Year,Country,Exports,Export_Percentage_Global,Export_Rank,Imports,Import_Percentage_Global,Import_Rank,Total_Trade,Total_Trade_Percentage_Global,Trade_Rank,Trade_Deficit,Prev_Trade_Deficit,Trade_Deficit_Growth_Percentage
2023,China,3379255,14.19,1,2556565,10.55,2,5935820,12.35,1,-822690,-837927,-1.82
2023,United States of America,2020606,8.49,2,3172476,13.09,1,5193082,10.81,2,1151870,1306594,-11.84
2023,Germany,1718251,7.22,3,1476656,6.09,3,3194907,6.65,3,-241595,-93252,159.08
2023,Netherlands,936392,3.93,4,842331,3.47,4,1778723,3.7,4,-94061,-67279,39.81
2023,Japan,717261,3.01,5,785796,3.24,7,1503057,3.13,5,68535,150340,-54.41
2023,France,648569,2.72,7,786158,3.24,6,1434727,2.99,6,137589,202755,-32.14
2023,Italy,676993,2.84,6,639755,2.64,11,1316748,2.74,7,-37238,35748,-204.17
2023,United Kingdom,521040,2.19,13,791523,3.27,5,1312563,2.73,8,270483,290565,-6.91
2023,"Korea, Republic of",632226,2.66,8,642572,2.65,10,1274798,2.65,9,10346,47785,-78.35
2023,"Hong Kong, China",573871,2.41,10,653696,2.7,9,1227567,2.55,10,79825,57629,38.52
2023,Mexico,593005,2.49,9,621476,2.56,12,1214481,2.53,11,28471,48626,-41.45
2023,Canada,568939,2.39,11,570484,2.35,13,1139423,2.37,12,1545,-15483,-109.98
2023,Belgium,564770,2.37,12,548051,2.26,14,1112821,2.32,13,-16719,-12490,33.86
2023,India,431574,1.81,17,672231,2.77,8,1103805,2.3,14,240657,267026,-9.88
2023,United Arab Emirates,485706,2.04,14,468302,1.93,16,954008,1.99,15,-17404,-95128,-81.7
2023,Singapore,476252,2.0,15,423448,1.75,17,899700,1.87,16,-52804,-40224,31.27
2023,Spain,423228,1.78,19,470329,1.94,15,893557,1.86,17,47101,78797,-40.22
2023,Chinese Taipei,432337,1.82,16,358960,1.48,21,791297,1.65,18,-73377,-41943,74.94
2023,Switzerland,420170,1.76,20,364098,1.5,19,784268,1.63,19,-56072,-43578,28.67
2023,Poland,381517,1.6,21,370076,1.53,18,751593,1.56,20,-11441,20645,-155.42
2023,Russian Federation,424222,1.78,18,303297,1.25,23,727519,1.51,21,-120925,-315564,-61.68
2023,Viet Nam,353782,1.49,23,325776,1.34,22,679558,1.41,22,-28006,-12140,130.69
2023,Australia,371278,1.56,22,287406,1.19,25,658684,1.37,23,-83872,-103494,-18.96
2023,Türkiye,255438,1.07,30,361765,1.49,20,617203,1.28,24,106327,109541,-2.93
2023,Brazil,339696,1.43,24,252710,1.04,27,592406,1.23,25,-86986,-41891,107.65
2023,Malaysia,312830,1.31,26,265750,1.1,26,578580,1.2,26,-47080,-58297,-19.24
2023,Thailand,284562,1.2,27,289754,1.2,24,574316,1.2,27,5192,13605,-61.84
2023,"Saudi Arabia, Kingdom of",320018,1.34,25,206940,0.85,31,526958,1.1,28,-113078,-221307,-48.9
2023,Czech Republic,255854,1.07,29,231315,0.95,28,487169,1.01,29,-24539,-5352,358.5
2023,Indonesia,258857,1.09,28,221886,0.92,30,480743,1.0,30,-36971,-54532,-32.2
2023,Austria,223855,0.94,31,225026,0.93,29,448881,0.93,31,1171,21590,-94.58
2023,Sweden,197900,0.83,33,192724,0.79,32,390624,0.81,32,-5176,5350,-196.75
2023,Ireland,208984,0.88,32,150554,0.62,34,359538,0.75,33,-58430,-66887,-12.64
2023,Hungary,160720,0.68,35,155879,0.64,33,316599,0.66,34,-4841,13464,-135.96
2023,Norway,174090,0.73,34,95470,0.39,41,269560,0.56,35,-78620,-144785,-45.7
2023,Denmark,136383,0.57,36,126009,0.52,38,262392,0.55,36,-10374,-3453,200.43
2023,South Africa,110855,0.47,38,130747,0.54,37,241602,0.5,37,19892,13306,49.5
2023,Romania,100611,0.42,39,131913,0.54,36,232524,0.48,38,31302,35769,-12.49
2023,Slovak Republic,117293,0.49,37,113599,0.47,39,230892,0.48,39,-3694,4080,-190.54
2023,Philippines,73527,0.31,48,133806,0.55,35,207333,0.43,40,60279,66937,-9.95
2023,Portugal,83857,0.35,45,113440,0.47,40,197297,0.41,41,29583,32617,-9.3
2023,Chile,94557,0.4,43,85308,0.35,44,179865,0.37,42,-9249,6056,-252.72
2023,Finland,82515,0.35,46,82961,0.34,46,165476,0.34,43,446,11260,-96.04
2023,Iraq,99149,0.42,40,65826,0.27,52,164975,0.34,44,-33323,-62851,-46.98
2023,Iran,97357,0.41,41,66058,0.27,51,163415,0.34,45,-31299,-39301,-20.36
2023,Israel,66893,0.28,50,91284,0.38,42,158177,0.33,46,24391,33684,-27.59
2023,Slovenia,73200,0.31,49,71563,0.3,48,144763,0.3,47,-1637,45,-3737.78
2023,Greece,55072,0.23,57,89470,0.37,43,144542,0.3,48,34398,40761,-15.61
2023,Argentina,66789,0.28,51,73714,0.3,47,140503,0.29,49,6925,-6923,-200.03
2023,Kazakhstan,78533,0.33,47,60655,0.25,55,139188,0.29,50,-17878,-33659,-46.88
2023,Qatar,96991,0.41,42,31187,0.13,70,128178,0.27,51,-65804,-97485,-32.5
2023,Egypt,42081,0.18,61,83189,0.34,45,125270,0.26,52,41108,44390,-7.39
2023,Bangladesh,55788,0.23,55,66863,0.28,50,122651,0.26,53,11075,33539,-66.98
2023,"Kuwait, the State of",83981,0.35,44,37490,0.15,66,121471,0.25,54,-46491,-65417,-28.93
2023,Peru,63074,0.26,52,52329,0.22,57,115403,0.24,55,-10745,-1932,456.16
2023,Colombia,49545,0.21,58,62797,0.26,54,112342,0.23,56,13252,20414,-35.08
2023,Morocco,41642,0.17,62,68632,0.28,49,110274,0.23,57,26990,30326,-11.0
2023,Nigeria,55182,0.23,56,49428,0.2,60,104610,0.22,58,-5754,-2724,111.23
2023,Bulgaria,47755,0.2,59,53529,0.22,56,101284,0.21,59,5774,8034,-28.13
2023,Algeria,56069,0.24,54,43729,0.18,62,99798,0.21,60,-12340,-26850,-54.04
2023,Ukraine,36040,0.15,66,63527,0.26,53,99567,0.21,61,27487,11160,146.3
2023,Oman,62736,0.26,53,36382,0.15,67,99118,0.21,62,-26354,-27490,-4.13
2023,New Zealand,41399,0.17,63,49957,0.21,59,91356,0.19,63,8558,9117,-6.13
2023,Lithuania,42639,0.18,60,48436,0.2,61,91075,0.19,64,5797,8610,-32.67
2023,Belarus,40168,0.17,64,43256,0.18,64,83424,0.17,65,3088,91,3293.41
2023,Pakistan,28478,0.12,70,50324,0.21,58,78802,0.16,66,21846,39880,-45.22
2023,Serbia,30935,0.13,69,39838,0.16,65,70773,0.15,67,8903,12090,-26.36
2023,Croatia,24937,0.1,72,43265,0.18,63,68202,0.14,68,18328,19156,-4.32
2023,Ecuador,31127,0.13,68,30902,0.13,71,62029,0.13,69,-225,391,-157.54
2023,Uzbekistan,19229,0.08,79,35575,0.15,68,54804,0.11,70,16346,12944,26.28
2023,Angola,38089,0.16,65,16271,0.07,90,54360,0.11,71,-21818,-33472,-34.82
2023,Azerbaijan,33899,0.14,67,17285,0.07,87,51184,0.11,72,-16614,-23607,-29.62
2023,Panama,16738,0.07,82,34285,0.14,69,51023,0.11,73,17547,13971,25.6
2023,Latvia,22667,0.1,75,27325,0.11,74,49992,0.1,74,4658,5401,-13.76
2023,Cambodia,23470,0.1,74,24386,0.1,78,47856,0.1,75,916,7333,-87.51
2023,Tunisia,19985,0.08,77,25485,0.11,77,45470,0.09,76,5500,8095,-32.06
2023,Guatemala,14199,0.06,88,30318,0.13,72,44517,0.09,77,16119,16421,-1.84
2023,Costa Rica,19025,0.08,80,24039,0.1,79,43064,0.09,78,5014,6088,-17.64
2023,Luxembourg,17162,0.07,81,25581,0.11,76,42743,0.09,79,8419,9643,-12.69
2023,Estonia,19674,0.08,78,22892,0.09,80,42566,0.09,80,3218,3903,-17.55
2023,Dominican Republic,12932,0.05,90,28823,0.12,73,41755,0.09,81,15891,17163,-7.41
2023,"Bahrain, Kingdom of",24814,0.1,73,15367,0.06,94,40181,0.08,82,-9447,-14657,-35.55
2023,Côte d'Ivoire,20263,0.09,76,18887,0.08,81,39150,0.08,83,-1376,1460,-194.25
2023,Jordan,12590,0.05,92,25717,0.11,75,38307,0.08,84,13127,14584,-9.99
2023,Libya,25033,0.11,71,11799,0.05,105,36832,0.08,85,-13234,-22088,-40.09
2023,Myanmar,14753,0.06,86,16441,0.07,89,31194,0.06,86,1688,318,430.82
2023,Ghana,16658,0.07,83,14010,0.06,96,30668,0.06,87,-2648,-2873,-7.83
2023,Honduras,11383,0.05,95,17423,0.07,86,28806,0.06,88,6040,6040,0.0
2023,Sri Lanka,11911,0.05,93,16811,0.07,88,28722,0.06,89,4900,5184,-5.48
2023,Democratic Republic of the Congo,16400,0.07,84,11600,0.05,106,28000,0.06,90,-4800,-4265,12.54
2023,Paraguay,11891,0.05,94,16105,0.07,91,27996,0.06,91,4214,5896,-28.53
2023,Kenya,7191,0.03,113,18585,0.08,82,25776,0.05,92,11394,13755,-17.16
2023,Bosnia and Herzegovina,9232,0.04,100,15355,0.06,95,24587,0.05,93,6123,5703,7.36
2023,Mongolia,15187,0.06,85,9250,0.04,115,24437,0.05,94,-5937,-3835,54.81
2023,"Bolivia, Plurinational State of",10911,0.05,97,11496,0.05,107,22407,0.05,95,585,-604,-196.85
2023,Lebanese Republic,4139,0.02,130,18125,0.07,83,22264,0.05,96,13986,15010,-6.82
2023,El Salvador,6498,0.03,116,15648,0.06,92,22146,0.05,97,9150,9993,-8.44
2023,Uruguay,9205,0.04,101,12486,0.05,99,21691,0.05,98,3281,1789,83.4
2023,Georgia,6091,0.03,118,15514,0.06,93,21605,0.04,99,9423,7965,18.31
2023,Ethiopia,3616,0.02,135,17888,0.07,84,21504,0.04,100,14272,14693,-2.87
2023,North Macedonia,8999,0.04,103,12056,0.05,103,21055,0.04,101,3057,4028,-24.11
2023,Tanzania,7275,0.03,111,13729,0.06,98,21004,0.04,102,6454,7394,-12.71
2023,Armenia,8415,0.04,104,12308,0.05,101,20723,0.04,103,3893,3409,14.2
2023,Zambia,10431,0.04,98,10125,0.04,111,20556,0.04,104,-306,-2639,-88.4
2023,Guyana,13210,0.06,89,6636,0.03,127,19846,0.04,105,-6574,-7657,-14.14
2023,"Macao, China",1654,0.01,147,17542,0.07,85,19196,0.04,106,15888,15661,1.45
2023,Cyprus,4995,0.02,124,13886,0.06,97,18881,0.04,107,8891,7842,13.38
2023,Brunei Darussalam,11241,0.05,96,7484,0.03,124,18725,0.04,108,-3757,-5046,-25.54
2023,"Venezuela, Bolivarian Republic of",7780,0.03,108,10945,0.05,109,18725,0.04,108,3165,5390,-41.28
2023,Mozambique,8276,0.03,106,10092,0.04,112,18368,0.04,110,1816,6372,-71.5
2023,Uganda,6162,0.03,117,12166,0.05,102,18328,0.04,111,6004,5960,0.74
2023,Nicaragua,7378,0.03,110,10916,0.05,110,18294,0.04,112,3538,3887,-8.98
2023,Turkmenistan,14246,0.06,87,4022,0.02,146,18268,0.04,113,-10224,-9913,3.14
2023,Papua New Guinea,12664,0.05,91,5465,0.02,136,18129,0.04,114,-7199,-8735,-17.58
2023,Trinidad and Tobago,9046,0.04,102,8161,0.03,120,17207,0.04,115,-885,-7053,-87.45
2023,Zimbabwe,7225,0.03,112,9214,0.04,116,16439,0.03,116,1989,2067,-3.77
2023,Senegal,5313,0.02,123,11064,0.05,108,16377,0.03,117,5751,6355,-9.5
2023,Iceland,6609,0.03,115,9464,0.04,114,16073,0.03,118,2855,2202,29.65
2023,Lao People's Democratic Republic,8370,0.04,105,7649,0.03,123,16019,0.03,119,-721,-954,-24.42
2023,Kyrgyz Republic,3309,0.01,137,12352,0.05,100,15661,0.03,120,9043,7548,19.81
2023,Guinea,9432,0.04,99,4682,0.02,142,14114,0.03,121,-4750,-3910,21.48
2023,Gabon,7700,0.03,109,6100,0.03,131,13800,0.03,122,-1600,-3944,-59.43
2023,Nepal,1145,0.0,150,12017,0.05,104,13162,0.03,123,10872,12439,-12.6
2023,Congo,8250,0.03,107,4870,0.02,140,13120,0.03,124,-3380,-6063,-44.25
2023,Albania,4374,0.02,129,8694,0.04,117,13068,0.03,125,4320,4090,5.62
2023,Cameroon,4927,0.02,125,8116,0.03,121,13043,0.03,126,3189,2290,39.26
2023,Namibia,5488,0.02,122,7239,0.03,126,12727,0.03,127,1751,1968,-11.03
2023,"Moldova, Republic of",4049,0.02,131,8674,0.04,118,12723,0.03,128,4625,4887,-5.36
2023,Syrian Arab Republic,6734,0.03,114,5962,0.02,133,12696,0.03,129,-772,1758,-143.91
2023,Sudan,4920,0.02,126,7380,0.03,125,12300,0.03,130,2460,6738,-63.49
2023,Botswana,5762,0.02,120,6501,0.03,128,12263,0.03,131,739,-227,-425.55
2023,Mali,5678,0.02,121,6490,0.03,129,12168,0.03,132,812,1765,-53.99
2023,Cuba,1939,0.01,146,9959,0.04,113,11898,0.02,133,8020,7663,4.66
2023,Malta,3467,0.01,136,8402,0.03,119,11869,0.02,134,4935,5266,-6.29
2023,Burkina Faso,4467,0.02,128,5896,0.02,134,10363,0.02,135,1429,986,44.93
2023,Jamaica,2107,0.01,144,7858,0.03,122,9965,0.02,136,5751,5830,-1.36
2023,Mauritania,3992,0.02,132,5221,0.02,137,9213,0.02,137,1229,1342,-8.42
2023,Benin,3834,0.02,133,5219,0.02,138,9053,0.02,138,1385,1195,15.9
2023,Equatorial Guinea,5800,0.02,119,2800,0.01,156,8600,0.02,139,-3000,-4512,-33.51
2023,Mauritius,2295,0.01,142,6273,0.03,130,8568,0.02,140,3978,4221,-5.76
2023,Djibouti,4527,0.02,127,3907,0.02,147,8434,0.02,141,-620,-1037,-40.21
2023,Tajikistan,2449,0.01,140,5880,0.02,135,8329,0.02,142,3431,3026,13.38
2023,Madagascar,3213,0.01,138,4750,0.02,141,7963,0.02,143,1537,1871,-17.85
2023,Afghanistan,881,0.0,156,6010,0.02,132,6891,0.01,144,5129,4712,8.85
2023,Rwanda,2466,0.01,139,3857,0.02,148,6323,0.01,145,1391,1458,-4.6
2023,Chad,3800,0.02,134,2200,0.01,159,6000,0.01,146,-1600,-2299,-30.4
2023,New Caledonia,2131,0.01,143,3196,0.01,153,5327,0.01,147,1065,836,27.39
2023,Yemen,251,0.0,176,5051,0.02,139,5302,0.01,148,4800,4587,4.64
2023,Somalia,752,0.0,160,4181,0.02,144,4933,0.01,149,3429,3649,-6.03
2023,Bahamas,708,0.0,162,4188,0.02,143,4896,0.01,150,3480,3148,10.55
2023,Montenegro,729,0.0,161,4122,0.02,145,4851,0.01,151,3393,2962,14.55
2023,Togo,1456,0.01,148,3322,0.01,152,4778,0.01,152,1866,1693,10.22
2023,Niger,986,0.0,153,3403,0.01,150,4389,0.01,153,2417,2655,-8.96
2023,Haiti,898,0.0,155,3363,0.01,151,4261,0.01,154,2465,3340,-26.2
2023,Fiji,1068,0.0,152,3100,0.01,155,4168,0.01,155,2032,1942,4.63
2023,Malawi,966,0.0,154,3141,0.01,154,4107,0.01,156,2175,686,217.06
2023,Suriname,2311,0.01,141,1697,0.01,168,4008,0.01,157,-614,-1033,-40.56
2023,Maldives,421,0.0,170,3497,0.01,149,3918,0.01,158,3076,3116,-1.28
2023,Eswatini,2029,0.01,145,1865,0.01,164,3894,0.01,159,-164,-61,168.85
2023,Sierra Leone,1328,0.01,149,1922,0.01,162,3250,0.01,160,594,907,-34.51
2023,Liberia,1123,0.0,151,1913,0.01,163,3036,0.01,161,790,501,57.68
2023,"Korea, Democratic People's Republic of",262,0.0,174,2718,0.01,157,2980,0.01,162,2456,1270,93.39
2023,Barbados,461,0.0,168,2109,0.01,160,2570,0.01,163,1648,1648,0.0
2023,Lesotho,825,0.0,159,1724,0.01,167,2549,0.01,164,899,962,-6.55
2023,French Polynesia,244,0.0,177,2303,0.01,158,2547,0.01,165,2059,2065,-0.29
2023,Curaçao,560,0.0,164,1830,0.01,166,2390,0.0,166,1270,1470,-13.61
2023,Andorra,252,0.0,175,1995,0.01,161,2247,0.0,167,1743,1478,17.93
2023,South Sudan,833,0.0,158,1184,0.0,175,2017,0.0,168,351,382,-8.12
2023,Seychelles,541,0.0,165,1451,0.01,169,1992,0.0,169,910,827,10.04
2023,Bhutan,641,0.0,163,1313,0.01,172,1954,0.0,170,672,787,-14.61
2023,Cayman Islands,45,0.0,189,1832,0.01,165,1877,0.0,171,1787,1759,1.59
2023,Belize,488,0.0,166,1341,0.01,171,1829,0.0,172,853,863,-1.16
2023,Greenland,873,0.0,157,905,0.0,180,1778,0.0,173,32,168,-80.95
2023,The Gambia,287,0.0,173,1227,0.01,174,1514,0.0,174,940,654,43.73
2023,"Aruba, Netherlands with respect to",147,0.0,181,1365,0.01,170,1512,0.0,175,1218,1167,4.37
2023,Sint Maarten,231,0.0,179,1158,0.0,177,1389,0.0,176,927,876,5.82
2023,Burundi,204,0.0,180,1151,0.0,178,1355,0.0,177,947,1053,-10.07
2023,Guam,14,0.0,201,1295,0.01,173,1309,0.0,178,1281,1207,6.13
2023,Solomon Islands,427,0.0,169,863,0.0,183,1290,0.0,179,436,278,56.83
2023,Bermuda,45,0.0,189,1171,0.0,176,1216,0.0,180,1126,1158,-2.76
2023,Timor-Leste,294,0.0,172,904,0.0,181,1198,0.0,181,610,461,32.32
2023,Cabo Verde,55,0.0,187,988,0.0,179,1043,0.0,182,933,868,7.49
2023,American Samoa,389,0.0,171,633,0.0,185,1022,0.0,183,244,265,-7.92
2023,Saint Lucia,80,0.0,184,896,0.0,182,976,0.0,184,816,755,8.08
2023,Eritrea,481,0.0,167,488,0.0,189,969,0.0,185,7,-91,-107.69
2023,Antigua and Barbuda,30,0.0,195,844,0.0,184,874,0.0,186,814,798,2.01
2023,Guinea-Bissau,235,0.0,178,469,0.0,191,704,0.0,187,234,224,4.46
2023,Grenada,46,0.0,188,609,0.0,186,655,0.0,188,563,552,1.99
2023,Central African Republic,144,0.0,182,496,0.0,188,640,0.0,189,352,351,0.28
2023,Northern Mariana Islands,4,0.0,205,556,0.0,187,560,0.0,190,552,544,1.47
2023,Vanuatu,60,0.0,185,473,0.0,190,533,0.0,191,413,288,43.4
2023,Samoa,42,0.0,192,468,0.0,192,510,0.0,192,426,398,7.04
2023,Saint Vincent and the Grenadines,41,0.0,193,456,0.0,193,497,0.0,193,415,392,5.87
2023,Turks and Caicos Islands,4,0.0,205,440,0.0,194,444,0.0,194,436,462,-5.63
2023,"Micronesia, Federated States of",106,0.0,183,301,0.0,199,407,0.0,195,195,167,16.77
2023,Comoros,31,0.0,194,358,0.0,195,389,0.0,196,327,294,11.22
2023,Saint Kitts and Nevis,25,0.0,196,333,0.0,196,358,0.0,197,308,297,3.7
2023,Kiribati,19,0.0,198,308,0.0,197,327,0.0,198,289,193,49.74
2023,Dominica,16,0.0,199,302,0.0,198,318,0.0,199,286,246,16.26
2023,Anguilla,15,0.0,200,285,0.0,200,300,0.0,200,270,286,-5.59
2023,Tonga,10,0.0,202,272,0.0,201,282,0.0,201,262,255,2.75
2023,Palau,2,0.0,207,242,0.0,202,244,0.0,202,240,207,15.94
2023,Sao Tomé and Principe,24,0.0,197,184,0.0,203,208,0.0,203,160,174,-8.05
2023,Cook Islands,7,0.0,203,173,0.0,204,180,0.0,204,166,136,22.06
2023,Marshall Islands,60,0.0,185,104,0.0,207,164,0.0,205,44,-2,-2300.0
2023,Nauru,43,0.0,191,75,0.0,209,118,0.0,206,32,41,-21.95
2023,"Bonaire, Sint Eustatius and Saba",1,0.0,209,112,0.0,205,113,0.0,207,111,118,-5.93
2023,Saint Pierre and Miquelon,2,0.0,207,110,0.0,206,112,0.0,208,108,106,1.89
2023,Wallis and Futuna Islands,0,0.0,211,79,0.0,208,79,0.0,209,79,84,-5.95
2023,Montserrat,6,0.0,204,47,0.0,210,53,0.0,210,41,32,28.13
2023,Tuvalu,0,0.0,211,43,0.0,211,43,0.0,211,43,34,26.47
2023,Niue,1,0.0,209,7,0.0,212,8,0.0,212,6,15,-60.0
2023,Tokelau,0,0.0,211,0,0.0,213,0,0.0,213,0,0,
2022,China,3544434,14.24,1,2706507,10.55,2,6250941,12.37,1,-837927,-636610,31.62
2022,United States of America,2065157,8.3,2,3371751,13.15,1,5436908,10.76,2,1306594,1181014,10.63
2022,Germany,1675847,6.73,3,1582595,6.17,3,3258442,6.45,3,-93252,-215230,-56.67
2022,Netherlands,964764,3.88,4,897485,3.5,4,1862249,3.69,4,-67279,-82652,-18.6
2022,Japan,746835,3.0,5,897175,3.5,5,1644010,3.25,5,150340,12944,1061.46
2022,France,620461,2.49,9,823216,3.21,7,1443677,2.86,6,202755,130061,55.89
2022,"Korea, Republic of",683585,2.75,6,731370,2.85,8,1414955,2.8,7,47785,-29307,-263.05
2022,United Kingdom,532982,2.14,14,823547,3.21,6,1356529,2.68,8,290565,224127,29.64
2022,Italy,658557,2.65,7,694305,2.71,10,1352862,2.68,9,35748,-48214,-174.14
2022,"Hong Kong, China",609925,2.45,10,667554,2.6,11,1277479,2.53,10,57629,42455,35.74
2022,Belgium,626376,2.52,8,613886,2.39,13,1240262,2.45,11,-12490,-24863,-49.76
2022,Mexico,577698,2.32,13,626324,2.44,12,1204022,2.38,12,48626,27506,76.78
2022,Canada,599032,2.41,11,583549,2.28,14,1182581,2.34,13,-15483,-1939,698.5
2022,India,453415,1.82,18,720441,2.81,9,1173856,2.32,14,267026,177666,50.3
2022,Singapore,515802,2.07,15,475578,1.85,16,991380,1.96,15,-40224,-51131,-21.33
2022,United Arab Emirates,515621,2.07,16,420493,1.64,18,936114,1.85,16,-95128,-77631,22.54
2022,Chinese Taipei,477778,1.92,17,435835,1.7,17,913613,1.81,17,-41943,-65592,-36.05
2022,Spain,415462,1.67,19,494259,1.93,15,909721,1.8,18,78797,39731,98.33
2022,Russian Federation,592075,2.38,12,276511,1.08,27,868586,1.72,19,-315564,-193115,63.41
2022,Switzerland,400693,1.61,22,357115,1.39,22,757808,1.5,20,-43578,-56125,-22.36
2022,Poland,360542,1.45,24,381187,1.49,19,741729,1.47,21,20645,1441,1332.69
2022,Viet Nam,371288,1.49,23,359148,1.4,21,730436,1.45,22,-12140,-3523,244.59
2022,Australia,412683,1.66,20,309189,1.21,23,721872,1.43,23,-103494,-83699,23.65
2022,Malaysia,352094,1.41,25,293797,1.15,25,645891,1.28,24,-58297,-61185,-4.72
2022,Brazil,334136,1.34,26,292245,1.14,26,626381,1.24,25,-41891,-46125,-9.18
2022,Türkiye,254170,1.02,29,363711,1.42,20,617881,1.22,26,109541,46212,137.04
2022,"Saudi Arabia, Kingdom of",411184,1.65,21,189877,0.74,32,601061,1.19,27,-221307,-123330,79.44
2022,Thailand,287425,1.15,28,301030,1.17,24,588455,1.16,28,13605,-5124,-365.52
2022,Indonesia,291979,1.17,27,237447,0.93,28,529426,1.05,29,-54532,-35316,54.41
2022,Czech Republic,242015,0.97,31,236663,0.92,29,478678,0.95,30,-5352,-14592,-63.32
2022,Austria,211929,0.85,33,233519,0.91,30,445448,0.88,31,21590,16714,29.17
2022,Sweden,197736,0.79,34,203086,0.79,31,400822,0.79,32,5350,-2416,-321.44
2022,Ireland,214156,0.86,32,147269,0.57,34,361425,0.72,33,-66887,-70357,-4.93
2022,Norway,250518,1.01,30,105733,0.41,42,356251,0.7,34,-144785,-62342,132.24
2022,Hungary,151672,0.61,35,165136,0.64,33,316808,0.63,35,13464,1087,1138.64
2022,Denmark,131793,0.53,36,128340,0.5,38,260133,0.51,36,-3453,-5638,-38.75
2022,South Africa,122901,0.49,38,136207,0.53,36,259108,0.51,37,13306,-9583,-238.85
2022,Romania,96699,0.39,44,132468,0.52,37,229167,0.45,38,35769,28815,24.13
2022,Philippines,78930,0.32,49,145867,0.57,35,224797,0.44,39,66937,49749,34.55
2022,Slovak Republic,108386,0.44,40,112466,0.44,40,220852,0.44,40,4080,0,
2022,Chile,98557,0.4,42,104613,0.41,43,203170,0.4,41,6056,-2208,-374.28
2022,Portugal,82463,0.33,48,115080,0.45,39,197543,0.39,42,32617,22971,41.99
2022,Finland,86069,0.35,46,97329,0.38,45,183398,0.36,43,11260,4017,180.31
2022,Israel,73585,0.3,50,107269,0.42,41,180854,0.36,44,33684,31996,5.28
2022,Iraq,118045,0.47,39,55194,0.22,58,173239,0.34,45,-62851,-32235,94.98
2022,Argentina,88446,0.36,45,81523,0.32,48,169969,0.34,46,-6923,-14750,-53.06
2022,Qatar,130964,0.53,37,33479,0.13,68,164443,0.33,47,-97485,-59218,64.62
2022,Greece,58524,0.24,56,99285,0.39,44,157809,0.31,48,40761,29887,36.38
2022,Iran,97853,0.39,43,58552,0.23,55,156405,0.31,49,-39301,-22560,74.21
2022,Egypt,51280,0.21,59,95670,0.37,46,146950,0.29,50,44390,33143,33.93
2022,Bangladesh,54695,0.22,58,88234,0.34,47,142929,0.28,51,33539,36225,-7.41
2022,Slovenia,69716,0.28,51,69761,0.27,52,139477,0.28,52,45,208,-78.37
2022,Kazakhstan,84593,0.34,47,50934,0.2,61,135527,0.27,53,-33659,-19454,73.02
2022,"Kuwait, the State of",99985,0.4,41,34568,0.13,67,134553,0.27,54,-65417,-31239,109.41
2022,Colombia,56999,0.23,57,77413,0.3,49,134412,0.27,55,20414,20814,-1.92
2022,Peru,62911,0.25,55,60979,0.24,53,123890,0.25,56,-1932,-8757,-77.94
2022,Nigeria,63075,0.25,54,60351,0.24,54,123426,0.24,57,-2724,5009,-154.38
2022,Morocco,41481,0.17,65,71807,0.28,50,113288,0.22,58,30326,22191,36.66
2022,Bulgaria,49925,0.2,61,57959,0.23,56,107884,0.21,59,8034,5053,58.99
2022,Oman,66063,0.27,52,38573,0.15,65,104636,0.21,60,-27490,-13596,102.19
2022,Algeria,65718,0.26,53,38868,0.15,64,104586,0.21,61,-26850,-1171,2192.91
2022,Pakistan,30901,0.12,70,70781,0.28,51,101682,0.2,62,39880,44170,-9.71
2022,Lithuania,46485,0.19,62,55095,0.21,59,101580,0.2,63,8610,3782,127.66
2022,Ukraine,44134,0.18,64,55294,0.22,57,99428,0.2,64,11160,4770,133.96
2022,New Zealand,45102,0.18,63,54219,0.21,60,99321,0.2,65,9117,5078,79.54
2022,Belarus,38220,0.15,66,38311,0.15,66,76531,0.15,66,91,1625,-94.4
2022,Serbia,29058,0.12,72,41148,0.16,63,70206,0.14,67,12090,8233,46.85
2022,Croatia,25467,0.1,73,44623,0.17,62,70090,0.14,68,19156,12649,51.44
2022,Angola,51275,0.21,60,17803,0.07,87,69078,0.14,69,-33472,-23093,44.94
2022,Ecuador,32658,0.13,69,33049,0.13,69,65707,0.13,70,391,-1009,-138.75
2022,Libya,38215,0.15,67,16127,0.06,91,54342,0.11,71,-22088,-16015,37.92
2022,Latvia,24100,0.1,74,29501,0.12,73,53601,0.11,72,5401,3613,49.49
2022,Azerbaijan,38147,0.15,68,14540,0.06,97,52687,0.1,73,-23607,-10505,124.72
2022,Cambodia,22472,0.09,76,29805,0.12,72,52277,0.1,74,7333,9276,-20.95
2022,Estonia,22859,0.09,75,26762,0.1,78,49621,0.1,75,3903,2053,90.11
2022,Guatemala,15695,0.06,83,32116,0.13,70,47811,0.09,76,16421,12854,27.75
2022,"Bahrain, Kingdom of",30194,0.12,71,15537,0.06,93,45731,0.09,77,-14657,-8181,79.16
2022,Tunisia,18561,0.07,77,26656,0.1,79,45217,0.09,78,8095,5797,39.64
2022,Dominican Republic,13750,0.06,89,30913,0.12,71,44663,0.09,79,17163,11795,45.51
2022,Panama,15278,0.06,85,29249,0.11,74,44527,0.09,80,13971,7435,87.91
2022,Luxembourg,17377,0.07,79,27020,0.11,77,44397,0.09,81,9643,9370,2.91
2022,Uzbekistan,15276,0.06,86,28220,0.11,75,43496,0.09,82,12944,9659,34.01
2022,Jordan,12780,0.05,94,27364,0.11,76,40144,0.08,83,14584,12184,19.7
2022,Costa Rica,16597,0.07,81,22685,0.09,80,39282,0.08,84,6088,5234,16.32
2022,Myanmar,17085,0.07,80,17403,0.07,88,34488,0.07,85,318,-827,-138.45
2022,Côte d'Ivoire,16429,0.07,82,17889,0.07,86,34318,0.07,86,1460,-1368,-206.73
2022,Ghana,17494,0.07,78,14621,0.06,96,32115,0.06,87,-2873,-1098,161.66
2022,Sri Lanka,13107,0.05,93,18291,0.07,85,31398,0.06,88,5184,8138,-36.3
2022,Honduras,12281,0.05,96,18321,0.07,84,30602,0.06,89,6040,4820,25.31
2022,Kenya,7411,0.03,110,21166,0.08,81,28577,0.06,90,13755,12820,7.29
2022,Democratic Republic of the Congo,15672,0.06,84,11407,0.04,106,27079,0.05,91,-4265,-14198,-69.96
2022,"Bolivia, Plurinational State of",13653,0.05,90,13049,0.05,101,26702,0.05,92,-604,-1909,-68.36
2022,Paraguay,9957,0.04,100,15853,0.06,92,25810,0.05,93,5896,3013,95.69
2022,Bosnia and Herzegovina,9674,0.04,102,15377,0.06,94,25051,0.05,94,5703,4415,29.17
2022,El Salvador,7115,0.03,113,17108,0.07,90,24223,0.05,95,9993,8222,21.54
2022,Uruguay,11184,0.04,99,12973,0.05,102,24157,0.05,96,1789,785,127.9
2022,Lebanese Republic,4485,0.02,126,19495,0.08,82,23980,0.05,97,15010,9719,54.44
2022,Brunei Darussalam,14230,0.06,88,9184,0.04,115,23414,0.05,98,-5046,-2483,103.22
2022,Mozambique,8299,0.03,107,14671,0.06,95,22970,0.05,99,6372,3054,108.64
2022,Ethiopia,3970,0.02,132,18663,0.07,83,22633,0.04,100,14693,12024,22.2
2022,North Macedonia,8727,0.04,105,12755,0.05,103,21482,0.04,101,4028,3200,25.87
2022,Mongolia,12539,0.05,95,8704,0.03,118,21243,0.04,102,-3835,-2395,60.13
2022,Tanzania,6825,0.03,114,14219,0.06,98,21044,0.04,103,7394,3633,103.52
2022,Zambia,11643,0.05,97,9004,0.04,116,20647,0.04,104,-2639,-4032,-34.55
2022,Papua New Guinea,14614,0.06,87,5879,0.02,131,20493,0.04,105,-8735,-6474,34.92
2022,Trinidad and Tobago,13286,0.05,92,6233,0.02,130,19519,0.04,106,-7053,-2871,145.66
2022,Georgia,5583,0.02,119,13548,0.05,100,19131,0.04,107,7965,5856,36.01
2022,"Macao, China",1677,0.01,147,17338,0.07,89,19015,0.04,108,15661,17599,-11.01
2022,Nicaragua,7360,0.03,112,11247,0.04,107,18607,0.04,109,3887,3671,5.88
2022,Senegal,5710,0.02,117,12065,0.05,105,17775,0.04,110,6355,4497,41.32
2022,Turkmenistan,13527,0.05,91,3614,0.01,148,17141,0.03,111,-9913,-5199,90.67
2022,Iceland,7389,0.03,111,9591,0.04,113,16980,0.03,112,2202,1830,20.33
2022,Cyprus,4363,0.02,128,12205,0.05,104,16568,0.03,113,7842,6492,20.79
2022,Botswana,8314,0.03,106,8087,0.03,122,16401,0.03,114,-227,980,-123.16
2022,Sudan,4357,0.02,129,11095,0.04,108,15452,0.03,115,6738,4867,38.44
2022,Lao People's Democratic Republic,8198,0.03,108,7244,0.03,126,15442,0.03,116,-954,-1420,-32.82
2022,Zimbabwe,6586,0.03,115,8653,0.03,119,15239,0.03,117,2067,1541,34.13
2022,Nepal,1296,0.01,149,13735,0.05,99,15031,0.03,118,12439,14209,-12.46
2022,Guyana,11281,0.05,98,3624,0.01,147,14905,0.03,119,-7657,20,-38385.0
2022,"Venezuela, Bolivarian Republic of",4750,0.02,123,10140,0.04,109,14890,0.03,120,5390,4210,28.03
2022,Gabon,9076,0.04,103,5132,0.02,137,14208,0.03,121,-3944,-4385,-10.06
2022,Armenia,5360,0.02,121,8769,0.03,117,14129,0.03,122,3409,2334,46.06
2022,Namibia,5828,0.02,116,7796,0.03,124,13624,0.03,123,1968,1960,0.41
2022,Guinea,8753,0.04,104,4843,0.02,140,13596,0.03,124,-3910,-6052,-35.39
2022,"Moldova, Republic of",4332,0.02,130,9219,0.04,114,13551,0.03,125,4887,4033,21.18
2022,Congo,9804,0.04,101,3741,0.01,144,13545,0.03,126,-6063,-5160,17.5
2022,Uganda,3772,0.02,134,9732,0.04,112,13504,0.03,127,5960,5121,16.38
2022,Cameroon,5584,0.02,118,7874,0.03,123,13458,0.03,128,2290,2664,-14.04
2022,Albania,4309,0.02,131,8399,0.03,121,12708,0.03,129,4090,4159,-1.66
2022,Mali,5376,0.02,120,7141,0.03,127,12517,0.02,130,1765,1438,22.74
2022,Kyrgyz Republic,2255,0.01,141,9803,0.04,111,12058,0.02,131,7548,2828,166.9
2022,Cuba,2170,0.01,142,9833,0.04,110,12003,0.02,132,7663,6465,18.53
2022,Malta,3253,0.01,137,8519,0.03,120,11772,0.02,133,5266,4069,29.42
2022,Syrian Arab Republic,4765,0.02,122,6523,0.03,129,11288,0.02,134,1758,2109,-16.64
2022,Equatorial Guinea,7500,0.03,109,2988,0.01,155,10488,0.02,135,-4512,-4054,11.3
2022,Burkina Faso,4518,0.02,125,5504,0.02,134,10022,0.02,136,986,-429,-329.84
2022,Jamaica,1901,0.01,146,7731,0.03,125,9632,0.02,137,5830,4490,29.84
2022,Madagascar,3654,0.01,136,5525,0.02,133,9179,0.02,138,1871,1683,11.17
2022,Mauritius,2388,0.01,140,6609,0.03,128,8997,0.02,139,4221,3171,33.11
2022,Mauritania,3778,0.02,133,5120,0.02,138,8898,0.02,140,1342,593,126.31
2022,Benin,3719,0.01,135,4914,0.02,139,8633,0.02,141,1195,866,37.99
2022,Djibouti,4601,0.02,124,3564,0.01,150,8165,0.02,142,-1037,182,-669.78
2022,Tajikistan,2142,0.01,143,5168,0.02,136,7310,0.01,143,3026,2060,46.89
2022,Chad,4383,0.02,127,2084,0.01,158,6467,0.01,144,-2299,-1073,114.26
2022,Afghanistan,819,0.0,159,5531,0.02,132,6350,0.01,145,4712,4458,5.7
2022,Yemen,690,0.0,162,5277,0.02,135,5967,0.01,146,4587,4411,3.99
2022,New Caledonia,2553,0.01,139,3389,0.01,152,5942,0.01,147,836,945,-11.53
2022,Haiti,1282,0.01,150,4622,0.02,141,5904,0.01,148,3340,3174,5.23
2022,Rwanda,2111,0.01,144,3569,0.01,149,5680,0.01,149,1458,1364,6.89
2022,Somalia,650,0.0,163,4299,0.02,142,4949,0.01,150,3649,3308,10.31
2022,Niger,1029,0.0,153,3684,0.01,146,4713,0.01,151,2655,2345,13.22
2022,Suriname,2836,0.01,138,1803,0.01,164,4639,0.01,152,-1033,-910,13.52
2022,Montenegro,742,0.0,160,3704,0.01,145,4446,0.01,153,2962,2441,21.34
2022,Togo,1348,0.01,148,3041,0.01,153,4389,0.01,154,1693,1616,4.76
2022,Bahamas,610,0.0,164,3758,0.01,143,4368,0.01,155,3148,2940,7.07
2022,Fiji,1055,0.0,152,2997,0.01,154,4052,0.01,156,1942,1301,49.27
2022,Eswatini,2034,0.01,145,1973,0.01,160,4007,0.01,157,-61,55,-210.91
2022,Maldives,400,0.0,171,3516,0.01,151,3916,0.01,158,3116,2288,36.19
2022,Sierra Leone,1059,0.0,151,1966,0.01,161,3025,0.01,159,907,1106,-17.99
2022,Lesotho,894,0.0,156,1856,0.01,163,2750,0.01,160,962,889,8.21
2022,Barbados,498,0.0,169,2146,0.01,157,2644,0.01,161,1648,1322,24.66
2022,Curaçao,553,0.0,166,2023,0.01,159,2576,0.01,162,1470,1139,29.06
2022,Liberia,1027,0.0,154,1528,0.01,167,2555,0.01,163,501,457,9.63
2022,Malawi,900,0.0,155,1586,0.01,166,2486,0.0,164,686,2064,-66.76
2022,French Polynesia,131,0.0,181,2196,0.01,156,2327,0.0,165,2065,1862,10.9
2022,Andorra,386,0.0,172,1864,0.01,162,2250,0.0,166,1478,1399,5.65
2022,Bhutan,724,0.0,161,1511,0.01,168,2235,0.0,167,787,436,80.5
2022,South Sudan,873,0.0,157,1255,0.0,174,2128,0.0,168,382,268,42.54
2022,Seychelles,537,0.0,167,1364,0.01,172,1901,0.0,169,827,669,23.62
2022,Belize,518,0.0,168,1381,0.01,170,1899,0.0,170,863,639,35.05
2022,Greenland,852,0.0,158,1020,0.0,178,1872,0.0,171,168,264,-36.36
2022,Cayman Islands,38,0.0,192,1797,0.01,165,1835,0.0,172,1759,1515,16.11
2022,"Korea, Democratic People's Republic of",160,0.0,179,1430,0.01,169,1590,0.0,173,1270,551,130.49
2022,"Aruba, Netherlands with respect to",208,0.0,177,1375,0.01,171,1583,0.0,174,1167,941,24.02
2022,Burundi,207,0.0,178,1260,0.0,173,1467,0.0,175,1053,862,22.16
2022,Timor-Leste,473,0.0,170,934,0.0,179,1407,0.0,176,461,257,79.38
2022,Sint Maarten,209,0.0,176,1085,0.0,177,1294,0.0,177,876,631,38.83
2022,Guam,33,0.0,195,1240,0.0,175,1273,0.0,178,1207,764,57.98
2022,Bermuda,34,0.0,194,1192,0.0,176,1226,0.0,179,1158,1026,12.87
2022,Eritrea,595,0.0,165,504,0.0,189,1099,0.0,180,-91,-140,-35.0
2022,American Samoa,377,0.0,173,642,0.0,184,1019,0.0,181,265,574,-53.83
2022,Cabo Verde,48,0.0,187,916,0.0,180,964,0.0,182,868,766,13.32
2022,Solomon Islands,335,0.0,174,613,0.0,185,948,0.0,183,278,155,79.35
2022,Saint Lucia,79,0.0,184,834,0.0,181,913,0.0,184,755,543,39.04
2022,Antigua and Barbuda,22,0.0,197,820,0.0,182,842,0.0,185,798,577,38.3
2022,The Gambia,40,0.0,191,694,0.0,183,734,0.0,186,654,574,13.94
2022,Guinea-Bissau,245,0.0,175,469,0.0,190,714,0.0,187,224,112,100.0
2022,Central African Republic,160,0.0,179,511,0.0,188,671,0.0,188,351,310,13.23
2022,Grenada,37,0.0,193,589,0.0,186,626,0.0,189,552,412,33.98
2022,Northern Mariana Islands,5,0.0,206,549,0.0,187,554,0.0,190,544,456,19.3
2022,Saint Vincent and the Grenadines,46,0.0,188,438,0.0,193,484,0.0,191,392,338,15.98
2022,Samoa,42,0.0,190,440,0.0,192,482,0.0,192,398,339,17.4
2022,Turks and Caicos Islands,5,0.0,206,467,0.0,191,472,0.0,193,462,408,13.24
2022,Vanuatu,61,0.0,185,349,0.0,194,410,0.0,194,288,285,1.05
2022,Comoros,54,0.0,186,348,0.0,195,402,0.0,195,294,293,0.34
2022,"Micronesia, Federated States of",111,0.0,182,278,0.0,198,389,0.0,196,167,139,20.14
2022,Saint Kitts and Nevis,29,0.0,196,326,0.0,196,355,0.0,197,297,210,41.43
2022,Anguilla,16,0.0,200,302,0.0,197,318,0.0,198,286,253,13.04
2022,Dominica,21,0.0,199,267,0.0,200,288,0.0,199,246,210,17.14
2022,Tonga,13,0.0,201,268,0.0,199,281,0.0,200,255,230,10.87
2022,Sao Tomé and Principe,22,0.0,197,196,0.0,203,218,0.0,201,174,145,20.0
2022,Palau,3,0.0,208,210,0.0,201,213,0.0,202,207,154,34.42
2022,Kiribati,9,0.0,203,202,0.0,202,211,0.0,203,193,167,15.57
2022,Marshall Islands,96,0.0,183,94,0.0,207,190,0.0,204,-2,-9,-77.78
2022,Cook Islands,11,0.0,202,147,0.0,204,158,0.0,205,136,104,30.77
2022,Nauru,43,0.0,189,84,0.0,208,127,0.0,206,41,49,-16.33
2022,Saint Pierre and Miquelon,8,0.0,204,114,0.0,206,122,0.0,207,106,113,-6.19
2022,"Bonaire, Sint Eustatius and Saba",1,0.0,209,119,0.0,205,120,0.0,208,118,104,13.46
2022,Wallis and Futuna Islands,0,0.0,211,84,0.0,208,84,0.0,209,84,74,13.51
2022,Montserrat,7,0.0,205,39,0.0,210,46,0.0,210,32,28,14.29
2022,Tuvalu,0,0.0,211,34,0.0,211,34,0.0,211,34,34,0.0
2022,Niue,1,0.0,209,16,0.0,212,17,0.0,212,15,13,15.38
2022,Tokelau,0,0.0,211,0,0.0,213,0,0.0,213,0,0,
2021,China,3316022,14.87,1,2679412,11.87,2,5995434,13.36,1,-636610,-523988,21.49
2021,United States of America,1754300,7.87,2,2935314,13.01,1,4689614,10.45,2,1181014,981997,20.27
2021,Germany,1636742,7.34,3,1421512,6.3,3,3058254,6.82,3,-215230,-210751,2.13
2021,Netherlands,840032,3.77,4,757380,3.36,5,1597412,3.56,4,-82652,-79480,3.99
2021,Japan,756032,3.39,5,768976,3.41,4,1525008,3.4,5,12944,-5859,-320.93
2021,"Hong Kong, China",669903,3.0,6,712358,3.16,7,1382261,3.08,6,42455,20996,102.21
2021,France,585021,2.62,9,715082,3.17,6,1300103,2.9,7,130061,92660,40.36
2021,"Korea, Republic of",644400,2.89,7,615093,2.73,9,1259493,2.81,8,-29307,-44865,-34.68
2021,Italy,615635,2.76,8,567421,2.51,11,1183056,2.64,9,-48214,-72925,-33.89
2021,United Kingdom,470508,2.11,14,694635,3.08,8,1165143,2.6,10,224127,238722,-6.11
2021,Belgium,551478,2.47,10,526615,2.33,12,1078093,2.4,11,-24863,-26594,-6.51
2021,Mexico,494949,2.22,12,522455,2.31,13,1017404,2.27,12,27506,-23893,-215.12
2021,Canada,507992,2.28,11,506053,2.24,14,1014045,2.26,13,-1939,30113,-106.44
2021,India,395426,1.77,18,573092,2.54,10,968518,2.16,14,177666,96792,83.55
2021,Singapore,457357,2.05,15,406226,1.8,16,863583,1.92,15,-51131,-32704,56.34
2021,Chinese Taipei,447693,2.01,16,382101,1.69,17,829794,1.85,16,-65592,-59140,10.91
2021,Spain,379969,1.7,20,419700,1.86,15,799669,1.78,17,39731,17875,122.27
2021,Russian Federation,494161,2.22,13,301046,1.33,22,795207,1.77,18,-193115,-93442,106.67
2021,United Arab Emirates,425160,1.91,17,347529,1.54,18,772689,1.72,19,-77631,-88336,-12.12
2021,Switzerland,380194,1.71,19,324069,1.44,21,704263,1.57,20,-56125,-27337,105.31
2021,Poland,340634,1.53,22,342075,1.52,19,682709,1.52,21,1441,-12209,-111.8
2021,Viet Nam,335978,1.51,23,332455,1.47,20,668433,1.49,22,-3523,-19928,-82.32
2021,Australia,344864,1.55,21,261165,1.16,25,606029,1.35,23,-83699,-38999,114.62
2021,Thailand,272006,1.22,27,266882,1.18,24,538888,1.2,24,-5124,-25478,-79.89
2021,Malaysia,299425,1.34,24,238240,1.06,26,537665,1.2,25,-61185,-43906,39.35
2021,Brazil,280815,1.26,25,234690,1.04,27,515505,1.15,26,-46125,-42844,7.66
2021,Türkiye,225214,1.01,30,271426,1.2,23,496640,1.11,27,46212,49879,-7.35
2021,Czech Republic,226564,1.02,29,211972,0.94,29,438536,0.98,28,-14592,-20811,-29.88
2021,"Saudi Arabia, Kingdom of",276179,1.24,26,152849,0.68,32,429028,0.96,29,-123330,-35857,243.95
2021,Indonesia,231506,1.04,28,196190,0.87,30,427696,0.95,30,-35316,-21684,62.87
2021,Austria,202806,0.91,31,219520,0.97,28,422326,0.94,31,16714,3031,451.44
2021,Sweden,189524,0.85,33,187108,0.83,31,376632,0.84,32,-2416,-5511,-56.16
2021,Ireland,190658,0.86,32,120301,0.53,36,310959,0.69,33,-70357,-80281,-12.36
2021,Hungary,141830,0.64,35,142917,0.63,33,284747,0.63,34,1087,-4634,-123.46
2021,Norway,160106,0.72,34,97764,0.43,41,257870,0.57,35,-62342,-4012,1453.89
2021,Denmark,125945,0.56,36,120307,0.53,35,246252,0.55,36,-5638,-10156,-44.49
2021,South Africa,123572,0.55,37,113989,0.51,38,237561,0.53,37,-9583,-1772,440.8
2021,Slovak Republic,103891,0.47,38,103891,0.46,39,207782,0.46,38,0,-2247,-100.0
2021,Romania,87388,0.39,40,116203,0.51,37,203591,0.45,39,28815,21414,34.56
2021,Philippines,74618,0.33,45,124367,0.55,34,198985,0.44,40,49749,26872,85.13
2021,Chile,94601,0.42,39,92393,0.41,42,186994,0.42,41,-2208,-14816,-85.1
2021,Portugal,75229,0.34,44,98200,0.44,40,173429,0.39,42,22971,16399,40.08
2021,Finland,81996,0.37,42,86013,0.38,44,168009,0.37,43,4017,2048,96.14
2021,Israel,60159,0.27,51,92155,0.41,43,152314,0.34,44,31996,19108,67.45
2021,Argentina,77934,0.35,43,63184,0.28,50,141118,0.31,45,-14750,-12528,17.74
2021,Ukraine,68073,0.31,48,72843,0.32,48,140916,0.31,46,4770,5145,-7.29
2021,Bangladesh,44223,0.2,58,80448,0.36,45,124671,0.28,47,36225,19199,88.68
2021,Greece,47218,0.21,54,77105,0.34,46,124323,0.28,48,29887,20732,44.16
2021,Iran,71646,0.32,47,49086,0.22,57,120732,0.27,49,-22560,-8159,176.5
2021,Egypt,41310,0.19,59,74453,0.33,47,115763,0.26,50,33143,33410,-0.8
2021,Qatar,87203,0.39,41,27985,0.12,69,115188,0.26,51,-59218,-25669,130.7
2021,Slovenia,57352,0.26,53,57560,0.26,53,114912,0.26,52,208,-2607,-107.98
2021,Iraq,73084,0.33,46,40849,0.18,62,113933,0.25,53,-32235,1430,-2354.2
2021,Peru,59648,0.27,52,50891,0.23,55,110539,0.25,54,-8757,-3460,153.09
2021,Kazakhstan,60625,0.27,50,41171,0.18,61,101796,0.23,55,-19454,-9225,110.88
2021,Colombia,40287,0.18,62,61101,0.27,51,101388,0.23,56,20814,12481,66.77
2021,Pakistan,28319,0.13,68,72489,0.32,49,100808,0.22,57,44170,23858,85.14
2021,Nigeria,46871,0.21,55,51880,0.23,54,98751,0.22,58,5009,106,4625.47
2021,"Kuwait, the State of",63128,0.28,49,31889,0.14,66,95017,0.21,59,-31239,-12378,152.38
2021,New Zealand,44777,0.2,56,49855,0.22,56,94632,0.21,60,5078,-1225,-514.53
2021,Morocco,35843,0.16,65,58034,0.26,52,93877,0.21,61,22191,16672,33.1
2021,Bulgaria,41157,0.18,60,46210,0.2,58,87367,0.19,62,5053,3102,62.89
2021,Lithuania,40706,0.18,61,44488,0.2,59,85194,0.19,63,3782,524,621.76
2021,Belarus,39762,0.18,63,41387,0.18,60,81149,0.18,64,1625,3588,-54.71
2021,Algeria,38637,0.17,64,37466,0.17,63,76103,0.17,65,-1171,13615,-108.6
2021,Oman,44591,0.2,57,30995,0.14,67,75586,0.17,66,-13596,-4972,173.45
2021,Serbia,25564,0.11,70,33797,0.15,65,59361,0.13,67,8233,6735,22.24
2021,Croatia,21878,0.1,73,34527,0.15,64,56405,0.13,68,12649,9637,31.25
2021,Ecuador,26699,0.12,69,25690,0.11,72,52389,0.12,69,-1009,-2437,-58.6
2021,Cambodia,19307,0.09,77,28583,0.13,68,47890,0.11,70,9276,1398,563.52
2021,Libya,30971,0.14,67,14956,0.07,87,45927,0.1,71,-16015,2656,-702.97
2021,Angola,34472,0.15,66,11379,0.05,98,45851,0.1,72,-23093,-12797,80.46
2021,Latvia,20833,0.09,76,24446,0.11,73,45279,0.1,73,3613,2104,71.72
2021,Estonia,21560,0.1,74,23613,0.1,76,45173,0.1,74,2053,984,108.64
2021,Luxembourg,16800,0.08,78,26170,0.12,71,42970,0.1,75,9370,7326,27.9
2021,Guatemala,13753,0.06,85,26607,0.12,70,40360,0.09,76,12854,6684,92.31
2021,Tunisia,16689,0.07,79,22486,0.1,77,39175,0.09,77,5797,4561,27.1
2021,Uzbekistan,14081,0.06,84,23740,0.11,75,37821,0.08,78,9659,6835,41.32
2021,Dominican Republic,12487,0.06,88,24282,0.11,74,36769,0.08,79,11795,6803,73.38
2021,"Bahrain, Kingdom of",22369,0.1,71,14188,0.06,90,36557,0.08,80,-8181,-1383,491.54
2021,Costa Rica,15494,0.07,80,20728,0.09,79,36222,0.08,81,5234,2623,99.54
2021,Azerbaijan,22208,0.1,72,11703,0.05,96,33911,0.08,82,-10505,-3001,250.05
2021,Panama,13161,0.06,86,20596,0.09,81,33757,0.08,83,7435,5257,41.43
2021,Sri Lanka,12499,0.06,87,20637,0.09,80,33136,0.07,84,8138,6008,35.45
2021,Jordan,9358,0.04,98,21542,0.1,78,30900,0.07,85,12184,9290,31.15
2021,Myanmar,15154,0.07,82,14327,0.06,89,29481,0.07,86,-827,1255,-165.9
2021,Côte d'Ivoire,15334,0.07,81,13966,0.06,91,29300,0.07,87,-1368,-1927,-29.01
2021,Democratic Republic of the Congo,21412,0.1,75,7214,0.03,116,28626,0.06,88,-14198,-7292,94.71
2021,Ghana,14727,0.07,83,13629,0.06,93,28356,0.06,89,-1098,-2043,-46.26
2021,Kenya,6739,0.03,107,19559,0.09,82,26298,0.06,90,12820,9401,36.37
2021,Honduras,10247,0.05,94,15067,0.07,86,25314,0.06,91,4820,2570,87.55
2021,Paraguay,10547,0.05,93,13560,0.06,94,24107,0.05,92,3013,1699,77.34
2021,Bosnia and Herzegovina,8614,0.04,101,13029,0.06,95,21643,0.05,93,4415,3718,18.75
2021,El Salvador,6395,0.03,109,14617,0.06,88,21012,0.05,94,8222,5083,61.75
2021,"Macao, China",1620,0.01,146,19219,0.09,83,20839,0.05,95,17599,10235,71.95
2021,"Bolivia, Plurinational State of",11030,0.05,90,9121,0.04,106,20151,0.04,96,-1909,65,-3036.92
2021,Ethiopia,3949,0.02,126,15973,0.07,84,19922,0.04,97,12024,9857,21.98
2021,Uruguay,9535,0.04,96,10320,0.05,100,19855,0.04,98,785,700,12.14
2021,Brunei Darussalam,11058,0.05,89,8575,0.04,109,19633,0.04,99,-2483,-1265,96.28
2021,North Macedonia,8186,0.04,102,11386,0.05,97,19572,0.04,100,3200,2077,54.07
2021,Lebanese Republic,4138,0.02,124,13857,0.06,92,17995,0.04,101,9719,7270,33.69
2021,Zambia,11013,0.05,91,6981,0.03,119,17994,0.04,102,-4032,-2638,52.84
2021,Nepal,1684,0.01,145,15893,0.07,85,17577,0.04,103,14209,9000,57.88
2021,Nicaragua,6495,0.03,108,10166,0.05,101,16661,0.04,104,3671,1290,184.57
2021,Tanzania,6391,0.03,110,10024,0.04,103,16415,0.04,105,3633,2378,52.78
2021,Mongolia,9241,0.04,99,6846,0.03,121,16087,0.04,106,-2395,-2277,5.18
2021,Botswana,7420,0.03,106,8400,0.04,111,15820,0.04,107,980,2254,-56.52
2021,Papua New Guinea,10842,0.05,92,4368,0.02,137,15210,0.03,108,-6474,-5486,18.01
2021,Sudan,5027,0.02,117,9894,0.04,104,14921,0.03,109,4867,6035,-19.35
2021,Senegal,5202,0.02,115,9699,0.04,105,14901,0.03,110,4497,3883,15.81
2021,Mozambique,5704,0.03,114,8758,0.04,108,14462,0.03,111,3054,2794,9.31
2021,Guinea,10239,0.05,95,4187,0.02,141,14426,0.03,112,-6052,-5204,16.3
2021,Trinidad and Tobago,8620,0.04,100,5749,0.03,127,14369,0.03,113,-2871,-643,346.5
2021,Georgia,4243,0.02,122,10099,0.04,102,14342,0.03,114,5856,4708,24.38
2021,Cyprus,3905,0.02,127,10397,0.05,99,14302,0.03,115,6492,5698,13.93
2021,Lao People's Democratic Republic,7695,0.03,104,6275,0.03,125,13970,0.03,116,-1420,-745,90.6
2021,Iceland,5987,0.03,112,7817,0.03,112,13804,0.03,117,1830,1115,64.13
2021,Turkmenistan,9447,0.04,97,4248,0.02,139,13695,0.03,118,-5199,-3277,58.65
2021,Zimbabwe,6036,0.03,111,7577,0.03,115,13613,0.03,119,1541,1248,23.48
2021,Uganda,3965,0.02,125,9086,0.04,107,13051,0.03,120,5121,4102,24.84
2021,Gabon,8031,0.04,103,3646,0.02,145,11677,0.03,121,-4385,-3861,13.57
2021,Cameroon,4317,0.02,121,6981,0.03,119,11298,0.03,122,2664,2389,11.51
2021,"Venezuela, Bolivarian Republic of",3535,0.02,131,7745,0.03,113,11280,0.03,123,4210,1580,166.46
2021,Albania,3559,0.02,130,7718,0.03,114,11277,0.03,124,4159,3064,35.74
2021,Mali,4858,0.02,118,6296,0.03,123,11154,0.02,125,1438,313,359.42
2021,Namibia,4417,0.02,119,6377,0.03,122,10794,0.02,126,1960,1170,67.52
2021,Syrian Arab Republic,4169,0.02,123,6278,0.03,124,10447,0.02,127,2109,576,266.15
2021,Cuba,1966,0.01,142,8431,0.04,110,10397,0.02,128,6465,5527,16.97
2021,"Moldova, Republic of",3144,0.01,133,7177,0.03,117,10321,0.02,129,4033,2949,36.76
2021,Malta,3064,0.01,134,7133,0.03,118,10197,0.02,130,4069,2881,41.24
2021,Congo,7512,0.03,105,2352,0.01,154,9864,0.02,131,-5160,-2985,72.86
2021,Burkina Faso,5043,0.02,116,4614,0.02,133,9657,0.02,132,-429,-246,74.39
2021,Guyana,4356,0.02,120,4376,0.02,136,8732,0.02,133,20,-340,-105.88
2021,Armenia,3023,0.01,135,5357,0.02,129,8380,0.02,134,2334,2015,15.83
2021,Kyrgyz Republic,2752,0.01,136,5580,0.02,128,8332,0.02,135,2828,1746,61.97
2021,Benin,3642,0.02,129,4508,0.02,134,8150,0.02,136,866,559,54.92
2021,Djibouti,3829,0.02,128,4011,0.02,142,7840,0.02,137,182,126,44.44
2021,Equatorial Guinea,5800,0.03,113,1746,0.01,160,7546,0.02,138,-4054,-1654,145.1
2021,Jamaica,1481,0.01,148,5971,0.03,126,7452,0.02,139,4490,3514,27.77
2021,Madagascar,2726,0.01,137,4409,0.02,135,7135,0.02,140,1683,1195,40.84
2021,Mauritania,3267,0.01,132,3860,0.02,143,7127,0.02,141,593,-85,-797.65
2021,Mauritius,1962,0.01,143,5133,0.02,131,7095,0.02,142,3171,2431,30.44
2021,Tajikistan,2150,0.01,140,4210,0.02,140,6360,0.01,143,2060,1744,18.12
2021,Afghanistan,850,0.0,155,5308,0.02,130,6158,0.01,144,4458,5761,-22.62
2021,Yemen,662,0.0,161,5073,0.02,132,5735,0.01,145,4411,4183,5.45
2021,Haiti,1130,0.01,150,4304,0.02,138,5434,0.01,146,3174,2664,19.14
2021,Niger,1212,0.01,149,3557,0.02,146,4769,0.01,147,2345,1993,17.66
2021,New Caledonia,1835,0.01,144,2780,0.01,151,4615,0.01,148,945,870,8.62
2021,Rwanda,1531,0.01,147,2895,0.01,150,4426,0.01,149,1364,1134,20.28
2021,Chad,2711,0.01,138,1638,0.01,162,4349,0.01,150,-1073,-222,383.33
2021,Eswatini,2068,0.01,141,2123,0.01,155,4191,0.01,151,55,-147,-137.41
2021,Malawi,1009,0.0,152,3073,0.01,148,4082,0.01,152,2064,1907,8.23
2021,Somalia,382,0.0,168,3690,0.02,144,4072,0.01,153,3308,3137,5.45
2021,Bahamas,543,0.0,163,3483,0.02,147,4026,0.01,154,2940,1870,57.22
2021,Togo,1060,0.0,151,2676,0.01,152,3736,0.01,155,1616,1281,26.15
2021,Suriname,2291,0.01,139,1381,0.01,166,3672,0.01,156,-910,-660,37.88
2021,Montenegro,515,0.0,164,2956,0.01,149,3471,0.01,157,2441,1985,22.97
2021,Fiji,815,0.0,156,2116,0.01,156,2931,0.01,158,1301,905,43.76
2021,Maldives,285,0.0,174,2573,0.01,153,2858,0.01,159,2288,1552,47.42
2021,Lesotho,935,0.0,153,1824,0.01,158,2759,0.01,160,889,535,66.17
2021,Sierra Leone,697,0.0,160,1803,0.01,159,2500,0.01,161,1106,1723,-35.81
2021,Liberia,881,0.0,154,1338,0.01,167,2219,0.0,162,457,390,17.18
2021,French Polynesia,119,0.0,180,1981,0.01,157,2100,0.0,163,1862,1626,14.51
2021,Barbados,350,0.0,170,1672,0.01,161,2022,0.0,164,1322,1152,14.76
2021,Bhutan,784,0.0,159,1220,0.01,168,2004,0.0,165,436,248,75.81
2021,South Sudan,812,0.0,157,1080,0.0,170,1892,0.0,166,268,-783,-134.23
2021,Greenland,802,0.0,158,1066,0.0,171,1868,0.0,167,264,141,87.23
2021,Curaçao,344,0.0,171,1483,0.01,165,1827,0.0,168,1139,938,21.43
2021,Andorra,164,0.0,175,1563,0.01,163,1727,0.0,169,1399,1328,5.35
2021,Seychelles,464,0.0,166,1133,0.01,169,1597,0.0,170,669,572,16.96
2021,Cayman Islands,17,0.0,199,1532,0.01,164,1549,0.0,171,1515,1317,15.03
2021,Timor-Leste,616,0.0,162,873,0.0,177,1489,0.0,172,257,361,-28.81
2021,Belize,422,0.0,167,1061,0.0,173,1483,0.0,173,639,498,28.31
2021,American Samoa,310,0.0,172,884,0.0,176,1194,0.0,174,574,357,60.78
2021,Burundi,163,0.0,176,1025,0.0,175,1188,0.0,175,862,747,15.39
2021,"Aruba, Netherlands with respect to",123,0.0,179,1064,0.0,172,1187,0.0,176,941,776,21.26
2021,Bermuda,29,0.0,194,1055,0.0,174,1084,0.0,177,1026,885,15.93
2021,Sint Maarten,144,0.0,177,775,0.0,180,919,0.0,178,631,464,35.99
2021,Solomon Islands,371,0.0,169,526,0.0,185,897,0.0,179,155,74,109.46
2021,Cabo Verde,55,0.0,185,821,0.0,178,876,0.0,180,766,667,14.84
2021,Eritrea,499,0.0,165,359,0.0,193,858,0.0,181,-140,-234,-40.17
2021,Guam,44,0.0,188,808,0.0,179,852,0.0,182,764,559,36.67
2021,Guinea-Bissau,300,0.0,173,412,0.0,189,712,0.0,183,112,147,-23.81
2021,"Korea, Democratic People's Republic of",80,0.0,183,631,0.0,181,711,0.0,184,551,684,-19.44
2021,Saint Lucia,59,0.0,184,602,0.0,183,661,0.0,185,543,449,20.94
2021,The Gambia,33,0.0,192,607,0.0,182,640,0.0,186,574,521,10.17
2021,Antigua and Barbuda,19,0.0,198,596,0.0,184,615,0.0,187,577,476,21.22
2021,Central African Republic,133,0.0,178,443,0.0,188,576,0.0,188,310,372,-16.67
2021,Grenada,35,0.0,189,447,0.0,187,482,0.0,189,412,370,11.35
2021,Northern Mariana Islands,3,0.0,207,459,0.0,186,462,0.0,190,456,422,8.06
2021,Turks and Caicos Islands,4,0.0,206,412,0.0,189,416,0.0,191,408,323,26.32
2021,Saint Vincent and the Grenadines,35,0.0,189,373,0.0,191,408,0.0,192,338,266,27.07
2021,Samoa,29,0.0,194,368,0.0,192,397,0.0,193,339,275,23.27
2021,Vanuatu,54,0.0,186,339,0.0,194,393,0.0,194,285,255,11.76
2021,"Micronesia, Federated States of",115,0.0,181,254,0.0,198,369,0.0,195,139,88,57.95
2021,Comoros,34,0.0,191,327,0.0,195,361,0.0,196,293,259,13.13
2021,Saint Kitts and Nevis,50,0.0,187,260,0.0,197,310,0.0,197,210,219,-4.11
2021,Anguilla,14,0.0,202,267,0.0,196,281,0.0,198,253,200,26.5
2021,Tonga,16,0.0,200,246,0.0,199,262,0.0,199,230,214,7.48
2021,Dominica,20,0.0,197,230,0.0,200,250,0.0,200,210,197,6.6
2021,Sao Tomé and Principe,21,0.0,196,166,0.0,202,187,0.0,201,145,124,16.94
2021,Kiribati,9,0.0,203,176,0.0,201,185,0.0,202,167,124,34.68
2021,Marshall Islands,90,0.0,182,81,0.0,207,171,0.0,203,-9,30,-130.0
2021,Palau,2,0.0,208,156,0.0,203,158,0.0,204,154,142,8.45
2021,Cook Islands,15,0.0,201,119,0.0,204,134,0.0,205,104,85,22.35
2021,Saint Pierre and Miquelon,5,0.0,205,118,0.0,205,123,0.0,206,113,94,20.21
2021,Nauru,31,0.0,193,80,0.0,208,111,0.0,207,49,47,4.26
2021,"Bonaire, Sint Eustatius and Saba",1,0.0,209,105,0.0,206,106,0.0,208,104,6062,-98.28
2021,Wallis and Futuna Islands,0,0.0,211,74,0.0,209,74,0.0,209,74,58,27.59
2021,Montserrat,8,0.0,204,36,0.0,210,44,0.0,210,28,25,12.0
2021,Tuvalu,0,0.0,211,34,0.0,211,34,0.0,211,34,34,0.0
2021,Niue,1,0.0,209,14,0.0,212,15,0.0,212,13,11,18.18
2021,Tokelau,0,0.0,211,0,0.0,213,0,0.0,213,0,0,
2020,China,2589952,14.68,1,2065964,11.56,2,4655916,13.11,1,-523988,-421071,24.44
2020,United States of America,1424935,8.07,2,2406932,13.47,1,3831867,10.79,2,981997,924284,6.24
2020,Germany,1382533,7.83,3,1171782,6.56,3,2554315,7.19,3,-210751,-255434,-17.49
2020,Japan,641319,3.63,5,635460,3.56,5,1276779,3.6,4,-5859,15393,-138.06
2020,Netherlands,674602,3.82,4,595122,3.33,6,1269724,3.58,5,-79480,-72918,9.0
2020,"Hong Kong, China",548773,3.11,6,569769,3.19,8,1118542,3.15,6,20996,42947,-51.11
2020,France,488637,2.77,9,581297,3.25,7,1069934,3.01,7,92660,83707,10.7
2020,United Kingdom,399529,2.26,12,638251,3.57,4,1037780,2.92,8,238722,236182,1.08
2020,"Korea, Republic of",512498,2.9,7,467633,2.62,9,980131,2.76,9,-44865,-38890,15.36
2020,Italy,499792,2.83,8,426867,2.39,10,926659,2.61,10,-72925,-62712,16.29
2020,Belgium,422655,2.4,10,396061,2.22,12,818716,2.31,11,-26594,-18032,47.48
2020,Canada,390821,2.21,13,420934,2.36,11,811755,2.29,12,30113,14176,112.42
2020,Mexico,417171,2.36,11,393278,2.2,13,810449,2.28,13,-23893,6514,-466.79
2020,Singapore,362534,2.05,14,329830,1.85,15,692364,1.95,14,-32704,-31497,3.83
2020,India,276410,1.57,21,373202,2.09,14,649612,1.83,15,96792,161719,-40.15
2020,Chinese Taipei,347193,1.97,15,288053,1.61,18,635246,1.79,16,-59140,-43458,36.09
2020,Spain,308317,1.75,19,326192,1.83,16,634509,1.79,17,17875,38732,-53.85
2020,Switzerland,319318,1.81,18,291981,1.63,17,611299,1.72,18,-27337,-36104,-24.28
2020,United Arab Emirates,335297,1.9,16,246961,1.38,21,582258,1.64,19,-88336,-100981,-12.52
2020,Russian Federation,333530,1.89,17,240088,1.34,22,573618,1.62,20,-93442,-165845,-43.66
2020,Viet Nam,282629,1.6,20,262701,1.47,19,545330,1.54,21,-19928,-10875,83.25
2020,Poland,273835,1.55,22,261626,1.46,20,535461,1.51,22,-12209,-1313,829.86
2020,Australia,250823,1.42,23,211824,1.19,24,462647,1.3,23,-38999,-49441,-21.12
2020,Thailand,231634,1.31,25,206156,1.15,25,437790,1.23,24,-25478,-10009,154.55
2020,Malaysia,234766,1.33,24,190860,1.07,26,425626,1.2,25,-43906,-33197,32.26
2020,Türkiye,169638,0.96,30,219517,1.23,23,389155,1.1,26,49879,29512,69.01
2020,Brazil,209180,1.19,26,166336,0.93,29,375516,1.06,27,-42844,-27965,53.21
2020,Czech Republic,191911,1.09,27,171100,0.96,28,363011,1.02,28,-20811,-20089,3.59
2020,Austria,169418,0.96,31,172449,0.97,27,341867,0.96,29,3031,6088,-50.21
2020,"Saudi Arabia, Kingdom of",173854,0.99,29,137997,0.77,32,311851,0.88,30,-35857,-108440,-66.93
2020,Sweden,155496,0.88,33,149985,0.84,30,305481,0.86,31,-5511,-1605,243.36
2020,Indonesia,163306,0.93,32,141622,0.79,31,304928,0.86,32,-21684,3593,-703.51
2020,Ireland,180104,1.02,28,99823,0.56,34,279927,0.79,33,-80281,-68521,17.16
2020,Hungary,120654,0.68,34,116020,0.65,33,236674,0.67,34,-4634,-3206,44.54
2020,Denmark,108454,0.61,35,98298,0.55,35,206752,0.58,35,-10156,-12892,-21.22
2020,Slovak Republic,86640,0.49,36,84393,0.47,38,171033,0.48,36,-2247,492,-556.71
2020,South Africa,85834,0.49,37,84062,0.47,39,169896,0.48,37,-1772,17523,-110.11
2020,Norway,84459,0.48,38,80447,0.45,40,164906,0.46,38,-4012,-17480,-77.05
2020,Romania,70718,0.4,40,92132,0.52,36,162850,0.46,39,21414,19673,8.85
2020,Philippines,63879,0.36,42,90751,0.51,37,154630,0.44,40,26872,42575,-36.88
2020,Portugal,61496,0.35,43,77895,0.44,41,139391,0.39,41,16399,22475,-27.03
2020,Finland,66220,0.38,41,68268,0.38,43,134488,0.38,42,2048,248,725.81
2020,Chile,74023,0.42,39,59207,0.33,45,133230,0.38,43,-14816,1061,-1496.42
2020,Israel,50152,0.28,46,69260,0.39,42,119412,0.34,44,19108,18084,5.66
2020,Ukraine,49192,0.28,47,54337,0.3,47,103529,0.29,45,5145,10746,-52.12
2020,Argentina,54884,0.31,44,42356,0.24,53,97240,0.27,46,-12528,-15992,-21.66
2020,Iraq,46863,0.27,49,48293,0.27,49,95156,0.27,47,1430,-22630,-106.32
2020,Greece,35215,0.2,56,55947,0.31,46,91162,0.26,48,20732,24477,-15.3
2020,Egypt,27078,0.15,64,60488,0.34,44,87566,0.25,49,33410,41991,-20.44
2020,Slovenia,44832,0.25,51,42225,0.24,54,87057,0.25,50,-2607,-936,178.53
2020,Bangladesh,33605,0.19,57,52804,0.3,48,86409,0.24,51,19199,19757,-2.82
2020,Iran,46916,0.27,48,38757,0.22,55,85673,0.24,52,-8159,-23890,-65.85
2020,Kazakhstan,46447,0.26,50,37222,0.21,56,83669,0.24,53,-9225,-19552,-52.82
2020,Qatar,51504,0.29,45,25835,0.14,68,77339,0.22,54,-25669,-43757,-41.34
2020,Peru,39600,0.22,53,36140,0.2,58,75740,0.21,55,-3460,-4160,-16.83
2020,New Zealand,38377,0.22,54,37152,0.21,57,75529,0.21,56,-1225,2846,-143.04
2020,Colombia,31008,0.18,61,43489,0.24,52,74497,0.21,57,12481,13214,-5.55
2020,Nigeria,35634,0.2,55,35740,0.2,59,71374,0.2,58,106,-7274,-101.46
2020,Morocco,27159,0.15,63,43831,0.25,51,70990,0.2,59,16672,21602,-22.82
2020,"Kuwait, the State of",40116,0.23,52,27738,0.16,65,67854,0.19,60,-12378,-30909,-59.95
2020,Pakistan,21979,0.12,66,45837,0.26,50,67816,0.19,61,23858,27003,-11.65
2020,Bulgaria,31954,0.18,60,35056,0.2,61,67010,0.19,62,3102,4323,-28.24
2020,Lithuania,32805,0.19,59,33329,0.19,62,66134,0.19,63,524,2608,-79.91
2020,Oman,33479,0.19,58,28507,0.16,64,61986,0.17,64,-4972,-15217,-67.33
2020,Belarus,29179,0.17,62,32767,0.18,63,61946,0.17,65,3588,6522,-44.99
2020,Algeria,21932,0.12,67,35547,0.2,60,57479,0.16,66,13615,9320,46.08
2020,Serbia,19498,0.11,69,26233,0.15,67,45731,0.13,67,6735,7100,-5.14
2020,Croatia,17193,0.1,71,26830,0.15,66,44023,0.12,68,9637,10980,-12.23
2020,Ecuador,20355,0.12,68,17918,0.1,76,38273,0.11,69,-2437,235,-1137.02
2020,Cambodia,17716,0.1,70,19114,0.11,71,36830,0.1,70,1398,5454,-74.37
2020,Luxembourg,13839,0.08,78,21165,0.12,69,35004,0.1,71,7326,7813,-6.23
2020,Latvia,16337,0.09,74,18441,0.1,72,34778,0.1,72,2104,3254,-35.34
2020,Myanmar,16692,0.09,72,17947,0.1,75,34639,0.1,73,1255,591,112.35
2020,Estonia,16340,0.09,73,17324,0.1,77,33664,0.09,74,984,1924,-48.86
2020,Uzbekistan,13097,0.07,81,19932,0.11,70,33029,0.09,75,6835,6937,-1.47
2020,Tunisia,13799,0.08,79,18360,0.1,73,32159,0.09,76,4561,6631,-31.22
2020,Angola,22135,0.13,65,9338,0.05,98,31473,0.09,77,-12797,-21470,-40.4
2020,Guatemala,11521,0.07,84,18205,0.1,74,29726,0.08,78,6684,8707,-23.23
2020,Dominican Republic,10302,0.06,85,17105,0.1,79,27407,0.08,79,6803,9075,-25.04
2020,Costa Rica,12319,0.07,83,14942,0.08,82,27261,0.08,80,2623,5709,-54.06
2020,Ghana,14472,0.08,75,12429,0.07,86,26901,0.08,81,-2043,-2257,-9.48
2020,"Bahrain, Kingdom of",14066,0.08,77,12683,0.07,85,26749,0.08,82,-1383,-4864,-71.57
2020,Sri Lanka,10047,0.06,86,16055,0.09,80,26102,0.07,83,6008,7997,-24.87
2020,Jordan,7943,0.05,92,17233,0.1,78,25176,0.07,84,9290,10853,-14.4
2020,Azerbaijan,13733,0.08,80,10732,0.06,90,24465,0.07,85,-3001,-5967,-49.71
2020,Panama,9483,0.05,87,14740,0.08,83,24223,0.07,86,5257,10174,-48.33
2020,Côte d'Ivoire,12454,0.07,82,10527,0.06,91,22981,0.06,87,-1927,-2235,-13.78
2020,Kenya,6034,0.03,105,15435,0.09,81,21469,0.06,88,9401,11816,-20.44
2020,Democratic Republic of the Congo,14230,0.08,76,6938,0.04,108,21168,0.06,89,-7292,-4557,60.02
2020,Libya,8443,0.05,91,11099,0.06,89,19542,0.06,90,2656,-14145,-118.78
2020,Paraguay,8518,0.05,90,10217,0.06,93,18735,0.05,91,1699,4576,-62.87
2020,Honduras,7683,0.04,94,10253,0.06,92,17936,0.05,92,2570,3361,-23.53
2020,Ethiopia,3258,0.02,124,13115,0.07,84,16373,0.05,93,9857,11813,-16.56
2020,Bosnia and Herzegovina,6155,0.03,102,9873,0.06,95,16028,0.05,94,3718,4581,-18.84
2020,Lebanese Republic,4085,0.02,118,11355,0.06,88,15440,0.04,95,7270,14812,-50.92
2020,North Macedonia,6638,0.04,99,8715,0.05,100,15353,0.04,96,2077,2282,-8.98
2020,El Salvador,4805,0.03,110,9888,0.06,94,14693,0.04,97,5083,5697,-10.78
2020,Tanzania,6061,0.03,104,8439,0.05,101,14500,0.04,98,2378,4447,-46.53
2020,Uruguay,6864,0.04,98,7564,0.04,105,14428,0.04,99,700,566,23.67
2020,"Bolivia, Plurinational State of",7015,0.04,97,7080,0.04,107,14095,0.04,100,65,1027,-93.67
2020,Sudan,3803,0.02,121,9838,0.06,97,13641,0.04,101,6035,5556,8.62
2020,Zambia,7924,0.04,93,5286,0.03,124,13210,0.04,102,-2638,134,-2068.66
2020,"Macao, China",1353,0.01,146,11588,0.06,87,12941,0.04,103,10235,9581,6.83
2020,Mongolia,7576,0.04,95,5299,0.03,123,12875,0.04,104,-2277,-1492,52.61
2020,Papua New Guinea,9077,0.05,88,3591,0.02,137,12668,0.04,105,-5486,-6819,-19.55
2020,Guinea,8931,0.05,89,3727,0.02,134,12658,0.04,106,-5204,-475,995.58
2020,Uganda,4149,0.02,117,8251,0.05,102,12400,0.03,107,4102,4132,-0.73
2020,Brunei Darussalam,6608,0.04,100,5343,0.03,122,11951,0.03,108,-1265,-1936,-34.66
2020,Cyprus,3063,0.02,127,8761,0.05,99,11824,0.03,109,5698,5674,0.42
2020,Senegal,3929,0.02,119,7812,0.04,104,11741,0.03,110,3883,3965,-2.07
2020,"Venezuela, Bolivarian Republic of",5010,0.03,108,6590,0.04,109,11600,0.03,111,1580,-11340,-113.93
2020,Lao People's Democratic Republic,6115,0.03,103,5370,0.03,121,11485,0.03,112,-745,466,-259.87
2020,Nicaragua,5087,0.03,107,6377,0.04,113,11464,0.03,113,1290,1565,-17.57
2020,Georgia,3341,0.02,123,8049,0.05,103,11390,0.03,114,4708,5720,-17.69
2020,Gabon,7345,0.04,96,3484,0.02,140,10829,0.03,115,-3861,-3840,0.55
2020,Botswana,4262,0.02,116,6516,0.04,111,10778,0.03,116,2254,1327,69.86
2020,Nepal,856,0.0,151,9856,0.06,96,10712,0.03,117,9000,11372,-20.86
2020,Trinidad and Tobago,5519,0.03,106,4876,0.03,128,10395,0.03,118,-643,-858,-25.06
2020,Iceland,4582,0.03,112,5697,0.03,116,10279,0.03,119,1115,1344,-17.04
2020,Mozambique,3720,0.02,122,6514,0.04,112,10234,0.03,120,2794,2912,-4.05
2020,Zimbabwe,4395,0.02,114,5643,0.03,117,10038,0.03,121,1248,548,127.74
2020,Mali,4794,0.03,111,5107,0.03,125,9901,0.03,122,313,1459,-78.55
2020,Turkmenistan,6511,0.04,101,3234,0.02,141,9745,0.03,123,-3277,-7613,-56.96
2020,Syrian Arab Republic,4512,0.03,113,5088,0.03,126,9600,0.03,124,576,3089,-81.35
2020,Cuba,1703,0.01,143,7230,0.04,106,8933,0.03,125,5527,7839,-29.49
2020,Namibia,3868,0.02,120,5038,0.03,127,8906,0.03,126,1170,1454,-19.53
2020,Cameroon,3132,0.02,126,5521,0.03,119,8653,0.02,127,2389,2499,-4.4
2020,Malta,2837,0.02,129,5718,0.03,115,8555,0.02,128,2881,4210,-31.57
2020,Burkina Faso,4372,0.02,115,4126,0.02,133,8498,0.02,129,-246,1045,-123.54
2020,Albania,2506,0.01,134,5570,0.03,118,8076,0.02,130,3064,3181,-3.68
2020,"Moldova, Republic of",2467,0.01,135,5416,0.03,120,7883,0.02,131,2949,3064,-3.75
2020,Afghanistan,777,0.0,156,6538,0.04,110,7315,0.02,132,5761,5913,-2.57
2020,Armenia,2544,0.01,133,4559,0.03,131,7103,0.02,133,2015,2874,-29.89
2020,Congo,4893,0.03,109,1908,0.01,155,6801,0.02,134,-2985,-3334,-10.47
2020,Benin,2996,0.02,128,3555,0.02,138,6551,0.02,135,559,880,-36.48
2020,"Bonaire, Sint Eustatius and Saba",1,0.0,209,6063,0.03,114,6064,0.02,136,6062,89,6711.24
2020,Jamaica,1251,0.01,147,4765,0.03,129,6016,0.02,137,3514,4738,-25.83
2020,Mauritius,1789,0.01,140,4220,0.02,132,6009,0.02,138,2431,3373,-27.93
2020,Djibouti,2785,0.02,131,2911,0.02,145,5696,0.02,139,126,142,-11.27
2020,Kyrgyz Republic,1973,0.01,138,3719,0.02,135,5692,0.02,140,1746,3003,-41.86
2020,Mauritania,2829,0.02,130,2744,0.02,146,5573,0.02,141,-85,1254,-106.78
2020,Madagascar,2026,0.01,137,3221,0.02,142,5247,0.01,142,1195,1246,-4.09
2020,Yemen,404,0.0,166,4587,0.03,130,4991,0.01,143,4183,4069,2.8
2020,Guyana,2590,0.01,132,2250,0.01,152,4840,0.01,144,-340,2473,-113.75
2020,Equatorial Guinea,3200,0.02,125,1546,0.01,161,4746,0.01,145,-1654,-3300,-49.88
2020,Tajikistan,1407,0.01,145,3151,0.02,143,4558,0.01,146,1744,2175,-19.82
2020,Haiti,885,0.01,150,3549,0.02,139,4434,0.01,147,2664,2980,-10.6
2020,New Caledonia,1722,0.01,142,2592,0.01,148,4314,0.01,148,870,1244,-30.06
2020,Niger,1116,0.01,148,3109,0.02,144,4225,0.01,149,1993,1805,10.42
2020,Somalia,513,0.0,161,3650,0.02,136,4163,0.01,150,3137,2788,12.52
2020,Rwanda,1408,0.01,144,2542,0.01,149,3950,0.01,151,1134,1418,-20.03
2020,Suriname,2193,0.01,136,1533,0.01,162,3726,0.01,152,-660,-444,48.65
2020,Malawi,771,0.0,157,2678,0.01,147,3449,0.01,153,1907,1993,-4.32
2020,Chad,1808,0.01,139,1586,0.01,160,3394,0.01,154,-222,-664,-66.57
2020,Eswatini,1752,0.01,141,1605,0.01,159,3357,0.01,155,-147,-170,-13.53
2020,Togo,979,0.01,149,2260,0.01,151,3239,0.01,156,1281,1036,23.65
2020,Montenegro,419,0.0,164,2404,0.01,150,2823,0.01,157,1985,2444,-18.78
2020,Sierra Leone,423,0.0,163,2146,0.01,154,2569,0.01,158,1723,867,98.73
2020,Fiji,826,0.0,153,1731,0.01,157,2557,0.01,159,905,1701,-46.8
2020,Bahamas,335,0.0,169,2205,0.01,153,2540,0.01,160,1870,2784,-32.83
2020,Lesotho,845,0.0,152,1380,0.01,165,2225,0.01,161,535,815,-34.36
2020,Maldives,286,0.0,171,1838,0.01,156,2124,0.01,162,1552,2527,-38.58
2020,Barbados,345,0.0,168,1497,0.01,163,1842,0.01,163,1152,1137,1.32
2020,Greenland,816,0.0,154,957,0.01,170,1773,0.0,164,141,160,-11.88
2020,French Polynesia,72,0.0,182,1698,0.01,158,1770,0.0,165,1626,1969,-17.42
2020,Andorra,167,0.0,175,1495,0.01,164,1662,0.0,166,1328,1539,-13.71
2020,Liberia,608,0.0,159,998,0.01,169,1606,0.0,167,390,490,-20.41
2020,Bhutan,651,0.0,158,899,0.01,173,1550,0.0,168,248,307,-19.22
2020,Curaçao,271,0.0,172,1209,0.01,167,1480,0.0,169,938,1063,-11.76
2020,Seychelles,432,0.0,162,1004,0.01,168,1436,0.0,170,572,649,-11.86
2020,Cayman Islands,21,0.0,194,1338,0.01,166,1359,0.0,171,1317,1378,-4.43
2020,American Samoa,409,0.0,165,766,0.0,177,1175,0.0,172,357,359,-0.56
2020,Belize,289,0.0,170,787,0.0,175,1076,0.0,173,498,561,-11.23
2020,Burundi,162,0.0,176,909,0.01,171,1071,0.0,174,747,707,5.66
2020,"Aruba, Netherlands with respect to",87,0.0,181,863,0.0,174,950,0.0,175,776,1075,-27.81
2020,Eritrea,583,0.0,160,349,0.0,190,932,0.0,176,-234,35,-768.57
2020,Bermuda,19,0.0,197,904,0.01,172,923,0.0,177,885,1091,-18.88
2020,Timor-Leste,264,0.0,173,625,0.0,179,889,0.0,178,361,437,-17.39
2020,"Korea, Democratic People's Republic of",90,0.0,180,774,0.0,176,864,0.0,179,684,2697,-74.64
2020,Solomon Islands,379,0.0,167,453,0.0,186,832,0.0,180,74,129,-42.64
2020,South Sudan,783,0.0,155,0,0.0,212,783,0.0,181,-783,-1613,-51.46
2020,Cabo Verde,53,0.0,186,720,0.0,178,773,0.0,182,667,734,-9.13
2020,Sint Maarten,134,0.0,177,598,0.0,180,732,0.0,183,464,747,-37.88
2020,The Gambia,61,0.0,183,582,0.0,182,643,0.0,184,521,488,6.76
2020,Central African Republic,134,0.0,177,506,0.0,183,640,0.0,185,372,465,-20.0
2020,Guam,36,0.0,191,595,0.0,181,631,0.0,186,559,1018,-45.09
2020,Guinea-Bissau,214,0.0,174,361,0.0,189,575,0.0,187,147,136,8.09
2020,Saint Lucia,55,0.0,184,504,0.0,184,559,0.0,188,449,516,-12.98
2020,Antigua and Barbuda,22,0.0,193,498,0.0,185,520,0.0,189,476,663,-28.21
2020,Northern Mariana Islands,5,0.0,206,427,0.0,187,432,0.0,190,422,587,-28.11
2020,Grenada,25,0.0,192,395,0.0,188,420,0.0,191,370,446,-17.04
2020,Saint Vincent and the Grenadines,55,0.0,184,321,0.0,192,376,0.0,192,266,296,-10.14
2020,Samoa,37,0.0,190,312,0.0,193,349,0.0,193,275,342,-19.59
2020,Vanuatu,46,0.0,188,301,0.0,194,347,0.0,194,255,301,-15.28
2020,"Micronesia, Federated States of",125,0.0,179,213,0.0,198,338,0.0,195,88,174,-49.43
2020,Turks and Caicos Islands,3,0.0,208,326,0.0,191,329,0.0,196,323,349,-7.45
2020,Saint Kitts and Nevis,52,0.0,187,271,0.0,196,323,0.0,197,219,280,-21.79
2020,Comoros,21,0.0,194,280,0.0,195,301,0.0,198,259,226,14.6
2020,Tonga,15,0.0,199,229,0.0,197,244,0.0,199,214,218,-1.83
2020,Dominica,16,0.0,198,213,0.0,198,229,0.0,200,197,300,-34.33
2020,Anguilla,11,0.0,202,211,0.0,200,222,0.0,201,200,216,-7.41
2020,Palau,7,0.0,204,149,0.0,201,156,0.0,202,142,189,-24.87
2020,Sao Tomé and Principe,14,0.0,200,138,0.0,202,152,0.0,203,124,135,-8.15
2020,Kiribati,9,0.0,203,133,0.0,203,142,0.0,204,124,120,3.33
2020,Cook Islands,20,0.0,196,105,0.0,204,125,0.0,205,85,119,-28.57
2020,Marshall Islands,44,0.0,189,74,0.0,206,118,0.0,206,30,13,130.77
2020,Saint Pierre and Miquelon,5,0.0,206,99,0.0,205,104,0.0,207,94,90,4.44
2020,Nauru,12,0.0,201,59,0.0,207,71,0.0,208,47,90,-47.78
2020,Wallis and Futuna Islands,0,0.0,211,58,0.0,208,58,0.0,209,58,63,-7.94
2020,Montserrat,6,0.0,205,31,0.0,210,37,0.0,210,25,27,-7.41
2020,Tuvalu,0,0.0,211,34,0.0,209,34,0.0,211,34,33,3.03
2020,Niue,1,0.0,209,12,0.0,211,13,0.0,212,11,12,-8.33
2020,Tokelau,0,0.0,211,0,0.0,212,0,0.0,213,0,0,
2019,China,2499457,13.15,1,2078386,10.76,2,4577843,11.95,1,-421071,-350947,19.98
2019,United States of America,1643161,8.65,2,2567445,13.3,1,4210606,10.99,2,924284,950239,-2.73
2019,Germany,1489412,7.84,3,1233978,6.39,3,2723390,7.11,3,-255434,-276186,-7.51
2019,Japan,705564,3.71,5,720957,3.73,4,1426521,3.72,4,15393,10345,48.8
2019,Netherlands,708596,3.73,4,635678,3.29,7,1344274,3.51,5,-72918,-81195,-10.19
2019,France,570951,3.0,6,654658,3.39,6,1225609,3.2,6,83707,94219,-11.16
2019,United Kingdom,460026,2.42,11,696208,3.61,5,1156234,3.02,7,236182,186011,26.97
2019,"Hong Kong, China",534887,2.81,9,577834,2.99,8,1112721,2.9,8,42947,58160,-26.16
2019,"Korea, Republic of",542233,2.85,7,503343,2.61,9,1045576,2.73,9,-38890,-69658,-44.17
2019,Italy,537718,2.83,8,475006,2.46,11,1012724,2.64,10,-62712,-46286,35.49
2019,Mexico,460604,2.42,10,467118,2.42,12,927722,2.42,11,6514,26122,-75.06
2019,Canada,448817,2.36,12,462993,2.4,13,911810,2.38,12,14176,16793,-15.58
2019,Belgium,446910,2.35,13,428878,2.22,14,875788,2.29,13,-18032,-13025,38.44
2019,India,324340,1.71,19,486059,2.52,10,810399,2.12,14,161719,189686,-14.74
2019,Singapore,390763,2.06,15,359266,1.86,16,750029,1.96,15,-31497,-42074,-25.14
2019,Spain,334018,1.76,17,372750,1.93,15,706768,1.84,16,38732,43808,-11.59
2019,United Arab Emirates,389428,2.05,16,288447,1.49,17,677875,1.77,17,-100981,-143276,-29.52
2019,Russian Federation,419721,2.21,14,253876,1.31,21,673597,1.76,18,-165845,-195058,-14.98
2019,Chinese Taipei,330622,1.74,18,287164,1.49,18,617786,1.61,19,-43458,-49576,-12.34
2019,Switzerland,313934,1.65,20,277830,1.44,19,591764,1.54,20,-36104,-31221,15.64
2019,Poland,266595,1.4,22,265282,1.37,20,531877,1.39,21,-1313,5390,-124.36
2019,Viet Nam,264268,1.39,23,253393,1.31,22,517661,1.35,22,-10875,-6837,59.06
2019,Australia,271005,1.43,21,221564,1.15,24,492569,1.29,23,-49441,-21712,127.71
2019,Thailand,246269,1.3,25,236260,1.22,23,482529,1.26,24,-10009,-4756,110.45
2019,Malaysia,238195,1.25,26,204998,1.06,26,443193,1.16,25,-33197,-29853,11.2
2019,"Saudi Arabia, Kingdom of",261603,1.38,24,153163,0.79,32,414766,1.08,26,-108440,-157308,-31.07
2019,Brazil,221127,1.16,27,193162,1.0,27,414289,1.08,27,-27965,-39050,-28.39
2019,Türkiye,180833,0.95,29,210345,1.09,25,391178,1.02,28,29512,53983,-45.33
2019,Czech Republic,199128,1.05,28,179039,0.93,29,378167,0.99,29,-20089,-17579,14.28
2019,Austria,178670,0.94,30,184758,0.96,28,363428,0.95,30,6088,8907,-31.65
2019,Indonesia,167683,0.88,32,171276,0.89,30,338959,0.88,31,3593,8584,-58.14
2019,Sweden,160576,0.84,33,158971,0.82,31,319547,0.83,32,-1605,4637,-134.61
2019,Ireland,169625,0.89,31,101104,0.52,36,270729,0.71,33,-68521,-57125,19.95
2019,Hungary,123796,0.65,34,120590,0.62,33,244386,0.64,34,-3206,-3964,-19.12
2019,Denmark,111076,0.58,35,98184,0.51,37,209260,0.55,35,-12892,-6942,85.71
2019,South Africa,90016,0.47,37,107539,0.56,35,197555,0.52,36,17523,20001,-12.39
2019,Norway,102799,0.54,36,85319,0.44,41,188118,0.49,37,-17480,-35191,-50.33
2019,Philippines,70334,0.37,43,112909,0.58,34,183243,0.48,38,42575,47631,-10.61
2019,Slovak Republic,89509,0.47,38,90001,0.47,39,179510,0.47,39,492,-523,-194.07
2019,Romania,76871,0.4,40,96544,0.5,38,173415,0.45,40,19673,18087,8.77
2019,Portugal,67063,0.35,45,89538,0.46,40,156601,0.41,41,22475,20699,8.58
2019,Finland,73468,0.39,41,73716,0.38,43,147184,0.38,42,248,2755,-91.0
2019,Chile,68794,0.36,44,69855,0.36,45,138649,0.36,43,1061,-227,-567.4
2019,Iraq,80211,0.42,39,57581,0.3,49,137792,0.36,44,-22630,-39944,-43.35
2019,Israel,58507,0.31,50,76591,0.4,42,135098,0.35,45,18084,14646,23.47
2019,Nigeria,62531,0.33,49,55257,0.29,50,117788,0.31,46,-7274,-17540,-58.53
2019,Argentina,65116,0.34,47,49124,0.25,54,114240,0.3,47,-15992,3701,-532.1
2019,Ukraine,50054,0.26,52,60800,0.31,47,110854,0.29,48,10746,9852,9.07
2019,Iran,65718,0.35,46,41828,0.22,59,107546,0.28,49,-23890,-54069,-55.82
2019,Qatar,72935,0.38,42,29178,0.15,65,102113,0.27,50,-43757,-53209,-17.76
2019,Greece,37907,0.2,59,62384,0.32,46,100291,0.26,51,24477,24375,0.42
2019,Egypt,29000,0.15,67,70991,0.37,44,99991,0.26,52,41991,44376,-5.37
2019,Bangladesh,39337,0.21,57,59094,0.31,48,98431,0.26,53,19757,21243,-7.0
2019,"Kuwait, the State of",64483,0.34,48,33574,0.17,64,98057,0.26,54,-30909,-36074,-14.32
2019,Kazakhstan,57309,0.3,51,37757,0.2,61,95066,0.25,55,-19552,-28422,-31.21
2019,Colombia,39489,0.21,56,52703,0.27,51,92192,0.24,56,13214,9459,39.7
2019,Slovenia,44943,0.24,54,44007,0.23,56,88950,0.23,57,-936,-1933,-51.58
2019,Peru,46444,0.24,53,42284,0.22,58,88728,0.23,58,-4160,-4757,-12.55
2019,New Zealand,39517,0.21,55,42363,0.22,57,81880,0.21,59,2846,4120,-30.92
2019,Algeria,35312,0.19,61,44632,0.23,55,79944,0.21,60,9320,4533,105.6
2019,Morocco,29132,0.15,66,50734,0.26,52,79866,0.21,61,21602,22429,-3.69
2019,Pakistan,23329,0.12,68,50332,0.26,53,73661,0.19,62,27003,36653,-26.33
2019,Belarus,32955,0.17,64,39477,0.2,60,72432,0.19,63,6522,4683,39.27
2019,Bulgaria,33340,0.18,62,37663,0.2,62,71003,0.19,64,4323,4239,1.98
2019,Lithuania,33151,0.17,63,35759,0.19,63,68910,0.18,65,2608,3165,-17.6
2019,Oman,38724,0.2,58,23507,0.12,69,62231,0.16,66,-15217,-15991,-4.84
2019,Angola,35432,0.19,60,13962,0.07,87,49394,0.13,67,-21470,-24960,-13.98
2019,Serbia,19630,0.1,71,26730,0.14,67,46360,0.12,68,7100,6655,6.69
2019,Croatia,17180,0.09,75,28160,0.15,66,45340,0.12,69,10980,10801,1.66
2019,Ecuador,22329,0.12,69,22564,0.12,70,44893,0.12,70,235,1549,-84.83
2019,Libya,29250,0.15,65,15105,0.08,85,44355,0.12,71,-14145,-17253,-18.01
2019,Luxembourg,16451,0.09,76,24264,0.13,68,40715,0.11,72,7813,7763,0.64
2019,Uzbekistan,14930,0.08,81,21867,0.11,71,36797,0.1,73,6937,6391,8.54
2019,Myanmar,17997,0.09,73,18588,0.1,81,36585,0.1,74,591,2720,-78.27
2019,Tunisia,14933,0.08,80,21564,0.11,72,36497,0.1,75,6631,7163,-7.43
2019,Cambodia,14825,0.08,82,20279,0.11,74,35104,0.09,76,5454,4789,13.89
2019,Latvia,15705,0.08,78,18959,0.1,80,34664,0.09,77,3254,3515,-7.43
2019,Estonia,16101,0.08,77,18025,0.09,82,34126,0.09,78,1924,2123,-9.37
2019,Azerbaijan,19635,0.1,70,13668,0.07,88,33303,0.09,79,-5967,-8851,-32.58
2019,Panama,11318,0.06,87,21492,0.11,73,32810,0.09,80,10174,11526,-11.73
2019,Sri Lanka,11940,0.06,85,19937,0.1,76,31877,0.08,81,7997,10343,-22.68
2019,Dominican Republic,11193,0.06,88,20268,0.1,75,31461,0.08,82,9075,9559,-5.06
2019,"Bahrain, Kingdom of",18120,0.1,72,13256,0.07,90,31376,0.08,83,-4864,-3173,53.29
2019,Guatemala,11175,0.06,89,19882,0.1,77,31057,0.08,84,8707,8930,-2.5
2019,Costa Rica,11864,0.06,86,17573,0.09,84,29437,0.08,85,5709,6794,-15.97
2019,Ghana,15668,0.08,79,13411,0.07,89,29079,0.08,86,-2257,-1809,24.77
2019,Jordan,8317,0.04,94,19170,0.1,79,27487,0.07,87,10853,12560,-13.59
2019,Lebanese Republic,4829,0.03,113,19641,0.1,78,24470,0.06,88,14812,16566,-10.59
2019,Kenya,5839,0.03,105,17655,0.09,83,23494,0.06,89,11816,11326,4.33
2019,Côte d'Ivoire,12718,0.07,84,10483,0.05,97,23201,0.06,90,-2235,-942,137.26
2019,"Venezuela, Bolivarian Republic of",17210,0.09,74,5870,0.03,123,23080,0.06,91,-11340,-22730,-50.11
2019,Democratic Republic of the Congo,13382,0.07,83,8825,0.05,105,22207,0.06,92,-4557,-12074,-62.26
2019,Honduras,8788,0.05,92,12149,0.06,93,20937,0.05,93,3361,3818,-11.97
2019,Paraguay,7968,0.04,95,12544,0.06,91,20512,0.05,94,4576,4292,6.62
2019,"Bolivia, Plurinational State of",8757,0.05,93,9784,0.05,99,18541,0.05,95,1027,1031,-0.39
2019,Bosnia and Herzegovina,6578,0.03,103,11159,0.06,96,17737,0.05,96,4581,4448,2.99
2019,El Salvador,5905,0.03,104,11602,0.06,94,17507,0.05,97,5697,5559,2.48
2019,Ethiopia,2741,0.01,130,14554,0.08,86,17295,0.05,98,11813,12601,-6.25
2019,North Macedonia,7189,0.04,100,9471,0.05,101,16660,0.04,99,2282,2139,6.69
2019,Uruguay,7680,0.04,97,8246,0.04,106,15926,0.04,100,566,1395,-59.43
2019,Papua New Guinea,10946,0.06,90,4127,0.02,136,15073,0.04,101,-6819,-7005,-2.66
2019,Tanzania,5005,0.03,112,9452,0.05,102,14457,0.04,102,4447,5079,-12.44
2019,Zambia,7039,0.04,101,7173,0.04,111,14212,0.04,103,134,432,-68.98
2019,Mongolia,7620,0.04,98,6128,0.03,121,13748,0.04,104,-1492,-1137,31.22
2019,Turkmenistan,10605,0.06,91,2992,0.02,146,13597,0.04,105,-7613,-7370,3.3
2019,Trinidad and Tobago,7192,0.04,99,6334,0.03,118,13526,0.04,106,-858,-2813,-69.5
2019,Georgia,3798,0.02,121,9518,0.05,100,13316,0.03,107,5720,5982,-4.38
2019,Nepal,968,0.01,153,12340,0.06,92,13308,0.03,108,11372,11926,-4.65
2019,Sudan,3735,0.02,122,9291,0.05,103,13026,0.03,109,5556,4372,27.08
2019,"Macao, China",1586,0.01,145,11167,0.06,95,12753,0.03,110,9581,9652,-0.74
2019,Cyprus,3453,0.02,125,9127,0.05,104,12580,0.03,111,5674,5763,-1.54
2019,Mozambique,4787,0.03,114,7699,0.04,108,12486,0.03,112,2912,1693,72.0
2019,Senegal,4179,0.02,117,8144,0.04,107,12323,0.03,113,3965,4448,-10.86
2019,Brunei Darussalam,7039,0.04,101,5103,0.03,129,12142,0.03,114,-1936,-2410,-19.67
2019,Nicaragua,5272,0.03,109,6837,0.04,112,12109,0.03,115,1565,2337,-33.03
2019,Lao People's Democratic Republic,5806,0.03,106,6272,0.03,119,12078,0.03,116,466,907,-48.62
2019,Cuba,2062,0.01,139,9901,0.05,98,11963,0.03,117,7839,9111,-13.96
2019,Botswana,5237,0.03,110,6564,0.03,116,11801,0.03,118,1327,-269,-593.31
2019,Iceland,5223,0.03,111,6567,0.03,115,11790,0.03,119,1344,2123,-36.69
2019,Gabon,7714,0.04,96,3874,0.02,140,11588,0.03,120,-3840,-5091,-24.57
2019,Uganda,3564,0.02,124,7696,0.04,109,11260,0.03,121,4132,3642,13.45
2019,Namibia,4743,0.02,115,6197,0.03,120,10940,0.03,122,1454,801,81.52
2019,Cameroon,4084,0.02,118,6583,0.03,114,10667,0.03,123,2499,1853,34.86
2019,Malta,3178,0.02,127,7388,0.04,110,10566,0.03,124,4210,3577,17.7
2019,Zimbabwe,4269,0.02,116,4817,0.02,131,9086,0.02,125,548,2334,-76.52
2019,Mali,3675,0.02,123,5134,0.03,128,8809,0.02,126,1459,1138,28.21
2019,"Moldova, Republic of",2779,0.01,129,5843,0.03,124,8622,0.02,127,3064,3054,0.33
2019,Albania,2716,0.01,132,5897,0.03,122,8613,0.02,128,3181,3055,4.12
2019,Syrian Arab Republic,2730,0.01,131,5819,0.03,125,8549,0.02,129,3089,4292,-28.03
2019,Armenia,2640,0.01,134,5514,0.03,127,8154,0.02,130,2874,2551,12.66
2019,Djibouti,3996,0.02,119,4138,0.02,135,8134,0.02,131,142,81,75.31
2019,Jamaica,1651,0.01,143,6389,0.03,117,8040,0.02,132,4738,4210,12.54
2019,Mauritius,2223,0.01,137,5596,0.03,126,7819,0.02,133,3373,3295,2.37
2019,Congo,5576,0.03,107,2242,0.01,155,7818,0.02,134,-3334,-7669,-56.53
2019,Afghanistan,864,0.0,156,6777,0.04,113,7641,0.02,135,5913,6532,-9.48
2019,Burkina Faso,3239,0.02,126,4284,0.02,133,7523,0.02,136,1045,1047,-0.19
2019,Equatorial Guinea,5400,0.03,108,2100,0.01,157,7500,0.02,137,-3300,-3413,-3.31
2019,Guinea,3945,0.02,120,3470,0.02,142,7415,0.02,138,-475,-592,-19.76
2019,Benin,3052,0.02,128,3932,0.02,139,6984,0.02,139,880,1031,-14.65
2019,Kyrgyz Republic,1986,0.01,141,4989,0.03,130,6975,0.02,140,3003,3455,-13.08
2019,Madagascar,2696,0.01,133,3942,0.02,138,6638,0.02,141,1246,951,31.02
2019,Mauritania,2266,0.01,136,3520,0.02,141,5786,0.02,142,1254,1131,10.88
2019,Guyana,1567,0.01,146,4040,0.02,137,5607,0.01,143,2473,1071,130.91
2019,Haiti,1202,0.01,148,4182,0.02,134,5384,0.01,144,2980,3744,-20.41
2019,Yemen,652,0.0,159,4721,0.02,132,5373,0.01,145,4069,2742,48.4
2019,New Caledonia,1700,0.01,142,2944,0.02,148,4644,0.01,146,1244,876,42.01
2019,Tajikistan,1174,0.01,149,3349,0.02,144,4523,0.01,147,2175,2078,4.67
2019,Chad,2588,0.01,135,1924,0.01,159,4512,0.01,148,-664,-699,-5.01
2019,Niger,1126,0.01,150,2931,0.02,149,4057,0.01,149,1805,1673,7.89
2019,Somalia,570,0.0,161,3358,0.02,143,3928,0.01,150,2788,2416,15.4
2019,Rwanda,1241,0.01,147,2659,0.01,154,3900,0.01,151,1418,1342,5.66
2019,Suriname,2155,0.01,138,1711,0.01,162,3866,0.01,152,-444,-653,-32.01
2019,Bahamas,537,0.0,163,3321,0.02,145,3858,0.01,153,2784,3008,-7.45
2019,Eswatini,2002,0.01,140,1832,0.01,160,3834,0.01,154,-170,16,-1162.5
2019,Malawi,899,0.0,155,2892,0.01,151,3791,0.01,155,1993,1848,7.85
2019,Fiji,1033,0.01,152,2734,0.01,153,3767,0.01,156,1701,1679,1.31
2019,Montenegro,465,0.0,166,2909,0.02,150,3374,0.01,157,2444,2538,-3.7
2019,"Korea, Democratic People's Republic of",280,0.0,173,2977,0.02,147,3257,0.01,158,2697,2370,13.8
2019,Maldives,361,0.0,171,2888,0.01,152,3249,0.01,159,2527,2621,-3.59
2019,Togo,1055,0.01,151,2091,0.01,158,3146,0.01,160,1036,1036,0.0
2019,Lesotho,919,0.0,154,1734,0.01,161,2653,0.01,161,815,964,-15.46
2019,French Polynesia,133,0.0,179,2102,0.01,156,2235,0.01,162,1969,2084,-5.52
2019,Sierra Leone,635,0.0,160,1502,0.01,165,2137,0.01,163,867,800,8.38
2019,Barbados,444,0.0,168,1581,0.01,163,2025,0.01,164,1137,1130,0.62
2019,Curaçao,398,0.0,170,1461,0.01,166,1859,0.0,165,1063,1171,-9.22
2019,Greenland,826,0.0,157,986,0.01,173,1812,0.0,166,160,130,23.08
2019,Seychelles,518,0.0,165,1167,0.01,169,1685,0.0,167,649,702,-7.55
2019,Bhutan,674,0.0,158,981,0.01,175,1655,0.0,168,307,442,-30.54
2019,South Sudan,1613,0.01,144,0,0.0,212,1613,0.0,169,-1613,,
2019,Liberia,543,0.0,162,1033,0.01,172,1576,0.0,170,490,595,-17.65
2019,Andorra,0,0.0,210,1539,0.01,164,1539,0.0,171,1539,1480,3.99
2019,Cayman Islands,50,0.0,187,1428,0.01,167,1478,0.0,172,1378,1210,13.88
2019,Belize,425,0.0,169,986,0.01,173,1411,0.0,173,561,507,10.65
2019,"Aruba, Netherlands with respect to",131,0.0,181,1206,0.01,168,1337,0.0,174,1075,1038,3.56
2019,Bermuda,27,0.0,195,1118,0.01,170,1145,0.0,175,1091,1083,0.74
2019,Sint Maarten,181,0.0,175,928,0.0,176,1109,0.0,176,747,771,-3.11
2019,Eritrea,530,0.0,164,565,0.0,187,1095,0.0,177,35,396,-91.16
2019,Guam,32,0.0,194,1050,0.01,171,1082,0.0,178,1018,1036,-1.74
2019,Burundi,180,0.0,176,887,0.0,177,1067,0.0,179,707,613,15.33
2019,American Samoa,353,0.0,172,712,0.0,179,1065,0.0,180,359,276,30.07
2019,Solomon Islands,461,0.0,167,590,0.0,186,1051,0.0,181,129,32,303.13
2019,Cabo Verde,62,0.0,183,796,0.0,178,858,0.0,182,734,740,-0.81
2019,Central African Republic,148,0.0,178,613,0.0,182,761,0.0,183,465,442,5.2
2019,The Gambia,133,0.0,179,621,0.0,181,754,0.0,184,488,537,-9.12
2019,Timor-Leste,154,0.0,177,591,0.0,185,745,0.0,185,437,475,-8.0
2019,Antigua and Barbuda,38,0.0,192,701,0.0,180,739,0.0,186,663,673,-1.49
2019,Saint Lucia,82,0.0,182,598,0.0,183,680,0.0,187,516,597,-13.57
2019,Guinea-Bissau,249,0.0,174,385,0.0,190,634,0.0,188,136,6,2166.67
2019,Northern Mariana Islands,5,0.0,205,592,0.0,184,597,0.0,189,587,586,0.17
2019,Grenada,34,0.0,193,480,0.0,188,514,0.0,190,446,436,2.29
2019,Samoa,49,0.0,188,391,0.0,189,440,0.0,191,342,317,7.89
2019,Vanuatu,56,0.0,185,357,0.0,191,413,0.0,192,301,329,-8.51
2019,Saint Kitts and Nevis,58,0.0,184,338,0.0,193,396,0.0,193,280,281,-0.36
2019,Saint Vincent and the Grenadines,39,0.0,190,335,0.0,194,374,0.0,194,296,310,-4.52
2019,Turks and Caicos Islands,3,0.0,207,352,0.0,192,355,0.0,195,349,358,-2.51
2019,Dominica,19,0.0,197,319,0.0,195,338,0.0,196,300,292,2.74
2019,Comoros,39,0.0,190,265,0.0,196,304,0.0,197,226,202,11.88
2019,Tonga,20,0.0,196,238,0.0,197,258,0.0,198,218,217,0.46
2019,"Micronesia, Federated States of",41,0.0,189,215,0.0,199,256,0.0,199,174,151,15.23
2019,Anguilla,12,0.0,201,228,0.0,198,240,0.0,200,216,222,-2.7
2019,Palau,4,0.0,206,193,0.0,200,197,0.0,201,189,172,9.88
2019,Sao Tomé and Principe,13,0.0,200,148,0.0,201,161,0.0,202,135,132,2.27
2019,Cook Islands,17,0.0,198,136,0.0,202,153,0.0,203,119,116,2.59
2019,Kiribati,12,0.0,201,132,0.0,203,144,0.0,204,120,114,5.26
2019,Marshall Islands,55,0.0,186,68,0.0,207,123,0.0,205,13,34,-61.76
2019,Nauru,14,0.0,199,104,0.0,204,118,0.0,206,90,38,136.84
2019,Saint Pierre and Miquelon,8,0.0,203,98,0.0,205,106,0.0,207,90,90,0.0
2019,"Bonaire, Sint Eustatius and Saba",1,0.0,209,90,0.0,206,91,0.0,208,89,92,-3.26
2019,Wallis and Futuna Islands,0,0.0,210,63,0.0,208,63,0.0,209,63,65,-3.08
2019,Montserrat,6,0.0,204,33,0.0,209,39,0.0,210,27,29,-6.9
2019,Tuvalu,0,0.0,210,33,0.0,209,33,0.0,211,33,25,32.0
2019,Niue,2,0.0,208,14,0.0,211,16,0.0,212,12,16,-25.0
2019,Tokelau,0,0.0,210,0,0.0,212,0,0.0,213,0,0,
2018,China,2486695,12.72,1,2135748,10.79,2,4622443,11.75,1,-350947,-419554,-16.35
2018,United States of America,1663982,8.51,2,2614221,13.2,1,4278203,10.87,2,950239,862203,10.21
2018,Germany,1560539,7.98,3,1284353,6.49,3,2844892,7.23,3,-276186,-285284,-3.19
2018,Japan,738143,3.78,4,748488,3.78,4,1486631,3.78,4,10345,-26233,-139.44
2018,Netherlands,726697,3.72,5,645502,3.26,7,1372199,3.49,5,-81195,-77419,4.88
2018,France,582222,2.98,7,676441,3.42,5,1258663,3.2,6,94219,84036,12.12
2018,"Hong Kong, China",568456,2.91,8,626616,3.16,8,1195072,3.04,7,58160,39048,48.94
2018,United Kingdom,486439,2.49,10,672450,3.4,6,1158889,2.95,8,186011,200005,-7.0
2018,"Korea, Republic of",604860,3.09,6,535202,2.7,9,1140062,2.9,9,-69658,-95216,-26.84
2018,Italy,549526,2.81,9,503240,2.54,11,1052766,2.68,10,-46286,-54296,-14.75
2018,Mexico,450713,2.31,13,476835,2.41,12,927548,2.36,11,26122,22746,14.84
2018,Belgium,468213,2.4,11,455188,2.3,14,923401,2.35,12,-13025,-20425,-36.23
2018,Canada,452313,2.31,12,469106,2.37,13,921419,2.34,13,16793,22986,-26.94
2018,India,324778,1.66,19,514464,2.6,10,839242,2.13,14,189686,150684,25.88
2018,Singapore,412955,2.11,15,370881,1.87,16,783836,1.99,15,-42074,-45523,-7.58
2018,Spain,346754,1.77,17,390562,1.97,15,737316,1.87,16,43808,32450,35.0
2018,Russian Federation,443914,2.27,14,248856,1.26,20,692770,1.76,17,-195058,-114559,70.27
2018,United Arab Emirates,387964,1.99,16,244688,1.24,22,632652,1.61,18,-143276,-55870,156.45
2018,Chinese Taipei,335909,1.72,18,286333,1.45,17,622242,1.58,19,-49576,-57983,-14.5
2018,Switzerland,310749,1.59,20,279528,1.41,18,590277,1.5,20,-31221,-29769,4.88
2018,Poland,263569,1.35,22,268959,1.36,19,532528,1.35,21,5390,-552,-1076.45
2018,Thailand,252957,1.29,24,248201,1.25,21,501158,1.27,22,-4756,-15116,-68.54
2018,Australia,257098,1.32,23,235386,1.19,24,492484,1.25,23,-21712,-2351,823.52
2018,Viet Nam,243699,1.25,26,236862,1.2,23,480561,1.22,24,-6837,-2095,226.35
2018,Malaysia,247455,1.27,25,217602,1.1,26,465057,1.18,25,-29853,-22713,31.44
2018,"Saudi Arabia, Kingdom of",294373,1.51,21,137065,0.69,32,431438,1.1,26,-157308,-87316,80.16
2018,Brazil,231890,1.19,27,192840,0.97,28,424730,1.08,27,-39050,-49133,-20.52
2018,Türkiye,177169,0.91,31,231152,1.17,25,408321,1.04,28,53983,74220,-27.27
2018,Czech Republic,202238,1.03,28,184659,0.93,30,386897,0.98,29,-17579,-18790,-6.44
2018,Austria,184815,0.95,29,193722,0.98,27,378537,0.96,30,8907,7729,15.24
2018,Indonesia,180124,0.92,30,188708,0.95,29,368832,0.94,31,8584,-11886,-172.22
2018,Sweden,165968,0.85,32,170605,0.86,31,336573,0.86,32,4637,1295,258.07
2018,Ireland,164794,0.84,33,107669,0.54,36,272463,0.69,33,-57125,-44161,29.36
2018,Hungary,124705,0.64,34,120741,0.61,33,245446,0.62,34,-3964,-6287,-36.95
2018,Denmark,109696,0.56,36,102754,0.52,37,212450,0.54,35,-6942,-9549,-27.3
2018,Norway,121791,0.62,35,86600,0.44,41,208391,0.53,36,-35191,-19805,77.69
2018,South Africa,93970,0.48,38,113971,0.58,35,207941,0.53,37,20001,12629,58.37
2018,Slovak Republic,93425,0.48,39,92902,0.47,39,186327,0.47,38,-523,-1797,-70.9
2018,Philippines,67488,0.35,47,115119,0.58,34,182607,0.46,39,47631,33189,43.51
2018,Romania,79660,0.41,42,97747,0.49,38,177407,0.45,40,18087,14725,22.83
2018,Portugal,68361,0.35,46,89060,0.45,40,157421,0.4,41,20699,16633,24.45
2018,Finland,75869,0.39,43,78624,0.4,42,154493,0.39,42,2755,2513,9.63
2018,Iran,103422,0.53,37,49353,0.25,53,152775,0.39,43,-54069,-43265,24.97
2018,Chile,74839,0.38,44,74612,0.38,44,149451,0.38,44,-227,-3593,-93.68
2018,Israel,61952,0.32,48,76598,0.39,43,138550,0.35,45,14646,7977,83.6
2018,Iraq,86360,0.44,40,46416,0.23,54,132776,0.34,46,-39944,-19493,104.91
2018,Argentina,61781,0.32,49,65482,0.33,46,127263,0.32,47,3701,8293,-55.37
2018,Qatar,84905,0.43,41,31696,0.16,65,116601,0.3,48,-53209,-37602,41.51
2018,"Kuwait, the State of",71938,0.37,45,35864,0.18,63,107802,0.27,49,-36074,-21442,68.24
2018,Ukraine,47336,0.24,53,57188,0.29,50,104524,0.27,50,9852,6344,55.3
2018,Nigeria,60547,0.31,51,43007,0.22,58,103554,0.26,51,-17540,-13195,32.93
2018,Greece,39502,0.2,60,63877,0.32,47,103379,0.26,52,24375,20868,16.81
2018,Bangladesh,39252,0.2,61,60495,0.31,48,99747,0.25,53,21243,16985,25.07
2018,Egypt,27624,0.14,68,72000,0.36,45,99624,0.25,54,44376,36023,23.19
2018,Kazakhstan,60956,0.31,50,32534,0.16,64,93490,0.24,55,-28422,-19038,49.29
2018,Colombia,41774,0.21,56,51233,0.26,51,93007,0.24,56,9459,9179,3.05
2018,Peru,48019,0.25,52,43262,0.22,57,91281,0.23,57,-4757,-3569,33.29
2018,Algeria,41797,0.21,55,46330,0.23,55,88127,0.22,58,4533,10868,-58.29
2018,Slovenia,44200,0.23,54,42267,0.21,59,86467,0.22,59,-1933,-2365,-18.27
2018,Pakistan,23425,0.12,69,60078,0.3,49,83503,0.21,60,36653,36177,1.32
2018,New Zealand,39673,0.2,59,43793,0.22,56,83466,0.21,61,4120,2050,100.98
2018,Morocco,28609,0.15,67,51038,0.26,52,79647,0.2,62,22429,19218,16.71
2018,Belarus,33726,0.17,63,38409,0.19,60,72135,0.18,63,4683,4964,-5.66
2018,Bulgaria,33617,0.17,64,37856,0.19,61,71473,0.18,64,4239,2746,54.37
2018,Lithuania,33337,0.17,65,36502,0.18,62,69839,0.18,65,3165,2357,34.28
2018,Oman,41761,0.21,57,25770,0.13,68,67531,0.17,66,-15991,-6469,147.19
2018,Angola,40758,0.21,58,15798,0.08,85,56556,0.14,67,-24960,-20150,23.87
2018,"Venezuela, Bolivarian Republic of",34440,0.18,62,11710,0.06,93,46150,0.12,68,-22730,-21390,6.26
2018,Croatia,17402,0.09,75,28203,0.14,66,45605,0.12,69,10801,8760,23.3
2018,Serbia,19227,0.1,73,25882,0.13,67,45109,0.11,70,6655,4955,34.31
2018,Ecuador,21628,0.11,70,23177,0.12,70,44805,0.11,71,1549,888,74.44
2018,Libya,30994,0.16,66,13741,0.07,88,44735,0.11,72,-17253,-11475,50.35
2018,Luxembourg,16412,0.08,78,24175,0.12,69,40587,0.1,73,7763,7115,9.11
2018,Tunisia,15535,0.08,80,22698,0.11,72,38233,0.1,74,7163,6450,11.05
2018,Estonia,17017,0.09,76,19140,0.1,80,36157,0.09,75,2123,2115,0.38
2018,Myanmar,16614,0.09,77,19334,0.1,79,35948,0.09,76,2720,5374,-49.39
2018,Latvia,16166,0.08,79,19681,0.1,78,35847,0.09,77,3515,2907,20.92
2018,Panama,11480,0.06,86,23006,0.12,71,34486,0.09,78,11526,10841,6.32
2018,Sri Lanka,11890,0.06,84,22233,0.11,73,34123,0.09,79,10343,9620,7.52
2018,"Bahrain, Kingdom of",18044,0.09,74,14871,0.08,87,32915,0.08,80,-3173,-2231,42.22
2018,Azerbaijan,20317,0.1,71,11466,0.06,96,31783,0.08,81,-8851,-6698,32.14
2018,Dominican Republic,10638,0.05,90,20197,0.1,76,30835,0.08,82,9559,7599,25.79
2018,Guatemala,10769,0.06,89,19699,0.1,77,30468,0.08,83,8930,7398,20.71
2018,Cambodia,12700,0.06,82,17489,0.09,82,30189,0.08,84,4789,3005,59.37
2018,Costa Rica,11495,0.06,85,18289,0.09,81,29784,0.08,85,6794,6027,12.73
2018,Uzbekistan,10921,0.06,88,17312,0.09,84,28233,0.07,86,6391,1956,226.74
2018,Ghana,14943,0.08,81,13134,0.07,90,28077,0.07,87,-1809,-1188,52.27
2018,Jordan,7750,0.04,99,20310,0.1,75,28060,0.07,88,12560,12987,-3.29
2018,Democratic Republic of the Congo,20004,0.1,72,7930,0.04,109,27934,0.07,89,-12074,-6493,85.95
2018,Lebanese Republic,3830,0.02,118,20396,0.1,74,24226,0.06,90,16566,15885,4.29
2018,Kenya,6052,0.03,108,17378,0.09,83,23430,0.06,91,11326,10940,3.53
2018,Côte d'Ivoire,11912,0.06,83,10970,0.06,99,22882,0.06,92,-942,-2239,-57.93
2018,Paraguay,9042,0.05,94,13334,0.07,89,22376,0.06,93,4292,3195,34.33
2018,Honduras,8644,0.04,97,12462,0.06,92,21106,0.05,94,3818,2753,38.69
2018,"Bolivia, Plurinational State of",8965,0.05,96,9996,0.05,101,18961,0.05,95,1031,1442,-28.5
2018,Bosnia and Herzegovina,7182,0.04,102,11630,0.06,94,18812,0.05,96,4448,4102,8.43
2018,Zambia,9034,0.05,95,9466,0.05,102,18500,0.05,97,432,-12,-3700.0
2018,Trinidad and Tobago,10532,0.05,91,7719,0.04,112,18251,0.05,98,-2813,-1848,52.22
2018,Ethiopia,2704,0.01,133,15305,0.08,86,18009,0.05,99,12601,12739,-1.08
2018,El Salvador,5905,0.03,110,11464,0.06,97,17369,0.04,100,5559,4812,15.52
2018,Uruguay,7498,0.04,100,8893,0.04,106,16391,0.04,101,1395,570,144.74
2018,North Macedonia,6911,0.04,104,9050,0.05,105,15961,0.04,102,2139,2055,4.09
2018,Cyprus,5052,0.03,113,10815,0.05,100,15867,0.04,103,5763,5943,-3.03
2018,Namibia,7488,0.04,101,8289,0.04,107,15777,0.04,104,801,1549,-48.29
2018,Congo,11155,0.06,87,3486,0.02,140,14641,0.04,105,-7669,-3692,107.72
2018,Papua New Guinea,10524,0.05,92,3519,0.02,138,14043,0.04,106,-7005,-6893,1.62
2018,Cuba,2373,0.01,136,11484,0.06,95,13857,0.04,107,9111,7770,17.26
2018,Mozambique,6037,0.03,109,7730,0.04,111,13767,0.03,108,1693,986,71.7
2018,Nepal,786,0.0,155,12712,0.06,91,13498,0.03,109,11926,9603,24.19
2018,Iceland,5556,0.03,111,7679,0.04,113,13235,0.03,110,2123,2087,1.72
2018,Tanzania,4041,0.02,116,9120,0.05,104,13161,0.03,111,5079,4186,21.33
2018,Mongolia,7012,0.04,103,5875,0.03,124,12887,0.03,112,-1137,-1864,-39.0
2018,Botswana,6575,0.03,105,6306,0.03,121,12881,0.03,113,-269,-541,-50.28
2018,Georgia,3380,0.02,124,9362,0.05,103,12742,0.03,114,5982,5311,12.63
2018,"Macao, China",1510,0.01,144,11162,0.06,98,12672,0.03,115,9652,8045,19.98
2018,Nicaragua,5014,0.03,114,7351,0.04,115,12365,0.03,116,2337,2538,-7.92
2018,Turkmenistan,9760,0.05,93,2390,0.01,156,12150,0.03,117,-7370,-2887,155.28
2018,Gabon,8584,0.04,98,3493,0.02,139,12077,0.03,118,-5091,-1926,164.33
2018,Lao People's Democratic Republic,5408,0.03,112,6315,0.03,120,11723,0.03,119,907,794,14.23
2018,Senegal,3623,0.02,120,8071,0.04,108,11694,0.03,120,4448,3740,18.93
2018,Sudan,3478,0.02,123,7850,0.04,110,11328,0.03,121,4372,5034,-13.15
2018,Brunei Darussalam,6574,0.03,106,4164,0.02,134,10738,0.03,122,-2410,-2486,-3.06
2018,Zimbabwe,4057,0.02,115,6391,0.03,119,10448,0.03,123,2334,1583,47.44
2018,Malta,3192,0.02,127,6769,0.03,117,9961,0.03,124,3577,3139,13.95
2018,Syrian Arab Republic,2819,0.01,131,7111,0.04,116,9930,0.03,125,4292,3598,19.29
2018,Uganda,3087,0.02,129,6729,0.03,118,9816,0.02,126,3642,2695,35.14
2018,Equatorial Guinea,6500,0.03,107,3087,0.02,145,9587,0.02,127,-3413,-2358,44.74
2018,Cameroon,3803,0.02,119,5656,0.03,127,9459,0.02,128,1853,1563,18.55
2018,Albania,2870,0.01,130,5925,0.03,123,8795,0.02,129,3055,2979,2.55
2018,"Moldova, Republic of",2706,0.01,132,5760,0.03,125,8466,0.02,130,3054,2406,26.93
2018,Mali,3584,0.02,121,4722,0.02,131,8306,0.02,131,1138,1390,-18.13
2018,Afghanistan,875,0.0,153,7407,0.04,114,8282,0.02,132,6532,6342,3.0
2018,Jamaica,1961,0.01,140,6171,0.03,122,8132,0.02,133,4210,4508,-6.61
2018,Mauritius,2366,0.01,137,5661,0.03,126,8027,0.02,134,3295,2912,13.15
2018,Benin,3344,0.02,125,4375,0.02,132,7719,0.02,135,1031,1278,-19.33
2018,Burkina Faso,3254,0.02,126,4301,0.02,133,7555,0.02,136,1047,986,6.19
2018,Armenia,2412,0.01,135,4963,0.03,129,7375,0.02,137,2551,1944,31.22
2018,Guinea,3978,0.02,117,3386,0.02,141,7364,0.02,138,-592,-1110,-46.67
2018,Madagascar,3110,0.02,128,4061,0.02,135,7171,0.02,139,951,822,15.69
2018,Kyrgyz Republic,1837,0.01,143,5292,0.03,128,7129,0.02,140,3455,2731,26.51
2018,Djibouti,3522,0.02,122,3603,0.02,136,7125,0.02,141,81,414,-80.43
2018,Haiti,1078,0.01,150,4822,0.02,130,5900,0.01,142,3744,2910,28.66
2018,Mauritania,2052,0.01,139,3183,0.02,143,5235,0.01,143,1131,1533,-26.22
2018,New Caledonia,1929,0.01,141,2805,0.01,150,4734,0.01,144,876,950,-7.79
2018,Chad,2670,0.01,134,1971,0.01,160,4641,0.01,145,-699,-770,-9.22
2018,Tajikistan,1073,0.01,151,3151,0.02,144,4224,0.01,146,2078,1577,31.77
2018,Niger,1202,0.01,147,2875,0.01,149,4077,0.01,147,1673,1253,33.52
2018,Bahamas,513,0.0,166,3521,0.02,137,4034,0.01,148,3008,2955,1.79
2018,Yemen,570,0.0,160,3312,0.02,142,3882,0.01,149,2742,2670,2.7
2018,Fiji,1041,0.01,152,2720,0.01,151,3761,0.01,150,1679,1464,14.69
2018,Guyana,1339,0.01,145,2410,0.01,155,3749,0.01,151,1071,207,417.39
2018,Suriname,2180,0.01,138,1527,0.01,165,3707,0.01,152,-653,-712,-8.29
2018,Eswatini,1842,0.01,142,1858,0.01,161,3700,0.01,153,16,-189,-108.47
2018,Rwanda,1122,0.01,148,2464,0.01,154,3586,0.01,154,1342,1175,14.21
2018,Malawi,838,0.0,154,2686,0.01,152,3524,0.01,155,1848,1712,7.94
2018,Somalia,534,0.0,165,2950,0.01,148,3484,0.01,156,2416,2434,-0.74
2018,Montenegro,472,0.0,167,3010,0.02,146,3482,0.01,157,2538,2192,15.78
2018,Lesotho,1221,0.01,146,2185,0.01,158,3406,0.01,158,964,1038,-7.13
2018,Maldives,339,0.0,171,2960,0.01,147,3299,0.01,159,2621,2042,28.35
2018,Togo,1080,0.01,149,2116,0.01,159,3196,0.01,160,1036,858,20.75
2018,"Korea, Democratic People's Republic of",251,0.0,173,2621,0.01,153,2872,0.01,161,2370,2011,17.85
2018,French Polynesia,148,0.0,177,2232,0.01,157,2380,0.01,162,2084,1484,40.43
2018,Curaçao,586,0.0,159,1757,0.01,162,2343,0.01,163,1171,1044,12.16
2018,Barbados,448,0.0,169,1578,0.01,164,2026,0.01,164,1130,1115,1.35
2018,Sierra Leone,554,0.0,163,1354,0.01,166,1908,0.0,165,800,734,8.99
2018,Seychelles,569,0.0,161,1271,0.01,167,1840,0.0,166,702,755,-7.02
2018,Andorra,129,0.0,180,1609,0.01,163,1738,0.0,167,1480,1360,8.82
2018,Eritrea,669,0.0,157,1065,0.01,173,1734,0.0,168,396,443,-10.61
2018,Liberia,548,0.0,164,1143,0.01,170,1691,0.0,169,595,731,-18.6
2018,Bhutan,606,0.0,158,1048,0.01,174,1654,0.0,170,442,456,-3.07
2018,Greenland,699,0.0,156,829,0.0,177,1528,0.0,171,130,164,-20.73
2018,"Aruba, Netherlands with respect to",194,0.0,174,1232,0.01,169,1426,0.0,172,1038,989,4.95
2018,Belize,451,0.0,168,958,0.0,175,1409,0.0,173,507,459,10.46
2018,Cayman Islands,41,0.0,189,1251,0.01,168,1292,0.0,174,1210,1059,14.26
2018,Solomon Islands,569,0.0,161,601,0.0,185,1170,0.0,175,32,72,-55.56
2018,Bermuda,18,0.0,195,1101,0.01,171,1119,0.0,176,1083,1077,0.56
2018,Guam,34,0.0,192,1070,0.01,172,1104,0.0,177,1036,727,42.5
2018,Sint Maarten,148,0.0,177,919,0.0,176,1067,0.0,178,771,638,20.85
2018,American Samoa,377,0.0,170,653,0.0,183,1030,0.0,179,276,198,39.39
2018,Burundi,180,0.0,175,793,0.0,179,973,0.0,180,613,583,5.15
2018,Cabo Verde,76,0.0,181,816,0.0,178,892,0.0,181,740,739,0.14
2018,The Gambia,140,0.0,179,677,0.0,181,817,0.0,182,537,424,26.65
2018,Central African Republic,164,0.0,176,606,0.0,184,770,0.0,183,442,348,27.01
2018,Antigua and Barbuda,26,0.0,194,699,0.0,180,725,0.0,184,673,533,26.27
2018,Saint Lucia,62,0.0,182,659,0.0,182,721,0.0,185,597,528,13.07
2018,Guinea-Bissau,339,0.0,171,345,0.0,193,684,0.0,186,6,14,-57.14
2018,Northern Mariana Islands,5,0.0,204,591,0.0,186,596,0.0,187,586,620,-5.48
2018,Timor-Leste,45,0.0,187,520,0.0,187,565,0.0,188,475,531,-10.55
2018,Grenada,31,0.0,193,467,0.0,188,498,0.0,189,436,390,11.79
2018,Vanuatu,61,0.0,183,390,0.0,189,451,0.0,190,329,323,1.86
2018,Samoa,46,0.0,186,363,0.0,190,409,0.0,191,317,312,1.6
2018,Saint Vincent and the Grenadines,44,0.0,188,354,0.0,192,398,0.0,192,310,288,7.64
2018,Saint Kitts and Nevis,54,0.0,184,335,0.0,194,389,0.0,193,281,259,8.49
2018,Turks and Caicos Islands,4,0.0,206,362,0.0,191,366,0.0,194,358,366,-2.19
2018,Dominica,10,0.0,200,302,0.0,195,312,0.0,195,292,186,56.99
2018,Comoros,41,0.0,189,243,0.0,196,284,0.0,196,202,214,-5.61
2018,Anguilla,12,0.0,199,234,0.0,197,246,0.0,197,222,211,5.21
2018,"Micronesia, Federated States of",47,0.0,185,198,0.0,199,245,0.0,198,151,137,10.22
2018,Tonga,13,0.0,198,230,0.0,198,243,0.0,199,217,212,2.36
2018,Palau,4,0.0,206,176,0.0,200,180,0.0,200,172,176,-2.27
2018,Sao Tomé and Principe,16,0.0,197,148,0.0,201,164,0.0,201,132,131,0.76
2018,Cook Islands,18,0.0,195,134,0.0,202,152,0.0,202,116,115,0.87
2018,Kiribati,8,0.0,202,122,0.0,203,130,0.0,203,114,116,-1.72
2018,Marshall Islands,41,0.0,189,75,0.0,206,116,0.0,204,34,50,-32.0
2018,Saint Pierre and Miquelon,7,0.0,203,97,0.0,204,104,0.0,205,90,94,-4.26
2018,"Bonaire, Sint Eustatius and Saba",1,0.0,209,93,0.0,205,94,0.0,206,92,85,8.24
2018,Wallis and Futuna Islands,0,0.0,210,65,0.0,207,65,0.0,207,65,65,0.0
2018,Nauru,9,0.0,201,47,0.0,208,56,0.0,208,38,28,35.71
2018,Montserrat,5,0.0,204,34,0.0,209,39,0.0,209,29,24,20.83
2018,Tuvalu,0,0.0,210,25,0.0,210,25,0.0,210,25,27,-7.41
2018,Niue,2,0.0,208,18,0.0,211,20,0.0,211,16,13,23.08
2018,Tokelau,0,0.0,210,0,0.0,212,0,0.0,212,0,0,
2017,China,2263346,12.76,1,1843792,10.27,2,4107138,11.51,1,-419554,-509707,-17.69
2017,United States of America,1546273,8.72,2,2408476,13.41,1,3954749,11.08,2,862203,799143,7.89
2017,Germany,1448191,8.17,3,1162907,6.48,3,2611098,7.32,3,-285284,-279029,2.24
2017,Japan,698329,3.94,4,672096,3.74,4,1370425,3.84,4,-26233,-37324,-29.72
2017,Netherlands,652065,3.68,5,574646,3.2,8,1226711,3.44,5,-77419,-69809,10.9
2017,France,535298,3.02,8,619334,3.45,6,1154632,3.24,6,84036,66478,26.41
2017,"Hong Kong, China",549865,3.1,7,588913,3.28,7,1138778,3.19,7,39048,29885,30.66
2017,United Kingdom,440997,2.49,10,641002,3.57,5,1081999,3.03,8,200005,225875,-11.45
2017,"Korea, Republic of",573694,3.24,6,478478,2.66,9,1052172,2.95,9,-95216,-89233,6.7
2017,Italy,507418,2.86,9,453122,2.52,10,960540,2.69,10,-54296,-54949,-1.19
2017,Canada,420665,2.37,12,443651,2.47,12,864316,2.42,11,22986,22949,0.16
2017,Mexico,409433,2.31,13,432179,2.41,13,841612,2.36,12,22746,23574,-3.51
2017,Belgium,429645,2.42,11,409220,2.28,14,838865,2.35,13,-20425,-18725,9.08
2017,India,299241,1.69,20,449925,2.51,11,749166,2.1,14,150684,97107,55.17
2017,Singapore,373446,2.11,14,327923,1.83,16,701369,1.97,15,-45523,-47142,-3.43
2017,Spain,319531,1.8,16,351981,1.96,15,671512,1.88,16,32450,20940,54.97
2017,Russian Federation,352943,1.99,15,238384,1.33,21,591327,1.66,17,-114559,-90217,26.98
2017,Chinese Taipei,317249,1.79,17,259266,1.44,18,576515,1.62,18,-57983,-49753,16.54
2017,United Arab Emirates,313603,1.77,18,257733,1.44,19,571336,1.6,19,-55870,-28455,96.35
2017,Switzerland,299603,1.69,19,269834,1.5,17,569437,1.6,20,-29769,-32772,-9.16
2017,Poland,234364,1.32,22,233812,1.3,22,468176,1.31,21,-552,-4311,-87.2
2017,Australia,231131,1.3,23,228780,1.27,23,459911,1.29,22,-2351,3765,-162.44
2017,Thailand,236635,1.33,21,221519,1.23,24,458154,1.28,23,-15116,-21190,-28.66
2017,Viet Nam,215014,1.21,26,212919,1.19,25,427933,1.2,24,-2095,-1777,17.9
2017,Malaysia,218130,1.23,25,195417,1.09,26,413547,1.16,25,-22713,-21059,7.85
2017,Türkiye,164495,0.93,31,238715,1.33,20,403210,1.13,26,74220,52942,40.19
2017,Brazil,214988,1.21,27,165855,0.92,28,380843,1.07,27,-49133,-34278,43.34
2017,"Saudi Arabia, Kingdom of",221835,1.25,24,134519,0.75,32,356354,1.0,28,-87316,-43409,101.15
2017,Czech Republic,182142,1.03,28,163352,0.91,29,345494,0.97,29,-18790,-19652,-4.39
2017,Austria,168026,0.95,30,175755,0.98,27,343781,0.96,30,7729,5607,37.85
2017,Indonesia,168811,0.95,29,156925,0.87,30,325736,0.91,31,-11886,-8837,34.5
2017,Sweden,152920,0.86,32,154215,0.86,31,307135,0.86,32,1295,1731,-25.19
2017,Ireland,137359,0.77,33,93198,0.52,36,230557,0.65,33,-44161,-49679,-11.11
2017,Hungary,113806,0.64,34,107519,0.6,33,221325,0.62,34,-6287,-8039,-21.79
2017,Denmark,102506,0.58,35,92957,0.52,37,195463,0.55,35,-9549,-9813,-2.69
2017,South Africa,88947,0.5,38,101576,0.57,35,190523,0.53,36,12629,15478,-18.41
2017,Norway,101054,0.57,36,81249,0.45,40,182303,0.51,37,-19805,-16300,21.5
2017,Philippines,68713,0.39,42,101902,0.57,34,170615,0.48,38,33189,29622,12.04
2017,Slovak Republic,83414,0.47,39,81617,0.45,39,165031,0.46,39,-1797,-2380,-24.5
2017,Romania,70761,0.4,40,85486,0.48,38,156247,0.44,40,14725,11026,33.55
2017,Iran,92764,0.52,37,49499,0.28,51,142263,0.4,41,-43265,-29823,45.07
2017,Portugal,62130,0.35,45,78763,0.44,41,140893,0.39,42,16633,12582,32.2
2017,Finland,68073,0.38,43,70586,0.39,42,138659,0.39,43,2513,2933,-14.32
2017,Chile,68823,0.39,41,65230,0.36,45,134053,0.38,44,-3593,-1342,167.73
2017,Israel,61150,0.34,46,69127,0.38,43,130277,0.37,45,7977,5241,52.2
2017,Argentina,58644,0.33,47,66937,0.37,44,125581,0.35,46,8293,-2058,-502.96
2017,Qatar,67498,0.38,44,29896,0.17,64,97394,0.27,47,-37602,-25249,48.92
2017,Iraq,57559,0.32,48,38066,0.21,57,95625,0.27,48,-19493,-7090,174.94
2017,Ukraine,43265,0.24,53,49609,0.28,50,92874,0.26,49,6344,2892,119.36
2017,Bangladesh,35851,0.2,57,52836,0.29,49,88687,0.25,50,16985,9878,71.95
2017,"Kuwait, the State of",55015,0.31,49,33573,0.19,61,88588,0.25,51,-21442,-15448,38.8
2017,Egypt,25604,0.14,66,61627,0.34,46,87231,0.24,52,36023,30321,18.81
2017,Greece,32627,0.18,61,53495,0.3,48,86122,0.24,53,20868,18658,11.84
2017,Peru,43454,0.25,52,39885,0.22,56,83339,0.23,54,-3569,-262,1262.21
2017,Colombia,36897,0.21,56,46076,0.26,52,82973,0.23,55,9179,13132,-30.1
2017,Algeria,35191,0.2,58,46059,0.26,53,81250,0.23,56,10868,17063,-36.31
2017,Pakistan,21569,0.12,68,57746,0.32,47,79315,0.22,57,36177,26472,36.66
2017,New Zealand,38075,0.21,55,40125,0.22,55,78200,0.22,58,2050,2323,-11.75
2017,Kazakhstan,48304,0.27,50,29266,0.16,65,77570,0.22,59,-19038,-11690,62.86
2017,Nigeria,44468,0.25,51,31273,0.17,63,75741,0.21,60,-13195,2230,-691.7
2017,Slovenia,38443,0.22,54,36078,0.2,58,74521,0.21,61,-2365,-2380,-0.63
2017,Morocco,25272,0.14,67,44490,0.25,54,69762,0.2,62,19218,18730,2.61
2017,Bulgaria,31438,0.18,63,34184,0.19,60,65622,0.18,63,2746,2361,16.31
2017,Belarus,29267,0.17,65,34231,0.19,59,63498,0.18,64,4964,4050,22.57
2017,Lithuania,29901,0.17,64,32258,0.18,62,62159,0.17,65,2357,2366,-0.38
2017,Oman,32904,0.19,60,26435,0.15,66,59339,0.17,66,-6469,-6866,-5.78
2017,Angola,34613,0.2,59,14463,0.08,84,49076,0.14,67,-20150,-14549,38.5
2017,"Venezuela, Bolivarian Republic of",31960,0.18,62,10570,0.06,92,42530,0.12,68,-21390,-11156,91.74
2017,Croatia,16069,0.09,72,24829,0.14,67,40898,0.11,69,8760,8090,8.28
2017,Ecuador,19122,0.11,70,20010,0.11,74,39132,0.11,70,888,-474,-287.34
2017,Serbia,16992,0.1,71,21947,0.12,69,38939,0.11,71,4955,4371,13.36
2017,Luxembourg,15761,0.09,73,22876,0.13,68,38637,0.11,72,7115,6076,17.1
2017,Tunisia,14204,0.08,77,20654,0.12,72,34858,0.1,73,6450,5890,9.51
2017,Myanmar,13879,0.08,79,19253,0.11,76,33132,0.09,74,5374,3874,38.72
2017,Panama,11093,0.06,85,21934,0.12,70,33027,0.09,75,10841,9740,11.3
2017,Sri Lanka,11360,0.06,83,20980,0.12,71,32340,0.09,76,9620,8873,8.42
2017,Estonia,14559,0.08,76,16674,0.09,82,31233,0.09,77,2115,1788,18.29
2017,Latvia,14126,0.08,78,17033,0.09,79,31159,0.09,78,2907,2140,35.84
2017,Libya,20881,0.12,69,9406,0.05,98,30287,0.08,79,-11475,-10222,12.26
2017,Guatemala,10990,0.06,86,18388,0.1,77,29378,0.08,80,7398,6553,12.89
2017,"Bahrain, Kingdom of",15376,0.09,75,13145,0.07,86,28521,0.08,81,-2231,-1206,84.99
2017,Jordan,7511,0.04,98,20498,0.11,73,28009,0.08,82,12987,11775,10.29
2017,Dominican Republic,10135,0.06,88,17734,0.1,78,27869,0.08,83,7599,7559,0.53
2017,Costa Rica,10769,0.06,87,16796,0.09,80,27565,0.08,84,6027,5095,18.29
2017,Ghana,13835,0.08,80,12647,0.07,87,26482,0.07,85,-1188,1782,-166.67
2017,Cambodia,11278,0.06,84,14283,0.08,85,25561,0.07,86,3005,2302,30.54
2017,Azerbaijan,15481,0.09,74,8783,0.05,102,24264,0.07,87,-6698,-4619,45.01
2017,Lebanese Republic,4026,0.02,117,19911,0.11,75,23937,0.07,88,15885,15438,2.9
2017,Kenya,5747,0.03,105,16687,0.09,81,22434,0.06,89,10940,8412,30.05
2017,Uzbekistan,10079,0.06,89,12035,0.07,88,22114,0.06,90,1956,2354,-16.91
2017,Côte d'Ivoire,11853,0.07,82,9614,0.05,96,21467,0.06,91,-2239,-2295,-2.44
2017,Paraguay,8680,0.05,92,11875,0.07,89,20555,0.06,92,3195,1259,153.77
2017,Honduras,8656,0.05,93,11409,0.06,90,20065,0.06,93,2753,2599,5.93
2017,Ethiopia,3022,0.02,122,15761,0.09,83,18783,0.05,94,12739,13640,-6.61
2017,Democratic Republic of the Congo,12296,0.07,81,5803,0.03,117,18099,0.05,95,-6493,-1701,281.72
2017,"Bolivia, Plurinational State of",7846,0.04,97,9288,0.05,99,17134,0.05,96,1442,1345,7.21
2017,Bosnia and Herzegovina,6402,0.04,100,10504,0.06,93,16906,0.05,97,4102,3818,7.44
2017,Uruguay,7888,0.04,96,8458,0.05,103,16346,0.05,98,570,1094,-47.9
2017,El Salvador,5760,0.03,104,10572,0.06,91,16332,0.05,99,4812,4406,9.21
2017,Zambia,8000,0.05,95,7988,0.04,106,15988,0.04,100,-12,918,-101.31
2017,Trinidad and Tobago,8741,0.05,91,6893,0.04,111,15634,0.04,101,-1848,419,-541.05
2017,North Macedonia,5668,0.03,106,7723,0.04,107,13391,0.04,102,2055,1968,4.42
2017,Sudan,4100,0.02,116,9134,0.05,101,13234,0.04,103,5034,5217,-3.51
2017,Papua New Guinea,9952,0.06,90,3059,0.02,145,13011,0.04,104,-6893,-6126,12.52
2017,Nicaragua,5170,0.03,110,7708,0.04,108,12878,0.04,105,2538,1045,142.87
2017,Congo,8252,0.05,94,4560,0.03,128,12812,0.04,106,-3692,3369,-209.59
2017,Cuba,2402,0.01,133,10172,0.06,95,12574,0.04,107,7770,7953,-2.3
2017,Cyprus,3288,0.02,119,9231,0.05,100,12519,0.04,108,5943,4865,22.16
2017,Tanzania,4113,0.02,115,8299,0.05,104,12412,0.03,109,4186,4800,-12.79
2017,Turkmenistan,7458,0.04,99,4571,0.03,127,12029,0.03,110,-2887,-1970,46.55
2017,Namibia,5229,0.03,108,6778,0.04,112,12007,0.03,111,1549,2589,-40.17
2017,Iceland,4878,0.03,111,6965,0.04,110,11843,0.03,112,2087,1234,69.12
2017,Botswana,5870,0.03,102,5329,0.03,121,11199,0.03,113,-541,-1223,-55.76
2017,Nepal,742,0.0,155,10345,0.06,94,11087,0.03,114,9603,8239,16.56
2017,"Macao, China",1406,0.01,145,9451,0.05,97,10857,0.03,115,8045,7667,4.93
2017,Georgia,2746,0.02,129,8057,0.04,105,10803,0.03,116,5311,5225,1.65
2017,Lao People's Democratic Republic,4873,0.03,112,5667,0.03,119,10540,0.03,117,794,1127,-29.55
2017,Mongolia,6201,0.03,101,4337,0.02,130,10538,0.03,118,-1864,-1558,19.64
2017,Mozambique,4755,0.03,113,5741,0.03,118,10496,0.03,119,986,1878,-47.5
2017,Senegal,2989,0.02,123,6729,0.04,113,9718,0.03,120,3740,2838,31.78
2017,Gabon,5771,0.03,103,3845,0.02,135,9616,0.03,121,-1926,-3331,-42.18
2017,Malta,2858,0.02,127,5997,0.03,115,8855,0.02,122,3139,3258,-3.65
2017,Syrian Arab Republic,2555,0.01,131,6153,0.03,114,8708,0.02,123,3598,2557,40.71
2017,Brunei Darussalam,5571,0.03,107,3085,0.02,144,8656,0.02,124,-2486,-2196,13.21
2017,Zimbabwe,3481,0.02,118,5064,0.03,124,8545,0.02,125,1583,2001,-20.89
2017,Uganda,2901,0.02,124,5596,0.03,120,8497,0.02,126,2695,2347,14.83
2017,Guinea,4594,0.03,114,3484,0.02,141,8078,0.02,127,-1110,2015,-155.09
2017,Equatorial Guinea,5200,0.03,109,2842,0.02,147,8042,0.02,128,-2358,-2577,-8.5
2017,Cameroon,3233,0.02,120,4796,0.03,126,8029,0.02,129,1563,1901,-17.78
2017,Afghanistan,723,0.0,156,7065,0.04,109,7788,0.02,130,6342,5938,6.8
2017,Mauritius,2342,0.01,134,5254,0.03,123,7596,0.02,131,2912,2296,26.83
2017,Albania,2292,0.01,135,5271,0.03,122,7563,0.02,132,2979,2654,12.25
2017,"Moldova, Republic of",2425,0.01,132,4831,0.03,125,7256,0.02,133,2406,1975,21.82
2017,Mali,2896,0.02,125,4286,0.02,131,7182,0.02,134,1390,1225,13.47
2017,Jamaica,1310,0.01,146,5818,0.03,116,7128,0.02,135,4508,3565,26.45
2017,Djibouti,3162,0.02,121,3576,0.02,138,6738,0.02,136,414,595,-30.42
2017,Burkina Faso,2875,0.02,126,3861,0.02,134,6736,0.02,137,986,836,17.94
2017,Madagascar,2848,0.02,128,3670,0.02,137,6518,0.02,138,822,712,15.45
2017,Armenia,2245,0.01,136,4189,0.02,132,6434,0.02,139,1944,1481,31.26
2017,Kyrgyz Republic,1764,0.01,142,4495,0.03,129,6259,0.02,140,2731,2427,12.53
2017,Benin,2216,0.01,137,3494,0.02,140,5710,0.02,141,1278,1098,16.39
2017,"Korea, Democratic People's Republic of",1770,0.01,141,3781,0.02,136,5551,0.02,142,2011,851,136.31
2017,Mauritania,1989,0.01,139,3522,0.02,139,5511,0.02,143,1533,551,178.22
2017,Haiti,980,0.01,152,3890,0.02,133,4870,0.01,144,2910,2437,19.41
2017,Chad,2621,0.01,130,1851,0.01,158,4472,0.01,145,-770,375,-305.33
2017,New Caledonia,1561,0.01,143,2511,0.01,151,4072,0.01,146,950,1065,-10.8
2017,Tajikistan,1198,0.01,148,2775,0.02,148,3973,0.01,147,1577,2132,-26.03
2017,Bahamas,473,0.0,164,3428,0.02,142,3901,0.01,148,2955,2572,14.89
2017,Niger,1206,0.01,147,2459,0.01,152,3665,0.01,149,1253,1130,10.88
2017,Yemen,418,0.0,169,3088,0.02,143,3506,0.01,150,2670,2669,0.04
2017,Eswatini,1801,0.01,140,1612,0.01,161,3413,0.01,151,-189,-157,20.38
2017,Malawi,839,0.0,154,2551,0.01,150,3390,0.01,152,1712,1232,38.96
2017,Fiji,956,0.01,153,2420,0.01,153,3376,0.01,153,1464,1390,5.32
2017,Somalia,464,0.0,165,2898,0.02,146,3362,0.01,154,2434,1753,38.85
2017,Suriname,1992,0.01,138,1280,0.01,167,3272,0.01,155,-712,-187,280.75
2017,Rwanda,1037,0.01,149,2212,0.01,155,3249,0.01,156,1175,1523,-22.85
2017,Lesotho,1028,0.01,150,2066,0.01,156,3094,0.01,157,1038,980,5.92
2017,Guyana,1437,0.01,144,1644,0.01,159,3081,0.01,158,207,7,2857.14
2017,Montenegro,421,0.0,168,2613,0.01,149,3034,0.01,159,2192,1925,13.87
2017,Togo,1016,0.01,151,1874,0.01,157,2890,0.01,160,858,1225,-29.96
2017,Maldives,318,0.0,173,2360,0.01,154,2678,0.01,161,2042,1869,9.26
2017,Barbados,485,0.0,163,1600,0.01,162,2085,0.01,162,1115,1105,0.9
2017,Curaçao,425,0.0,167,1469,0.01,164,1894,0.01,163,1044,1013,3.06
2017,Sierra Leone,567,0.0,160,1301,0.01,166,1868,0.01,164,734,444,65.32
2017,Seychelles,547,0.0,161,1302,0.01,165,1849,0.01,165,755,580,30.17
2017,French Polynesia,153,0.0,175,1637,0.01,160,1790,0.01,166,1484,1318,12.59
2017,Eritrea,583,0.0,158,1026,0.01,173,1609,0.0,167,443,521,-14.97
2017,Bhutan,573,0.0,159,1029,0.01,172,1602,0.0,168,456,477,-4.4
2017,Andorra,118,0.0,181,1478,0.01,163,1596,0.0,169,1360,1257,8.19
2017,Liberia,358,0.0,171,1089,0.01,171,1447,0.0,170,731,1023,-28.54
2017,Belize,457,0.0,166,916,0.01,174,1373,0.0,171,459,510,-10.0
2017,Greenland,596,0.0,157,760,0.0,177,1356,0.0,172,164,159,3.14
2017,"Aruba, Netherlands with respect to",135,0.0,177,1124,0.01,168,1259,0.0,173,989,854,15.81
2017,Cayman Islands,39,0.0,189,1098,0.01,169,1137,0.0,174,1059,965,9.74
2017,Bermuda,18,0.0,197,1095,0.01,170,1113,0.0,175,1077,958,12.42
2017,Solomon Islands,500,0.0,162,572,0.0,183,1072,0.0,176,72,17,323.53
2017,American Samoa,397,0.0,170,595,0.0,182,992,0.0,177,198,267,-25.84
2017,Burundi,172,0.0,174,755,0.0,179,927,0.0,178,583,491,18.74
2017,Sint Maarten,123,0.0,180,761,0.0,176,884,0.0,179,638,724,-11.88
2017,Cabo Verde,50,0.0,182,789,0.0,175,839,0.0,180,739,606,21.95
2017,Guam,33,0.0,191,760,0.0,177,793,0.0,181,727,680,6.91
2017,Saint Lucia,127,0.0,178,655,0.0,180,782,0.0,182,528,535,-1.31
2017,Guinea-Bissau,339,0.0,172,353,0.0,192,692,0.0,183,14,2,600.0
2017,The Gambia,124,0.0,179,548,0.0,186,672,0.0,184,424,231,83.55
2017,Northern Mariana Islands,5,0.0,205,625,0.0,181,630,0.0,185,620,582,6.53
2017,Central African Republic,140,0.0,176,488,0.0,187,628,0.0,186,348,284,22.54
2017,Timor-Leste,23,0.0,193,554,0.0,184,577,0.0,187,531,527,0.76
2017,Antigua and Barbuda,21,0.0,194,554,0.0,184,575,0.0,188,533,417,27.82
2017,Grenada,30,0.0,192,420,0.0,188,450,0.0,189,390,321,21.5
2017,Vanuatu,47,0.0,184,370,0.0,189,417,0.0,190,323,372,-13.17
2017,Samoa,44,0.0,186,356,0.0,191,400,0.0,191,312,294,6.12
2017,Turks and Caicos Islands,4,0.0,207,370,0.0,189,374,0.0,192,366,385,-4.94
2017,Saint Vincent and the Grenadines,42,0.0,187,330,0.0,193,372,0.0,193,288,288,0.0
2017,Saint Kitts and Nevis,50,0.0,182,309,0.0,194,359,0.0,194,259,282,-8.16
2017,Comoros,39,0.0,189,253,0.0,195,292,0.0,195,214,188,13.83
2017,Tonga,19,0.0,196,231,0.0,196,250,0.0,196,212,208,1.92
2017,Anguilla,11,0.0,202,222,0.0,197,233,0.0,197,211,186,13.44
2017,"Micronesia, Federated States of",46,0.0,185,183,0.0,199,229,0.0,198,137,137,0.0
2017,Dominica,12,0.0,201,198,0.0,198,210,0.0,199,186,196,-5.1
2017,Palau,6,0.0,203,182,0.0,200,188,0.0,200,176,147,19.73
2017,Sao Tomé and Principe,16,0.0,198,147,0.0,201,163,0.0,201,131,125,4.8
2017,Cook Islands,20,0.0,195,135,0.0,202,155,0.0,202,115,94,22.34
2017,Kiribati,15,0.0,199,131,0.0,203,146,0.0,203,116,126,-7.94
2017,Marshall Islands,40,0.0,188,90,0.0,205,130,0.0,204,50,61,-18.03
2017,Saint Pierre and Miquelon,5,0.0,205,99,0.0,204,104,0.0,205,94,86,9.3
2017,"Bonaire, Sint Eustatius and Saba",1,0.0,209,86,0.0,206,87,0.0,206,85,79,7.59
2017,Wallis and Futuna Islands,0,0.0,210,65,0.0,207,65,0.0,207,65,65,0.0
2017,Nauru,15,0.0,199,43,0.0,208,58,0.0,208,28,33,-15.15
2017,Montserrat,6,0.0,203,30,0.0,209,36,0.0,209,24,32,-25.0
2017,Tuvalu,0,0.0,210,27,0.0,210,27,0.0,210,27,23,17.39
2017,Niue,2,0.0,208,15,0.0,211,17,0.0,211,13,12,8.33
2017,Tokelau,0,0.0,210,0,0.0,212,0,0.0,212,0,0,
2016,United States of America,1451011,9.04,2,2250154,13.89,1,3701165,11.48,1,799143,812729,-1.67
2016,China,2097632,13.07,1,1587925,9.8,2,3685557,11.43,2,-509707,-593902,-14.18
2016,Germany,1334355,8.32,3,1055326,6.52,3,2389681,7.41,3,-279029,-275074,1.44
2016,Japan,645052,4.02,4,607728,3.75,5,1252780,3.89,4,-37324,23196,-260.91
2016,Netherlands,570606,3.56,5,500797,3.09,8,1071403,3.32,5,-69809,-58337,19.67
2016,France,501179,3.12,7,567657,3.51,6,1068836,3.32,6,66478,64494,3.08
2016,"Hong Kong, China",516635,3.22,6,546520,3.37,7,1063155,3.3,7,29885,48284,-38.11
2016,United Kingdom,410856,2.56,10,636731,3.93,4,1047587,3.25,8,225875,164153,37.6
2016,"Korea, Republic of",495426,3.09,8,406193,2.51,11,901619,2.8,9,-89233,-90258,-1.14
2016,Italy,461737,2.88,9,406788,2.51,10,868525,2.69,10,-54949,-46071,19.27
2016,Canada,389991,2.43,12,412940,2.55,9,802931,2.49,11,22949,20062,14.39
2016,Belgium,398134,2.48,11,379409,2.34,13,777543,2.41,12,-18725,-21311,-12.13
2016,Mexico,373948,2.33,13,397522,2.45,12,771470,2.39,13,23574,24732,-4.68
2016,India,264542,1.65,20,361649,2.23,14,626191,1.94,14,97107,126180,-23.04
2016,Singapore,330481,2.06,14,283339,1.75,16,613820,1.9,15,-47142,-54500,-13.5
2016,Spain,289981,1.81,17,310921,1.92,15,600902,1.86,16,20940,29577,-29.2
2016,Switzerland,302900,1.89,15,270128,1.67,17,573028,1.78,17,-32772,-36693,-10.69
2016,United Arab Emirates,295031,1.84,16,266576,1.65,18,561607,1.74,18,-28455,-37060,-23.22
2016,Chinese Taipei,280321,1.75,19,230568,1.42,19,510889,1.58,19,-49753,-48125,3.38
2016,Russian Federation,281710,1.76,18,191493,1.18,24,473203,1.47,20,-90217,-148400,-39.21
2016,Thailand,215388,1.34,21,194198,1.2,23,409586,1.27,21,-21190,-11657,81.78
2016,Poland,203817,1.27,22,199506,1.23,21,403323,1.25,22,-4311,-2651,62.62
2016,Australia,192505,1.2,23,196270,1.21,22,388775,1.21,23,3765,20817,-81.91
2016,Malaysia,189743,1.18,24,168684,1.04,26,358427,1.11,24,-21059,-23981,-12.18
2016,Türkiye,149247,0.93,30,202189,1.25,20,351436,1.09,25,52942,62637,-15.48
2016,Viet Nam,176581,1.1,27,174804,1.08,25,351385,1.09,26,-1777,3545,-150.13
2016,Brazil,179526,1.12,26,145248,0.9,28,324774,1.01,27,-34278,-6322,442.2
2016,"Saudi Arabia, Kingdom of",183579,1.14,25,140170,0.87,31,323749,1.0,28,-43409,-28874,50.34
2016,Austria,152090,0.95,29,157697,0.97,27,309787,0.96,29,5607,3318,68.99
2016,Czech Republic,162692,1.01,28,143040,0.88,29,305732,0.95,30,-19652,-16514,19.0
2016,Sweden,139290,0.87,32,141021,0.87,30,280311,0.87,31,1731,-1625,-206.52
2016,Indonesia,144490,0.9,31,135653,0.84,32,280143,0.87,32,-8837,-7671,15.2
2016,Ireland,130864,0.82,33,81185,0.5,37,212049,0.66,33,-49679,-46384,7.1
2016,Hungary,101919,0.64,34,93880,0.58,33,195799,0.61,34,-8039,-6551,22.71
2016,Denmark,95326,0.59,35,85513,0.53,36,180839,0.56,35,-9813,-9834,-0.21
2016,South Africa,76214,0.47,38,91692,0.57,34,167906,0.52,36,15478,23649,-34.55
2016,Norway,88410,0.55,36,72110,0.45,40,160520,0.5,37,-16300,-27491,-40.71
2016,Slovak Republic,77060,0.48,37,74680,0.46,38,151740,0.47,38,-2380,-2309,3.07
2016,Philippines,56313,0.35,46,85935,0.53,35,142248,0.44,39,29622,15923,86.03
2016,Romania,63534,0.4,40,74560,0.46,39,138094,0.43,40,11026,9229,19.47
2016,Israel,60571,0.38,42,65812,0.41,42,126383,0.39,41,5241,-1998,-362.31
2016,Portugal,55372,0.35,47,67954,0.42,41,123326,0.38,42,12582,11867,6.03
2016,Chile,60718,0.38,41,59376,0.37,44,120094,0.37,43,-1342,353,-480.17
2016,Finland,57908,0.36,44,60841,0.38,43,118749,0.37,44,2933,613,378.47
2016,Iran,72903,0.45,39,43080,0.27,52,115983,0.36,45,-29823,-25338,17.7
2016,Argentina,57910,0.36,43,55852,0.34,45,113762,0.35,46,-2058,3421,-160.16
2016,Qatar,57309,0.36,45,32060,0.2,59,89369,0.28,47,-25249,-45361,-44.34
2016,Egypt,25468,0.16,64,55789,0.34,46,81257,0.25,48,30321,42225,-28.19
2016,Bangladesh,34894,0.22,53,44772,0.28,51,79666,0.25,49,9878,9668,2.17
2016,Algeria,30026,0.19,58,47089,0.29,47,77115,0.24,50,17063,17034,0.17
2016,"Kuwait, the State of",46273,0.29,48,30825,0.19,60,77098,0.24,51,-15448,-23159,-33.3
2016,Colombia,31757,0.2,57,44889,0.28,50,76646,0.24,52,13132,18367,-28.5
2016,Ukraine,36360,0.23,52,39252,0.24,54,75612,0.23,53,2892,-610,-574.1
2016,Iraq,41298,0.26,49,34208,0.21,58,75506,0.23,54,-7090,-3871,83.16
2016,Greece,28151,0.18,60,46809,0.29,49,74960,0.23,55,18658,18232,2.34
2016,Peru,36516,0.23,51,36254,0.22,55,72770,0.23,56,-262,4379,-105.98
2016,New Zealand,33756,0.21,54,36079,0.22,56,69835,0.22,57,2323,2199,5.64
2016,Nigeria,33302,0.21,55,35532,0.22,57,68834,0.21,58,2230,-5516,-140.43
2016,Pakistan,20375,0.13,69,46847,0.29,48,67222,0.21,59,26472,22079,19.9
2016,Morocco,22661,0.14,67,41391,0.26,53,64052,0.2,60,18730,15766,18.8
2016,Slovenia,32917,0.21,56,30537,0.19,61,63454,0.2,61,-2380,-2114,12.58
2016,Kazakhstan,36685,0.23,50,24995,0.15,65,61680,0.19,62,-11690,-15388,-24.03
2016,Bulgaria,26572,0.17,63,28933,0.18,62,55505,0.17,63,2361,3834,-38.42
2016,Oman,30014,0.19,59,23148,0.14,66,53162,0.16,64,-6866,-2920,135.14
2016,Lithuania,25010,0.16,65,27376,0.17,64,52386,0.16,65,2366,2762,-14.34
2016,Belarus,23414,0.15,66,27464,0.17,63,50878,0.16,66,4050,3183,27.24
2016,"Venezuela, Bolivarian Republic of",26696,0.17,62,15540,0.1,80,42236,0.13,67,-11156,-3979,180.37
2016,Angola,27589,0.17,61,13040,0.08,85,40629,0.13,68,-14549,-12488,16.5
2016,Luxembourg,15796,0.1,71,21872,0.14,68,37668,0.12,69,6076,6150,-1.2
2016,Croatia,13813,0.09,73,21903,0.14,67,35716,0.11,70,8090,7646,5.81
2016,Serbia,14874,0.09,72,19245,0.12,73,34119,0.11,71,4371,4500,-2.87
2016,Ecuador,16798,0.1,70,16324,0.1,78,33122,0.1,72,-474,3187,-114.87
2016,Tunisia,13572,0.08,74,19462,0.12,70,33034,0.1,73,5890,6148,-4.2
2016,Panama,11195,0.07,80,20935,0.13,69,32130,0.1,74,9740,11156,-12.69
2016,Libya,20880,0.13,68,10658,0.07,91,31538,0.1,75,-10222,-10649,-4.01
2016,Sri Lanka,10310,0.06,85,19183,0.12,74,29493,0.09,76,8873,8388,5.78
2016,Estonia,13171,0.08,75,14959,0.09,82,28130,0.09,77,1788,1685,6.11
2016,Myanmar,11831,0.07,79,15705,0.1,79,27536,0.09,78,3874,5456,-29.0
2016,Guatemala,10447,0.07,83,17000,0.1,76,27447,0.09,79,6553,6963,-5.89
2016,Dominican Republic,9840,0.06,87,17399,0.11,75,27239,0.08,80,7559,7465,1.26
2016,Jordan,7549,0.05,95,19324,0.12,72,26873,0.08,81,11775,12642,-6.86
2016,Latvia,12294,0.08,78,14434,0.09,83,26728,0.08,82,2140,2433,-12.04
2016,Costa Rica,10361,0.06,84,15456,0.1,81,25817,0.08,83,5095,6851,-25.63
2016,"Bahrain, Kingdom of",12785,0.08,77,11579,0.07,88,24364,0.08,84,-1206,-4132,-70.81
2016,Ghana,11138,0.07,81,12920,0.08,86,24058,0.07,85,1782,3144,-43.32
2016,Lebanese Republic,3930,0.02,114,19368,0.12,71,23298,0.07,86,15438,14983,3.04
2016,Cambodia,10069,0.06,86,12371,0.08,87,22440,0.07,87,2302,4719,-51.22
2016,Azerbaijan,13108,0.08,76,8489,0.05,101,21597,0.07,88,-4619,-7375,-37.37
2016,Uzbekistan,8974,0.06,89,11328,0.07,89,20302,0.06,89,2354,2018,16.65
2016,Kenya,5695,0.04,102,14107,0.09,84,19802,0.06,90,8412,10187,-17.42
2016,Côte d'Ivoire,10876,0.07,82,8581,0.05,100,19457,0.06,91,-2295,-1324,73.34
2016,Ethiopia,2789,0.02,123,16429,0.1,77,19218,0.06,92,13640,13788,-1.07
2016,Congo,7901,0.05,93,11270,0.07,90,19171,0.06,93,3369,1927,74.83
2016,Honduras,7960,0.05,92,10559,0.07,92,18519,0.06,94,2599,2949,-11.87
2016,Paraguay,8494,0.05,90,9753,0.06,95,18247,0.06,95,1259,1934,-34.9
2016,Trinidad and Tobago,7633,0.05,94,8052,0.05,105,15685,0.05,96,419,-1515,-127.66
2016,Gabon,9503,0.06,88,6172,0.04,113,15675,0.05,97,-3331,-4533,-26.52
2016,"Bolivia, Plurinational State of",7082,0.04,98,8427,0.05,102,15509,0.05,98,1345,1040,29.33
2016,El Salvador,5420,0.03,103,9826,0.06,94,15246,0.05,99,4406,4784,-7.9
2016,Uruguay,7043,0.04,99,8137,0.05,104,15180,0.05,100,1094,1801,-39.26
2016,Bosnia and Herzegovina,5328,0.03,104,9146,0.06,97,14474,0.04,101,3818,3888,-1.8
2016,Tanzania,4500,0.03,110,9300,0.06,96,13800,0.04,102,4800,5955,-19.4
2016,Zambia,6372,0.04,101,7290,0.05,108,13662,0.04,103,918,1328,-30.87
2016,Botswana,7366,0.05,96,6143,0.04,114,13509,0.04,104,-1223,922,-232.65
2016,Democratic Republic of the Congo,7193,0.04,97,5492,0.03,117,12685,0.04,105,-1701,-617,175.69
2016,Cuba,2317,0.01,130,10270,0.06,93,12587,0.04,106,7953,8352,-4.78
2016,Turkmenistan,6964,0.04,100,4994,0.03,123,11958,0.04,107,-1970,-3000,-34.33
2016,North Macedonia,4790,0.03,108,6758,0.04,109,11548,0.04,108,1968,1891,4.07
2016,Sudan,3094,0.02,119,8311,0.05,103,11405,0.04,109,5217,6340,-17.71
2016,Cyprus,2965,0.02,121,7830,0.05,106,10795,0.03,110,4865,3728,30.5
2016,Namibia,4084,0.03,113,6673,0.04,110,10757,0.03,111,2589,3630,-28.68
2016,Nicaragua,4782,0.03,109,5827,0.04,115,10609,0.03,112,1045,2221,-52.95
2016,Papua New Guinea,8194,0.05,91,2068,0.01,157,10262,0.03,113,-6126,-5902,3.8
2016,"Macao, China",1257,0.01,145,8924,0.06,99,10181,0.03,114,7667,9264,-17.24
2016,Iceland,4436,0.03,111,5670,0.04,116,10106,0.03,115,1234,567,117.64
2016,Nepal,696,0.0,155,8935,0.06,98,9631,0.03,116,8239,5931,38.91
2016,Malta,3186,0.02,118,6444,0.04,112,9630,0.03,117,3258,3429,-4.99
2016,Lao People's Democratic Republic,4245,0.03,112,5372,0.03,119,9617,0.03,118,1127,2022,-44.26
2016,Georgia,2117,0.01,132,7342,0.05,107,9459,0.03,119,5225,5096,2.53
2016,Zimbabwe,3335,0.02,115,5336,0.03,120,8671,0.03,120,2001,2805,-28.66
2016,Mozambique,3328,0.02,116,5206,0.03,121,8534,0.03,121,1878,4921,-61.84
2016,Cameroon,3305,0.02,117,5206,0.03,121,8511,0.03,122,1901,1987,-4.33
2016,Mongolia,4916,0.03,105,3358,0.02,135,8274,0.03,123,-1558,-871,78.87
2016,Senegal,2640,0.02,124,5478,0.03,118,8118,0.03,124,2838,2983,-4.86
2016,Brunei Darussalam,4875,0.03,107,2679,0.02,143,7554,0.02,125,-2196,-3124,-29.71
2016,Uganda,2482,0.02,126,4829,0.03,125,7311,0.02,126,2347,3261,-28.03
2016,Syrian Arab Republic,2377,0.01,128,4934,0.03,124,7311,0.02,126,2557,3918,-34.74
2016,Equatorial Guinea,4900,0.03,106,2323,0.01,148,7223,0.02,128,-2577,-2975,-13.38
2016,Afghanistan,596,0.0,158,6534,0.04,111,7130,0.02,129,5938,7152,-16.97
2016,Mauritius,2359,0.01,129,4655,0.03,127,7014,0.02,130,2296,2128,7.89
2016,Mali,2826,0.02,122,4051,0.03,130,6877,0.02,131,1225,1083,13.11
2016,"Korea, Democratic People's Republic of",3006,0.02,120,3857,0.02,133,6863,0.02,132,851,670,27.01
2016,Guinea,2414,0.02,127,4429,0.03,129,6843,0.02,133,2015,411,390.27
2016,Albania,1959,0.01,135,4613,0.03,128,6572,0.02,134,2654,2385,11.28
2016,"Moldova, Republic of",2045,0.01,134,4020,0.02,131,6065,0.02,135,1975,2020,-2.23
2016,Jamaica,1202,0.01,146,4767,0.03,126,5969,0.02,136,3565,3730,-4.42
2016,Burkina Faso,2509,0.02,125,3345,0.02,136,5854,0.02,137,836,904,-7.52
2016,Kyrgyz Republic,1573,0.01,141,4000,0.02,132,5573,0.02,138,2427,2629,-7.68
2016,Madagascar,2254,0.01,131,2966,0.02,141,5220,0.02,139,712,747,-4.69
2016,Armenia,1792,0.01,136,3273,0.02,137,5065,0.02,140,1481,1754,-15.56
2016,Benin,1774,0.01,137,2872,0.02,142,4646,0.01,141,1098,879,24.91
2016,Chad,2090,0.01,133,2465,0.02,144,4555,0.01,142,375,1274,-70.57
2016,Haiti,986,0.01,150,3423,0.02,134,4409,0.01,143,2437,2801,-13.0
2016,Djibouti,1732,0.01,138,2327,0.01,147,4059,0.01,144,595,737,-19.27
2016,Tajikistan,899,0.01,152,3031,0.02,139,3930,0.01,145,2132,2545,-16.23
2016,Mauritania,1623,0.01,140,2174,0.01,154,3797,0.01,146,551,1871,-70.55
2016,New Caledonia,1330,0.01,144,2395,0.01,145,3725,0.01,147,1065,1470,-27.55
2016,Yemen,411,0.0,167,3080,0.02,138,3491,0.01,148,2669,6063,-55.98
2016,Bahamas,403,0.0,168,2975,0.02,140,3378,0.01,149,2572,2719,-5.41
2016,Togo,1036,0.01,147,2261,0.01,151,3297,0.01,150,1225,1325,-7.55
2016,Malawi,1022,0.01,149,2254,0.01,152,3276,0.01,151,1232,1198,2.84
2016,Fiji,926,0.01,151,2316,0.01,149,3242,0.01,152,1390,1186,17.2
2016,Niger,1032,0.01,148,2162,0.01,155,3194,0.01,153,1130,1403,-19.46
2016,Eswatini,1633,0.01,139,1476,0.01,161,3109,0.01,154,-157,-400,-60.75
2016,Rwanda,731,0.0,154,2254,0.01,152,2985,0.01,155,1523,1700,-10.41
2016,Somalia,615,0.0,157,2368,0.01,146,2983,0.01,156,1753,1480,18.45
2016,Guyana,1441,0.01,142,1448,0.01,162,2889,0.01,157,7,341,-97.95
2016,Lesotho,881,0.01,153,1861,0.01,158,2742,0.01,158,980,1068,-8.24
2016,Suriname,1439,0.01,143,1252,0.01,166,2691,0.01,159,-187,376,-149.73
2016,Montenegro,361,0.0,170,2286,0.01,150,2647,0.01,160,1925,1688,14.04
2016,Maldives,256,0.0,175,2125,0.01,156,2381,0.01,161,1869,1656,12.86
2016,Barbados,517,0.0,161,1622,0.01,159,2139,0.01,162,1105,1135,-2.64
2016,Curaçao,419,0.0,166,1432,0.01,163,1851,0.01,163,1013,1066,-4.97
2016,Sierra Leone,624,0.0,156,1068,0.01,168,1692,0.01,164,444,1018,-56.39
2016,French Polynesia,173,0.0,176,1491,0.01,160,1664,0.01,165,1318,1397,-5.65
2016,Liberia,279,0.0,173,1302,0.01,165,1581,0.0,166,1023,1404,-27.14
2016,Bhutan,525,0.0,160,1002,0.01,171,1527,0.0,167,477,512,-6.84
2016,Seychelles,460,0.0,162,1040,0.01,169,1500,0.0,168,580,576,0.69
2016,Andorra,97,0.0,182,1354,0.01,164,1451,0.0,169,1257,1204,4.4
2016,"Aruba, Netherlands with respect to",284,0.0,172,1138,0.01,167,1422,0.0,170,854,920,-7.17
2016,Belize,443,0.0,163,953,0.01,174,1396,0.0,171,510,453,12.58
2016,Eritrea,436,0.0,165,957,0.01,173,1393,0.0,172,521,521,0.0
2016,Greenland,575,0.0,159,734,0.0,177,1309,0.0,173,159,261,-39.08
2016,Gibraltar,307,0.0,171,830,0.01,176,1137,0.0,174,523,,
2016,Cayman Islands,58,0.0,185,1023,0.01,170,1081,0.0,175,965,921,4.78
2016,American Samoa,388,0.0,169,655,0.0,180,1043,0.0,176,267,296,-9.8
2016,Bermuda,19,0.0,197,977,0.01,172,996,0.0,177,958,912,5.04
2016,Sint Maarten,132,0.0,177,856,0.01,175,988,0.0,178,724,728,-0.55
2016,Solomon Islands,437,0.0,164,454,0.0,186,891,0.0,179,17,66,-74.24
2016,Saint Lucia,120,0.0,179,655,0.0,180,775,0.0,180,535,390,37.18
2016,Guam,33,0.0,192,713,0.0,178,746,0.0,181,680,673,1.04
2016,Burundi,125,0.0,178,616,0.0,182,741,0.0,182,491,736,-33.29
2016,Cabo Verde,60,0.0,184,666,0.0,179,726,0.0,183,606,537,12.85
2016,Northern Mariana Islands,6,0.0,205,588,0.0,183,594,0.0,184,582,470,23.83
2016,Timor-Leste,20,0.0,196,547,0.0,184,567,0.0,185,527,560,-5.89
2016,Guinea-Bissau,277,0.0,174,279,0.0,195,556,0.0,186,2,-1,-300.0
2016,Antigua and Barbuda,61,0.0,183,478,0.0,185,539,0.0,187,417,383,8.88
2016,Central African Republic,115,0.0,180,399,0.0,188,514,0.0,188,284,260,9.23
2016,Vanuatu,50,0.0,188,422,0.0,187,472,0.0,189,372,328,13.41
2016,The Gambia,105,0.0,181,336,0.0,192,441,0.0,190,231,305,-24.26
2016,Samoa,56,0.0,186,350,0.0,191,406,0.0,191,294,312,-5.77
2016,Turks and Caicos Islands,4,0.0,206,389,0.0,189,393,0.0,192,385,405,-4.94
2016,Saint Kitts and Nevis,51,0.0,187,333,0.0,194,384,0.0,193,282,242,16.53
2016,Saint Vincent and the Grenadines,47,0.0,190,335,0.0,193,382,0.0,194,288,288,0.0
2016,Grenada,30,0.0,194,351,0.0,190,381,0.0,195,321,339,-5.31
2016,Comoros,31,0.0,193,219,0.0,197,250,0.0,196,188,197,-4.57
2016,Tonga,21,0.0,195,229,0.0,196,250,0.0,196,208,191,8.9
2016,"Micronesia, Federated States of",49,0.0,189,186,0.0,200,235,0.0,198,137,120,14.17
2016,Dominica,18,0.0,198,214,0.0,198,232,0.0,199,196,184,6.52
2016,Anguilla,7,0.0,203,193,0.0,199,200,0.0,200,186,193,-3.63
2016,Palau,7,0.0,203,154,0.0,201,161,0.0,201,147,144,2.08
2016,Sao Tomé and Principe,14,0.0,200,139,0.0,202,153,0.0,202,125,131,-4.58
2016,Kiribati,11,0.0,202,137,0.0,203,148,0.0,203,126,107,17.76
2016,Marshall Islands,36,0.0,191,97,0.0,205,133,0.0,204,61,56,8.93
2016,Cook Islands,13,0.0,201,107,0.0,204,120,0.0,205,94,95,-1.05
2016,Saint Pierre and Miquelon,3,0.0,208,89,0.0,206,92,0.0,206,86,92,-6.52
2016,"Bonaire, Sint Eustatius and Saba",1,0.0,209,80,0.0,207,81,0.0,207,79,74,6.76
2016,Nauru,18,0.0,198,51,0.0,209,69,0.0,208,33,80,-58.75
2016,Wallis and Futuna Islands,0,0.0,211,65,0.0,208,65,0.0,209,65,65,0.0
2016,Montserrat,4,0.0,206,36,0.0,210,40,0.0,210,32,36,-11.11
2016,Tuvalu,0,0.0,211,23,0.0,211,23,0.0,211,23,37,-37.84
2016,Niue,1,0.0,209,13,0.0,212,14,0.0,212,12,12,0.0
2016,Tokelau,0,0.0,211,0,0.0,213,0,0.0,213,0,0,
2015,China,2273468,13.73,1,1679566,10.05,2,3953034,11.88,1,-593902,-383060,55.04
2015,United States of America,1502572,9.07,2,2315301,13.85,1,3817873,11.47,2,812729,792015,2.62
2015,Germany,1326206,8.01,3,1051132,6.29,3,2377338,7.14,3,-275074,-287021,-4.16
2015,Japan,624921,3.77,4,648117,3.88,4,1273038,3.83,4,23196,122005,-80.99
2015,United Kingdom,465850,2.81,9,630003,3.77,5,1095853,3.29,5,164153,183337,-10.46
2015,Netherlands,570442,3.44,5,512105,3.06,8,1082547,3.25,6,-58337,-82840,-29.58
2015,France,506264,3.06,8,570758,3.41,6,1077022,3.24,7,64494,95224,-32.27
2015,"Hong Kong, China",510486,3.08,7,558770,3.34,7,1069256,3.21,8,48284,76635,-36.99
2015,"Korea, Republic of",526757,3.18,6,436499,2.61,9,963256,2.89,9,-90258,-47527,89.91
2015,Italy,456990,2.76,10,410919,2.46,11,867909,2.61,10,-46071,-55403,-16.84
2015,Canada,410062,2.48,11,430124,2.57,10,840186,2.52,11,20062,-981,-2145.06
2015,Mexico,380550,2.3,13,405282,2.42,12,785832,2.36,12,24732,14669,68.6
2015,Belgium,396841,2.4,12,375530,2.25,14,772371,2.32,13,-21311,-18492,15.24
2015,India,267951,1.62,20,394131,2.36,13,662082,1.99,14,126180,140216,-10.01
2015,Singapore,351587,2.12,14,297087,1.78,16,648674,1.95,15,-54500,-37464,45.47
2015,Spain,282274,1.7,19,311851,1.87,15,594125,1.79,16,29577,34327,-13.84
2015,United Arab Emirates,300477,1.81,16,263417,1.58,17,563894,1.69,17,-37060,-67011,-44.7
2015,Switzerland,289720,1.75,17,253027,1.51,18,542747,1.63,18,-36693,-35463,3.47
2015,Russian Federation,341419,2.06,15,193019,1.15,24,534438,1.61,19,-148400,-188930,-21.45
2015,Chinese Taipei,285344,1.72,18,237219,1.42,19,522563,1.57,20,-48125,-38242,25.84
2015,Thailand,214310,1.29,21,202653,1.21,22,416963,1.25,21,-11657,287,-4161.67
2015,Australia,187684,1.13,25,208501,1.25,21,396185,1.19,22,20817,-2623,-893.63
2015,Poland,199124,1.2,24,196473,1.18,23,395597,1.19,23,-2651,3504,-175.66
2015,"Saudi Arabia, Kingdom of",203550,1.23,22,174676,1.04,27,378226,1.14,24,-28874,-168599,-82.87
2015,Malaysia,199952,1.21,23,175971,1.05,26,375923,1.13,25,-23981,-25076,-4.37
2015,Brazil,186782,1.13,26,180460,1.08,25,367242,1.1,26,-6322,19840,-131.86
2015,Türkiye,150982,0.91,30,213619,1.28,20,364601,1.1,27,62637,84637,-25.99
2015,Viet Nam,162065,0.98,27,165610,0.99,28,327675,0.98,28,3545,-2368,-249.7
2015,Austria,152728,0.92,29,156046,0.93,29,308774,0.93,29,3318,3853,-13.89
2015,Czech Republic,157878,0.95,28,141364,0.85,31,299242,0.9,30,-16514,-20784,-20.54
2015,Indonesia,150366,0.91,31,142695,0.85,30,293061,0.88,31,-7671,1886,-506.73
2015,Sweden,140023,0.85,32,138398,0.83,32,278421,0.84,32,-1625,-2434,-33.24
2015,Ireland,123361,0.74,33,76977,0.46,36,200338,0.6,33,-46384,-39041,18.81
2015,Hungary,98524,0.59,35,91973,0.55,34,190497,0.57,34,-6551,-5725,14.43
2015,South Africa,81002,0.49,37,104651,0.63,33,185653,0.56,35,23649,28907,-18.19
2015,Denmark,95457,0.58,36,85623,0.51,35,181080,0.54,36,-9834,-11921,-17.51
2015,Norway,103915,0.63,34,76424,0.46,37,180339,0.54,37,-27491,-55217,-50.21
2015,Slovak Republic,75146,0.45,39,72837,0.44,39,147983,0.44,38,-2309,-4678,-50.64
2015,Philippines,58827,0.36,45,74750,0.45,38,133577,0.4,39,15923,6602,141.18
2015,Romania,60595,0.37,43,69824,0.42,40,130419,0.39,40,9229,8023,15.03
2015,Israel,64063,0.39,41,62065,0.37,44,126128,0.38,41,-1998,2973,-167.2
2015,Chile,62035,0.37,42,62388,0.37,43,124423,0.37,42,353,-2213,-115.95
2015,Portugal,55047,0.33,47,66914,0.4,41,121961,0.37,43,11867,14557,-18.48
2015,Finland,59817,0.36,44,60430,0.36,45,120247,0.36,44,613,2432,-74.79
2015,Argentina,56784,0.34,46,60205,0.36,46,116989,0.35,45,3421,-2670,-228.13
2015,Iran,70275,0.42,40,44937,0.27,51,115212,0.35,46,-25338,-40054,-36.74
2015,Qatar,77971,0.47,38,32610,0.2,60,110581,0.33,47,-45361,-101144,-55.15
2015,Iraq,51338,0.31,49,47467,0.28,49,98805,0.3,48,-3871,-26768,-85.54
2015,Nigeria,50216,0.3,50,44700,0.27,52,94916,0.29,49,-5516,-44800,-87.69
2015,Colombia,35691,0.22,54,54058,0.32,47,89749,0.27,50,18367,9172,100.25
2015,Algeria,34668,0.21,55,51702,0.31,48,86370,0.26,51,17034,-1481,-1250.17
2015,"Kuwait, the State of",54122,0.33,48,30963,0.19,61,85085,0.26,52,-23159,-71090,-67.42
2015,Egypt,21349,0.13,69,63574,0.38,42,84923,0.26,53,42225,39933,5.74
2015,Kazakhstan,45956,0.28,51,30568,0.18,62,76524,0.23,54,-15388,-38164,-59.68
2015,Ukraine,38127,0.23,52,37517,0.22,57,75644,0.23,55,-610,529,-215.31
2015,Greece,28554,0.17,62,46786,0.28,50,75340,0.23,56,18232,26023,-29.94
2015,Bangladesh,32379,0.2,59,42047,0.25,54,74426,0.22,57,9668,10714,-9.76
2015,Peru,33545,0.2,57,37924,0.23,56,71469,0.21,58,4379,3734,17.27
2015,New Zealand,34355,0.21,56,36554,0.22,58,70909,0.21,59,2199,896,145.42
2015,"Venezuela, Bolivarian Republic of",37309,0.23,53,33330,0.2,59,70639,0.21,60,-3979,-31545,-87.39
2015,Pakistan,22089,0.13,68,44168,0.26,53,66257,0.2,61,22079,22859,-3.41
2015,Slovenia,31929,0.19,60,29815,0.18,64,61744,0.19,62,-2114,-2022,4.55
2015,Oman,31927,0.19,61,29007,0.17,66,60934,0.18,63,-2920,-21415,-86.36
2015,Morocco,22334,0.13,67,38100,0.23,55,60434,0.18,64,15766,22363,-29.5
2015,Belarus,26758,0.16,63,29941,0.18,63,56699,0.17,65,3183,4421,-28.0
2015,Bulgaria,25371,0.15,65,29205,0.17,65,54576,0.16,66,3834,5406,-29.08
2015,Angola,33181,0.2,58,20693,0.12,71,53874,0.16,67,-12488,-30590,-59.18
2015,Lithuania,25392,0.15,64,28154,0.17,67,53546,0.16,68,2762,2040,35.39
2015,Luxembourg,17139,0.1,71,23289,0.14,68,40428,0.12,69,6150,7557,-18.62
2015,Ecuador,18331,0.11,70,21518,0.13,70,39849,0.12,70,3187,2002,59.19
2015,Libya,23185,0.14,66,12536,0.07,88,35721,0.11,71,-10649,-12595,-15.45
2015,Tunisia,14073,0.08,74,20221,0.12,74,34294,0.1,72,6148,8072,-23.84
2015,Panama,11348,0.07,81,22504,0.13,69,33852,0.1,73,11156,11441,-2.49
2015,Croatia,12925,0.08,76,20571,0.12,72,33496,0.1,74,7646,8974,-14.8
2015,Serbia,13376,0.08,75,17876,0.11,77,31252,0.09,75,4500,5756,-21.82
2015,Sri Lanka,10547,0.06,85,18935,0.11,76,29482,0.09,76,8388,8119,3.31
2015,"Bahrain, Kingdom of",16540,0.1,73,12408,0.07,89,28948,0.09,77,-4132,-7914,-47.79
2015,Guatemala,10677,0.06,83,17640,0.11,78,28317,0.09,78,6963,7479,-6.9
2015,Myanmar,11429,0.07,80,16885,0.1,80,28314,0.09,79,5456,5006,8.99
2015,Jordan,7833,0.05,98,20475,0.12,73,28308,0.09,80,12642,14545,-13.08
2015,Estonia,12836,0.08,77,14521,0.09,85,27357,0.08,81,1685,2254,-25.24
2015,Latvia,12286,0.07,78,14719,0.09,84,27005,0.08,82,2433,3249,-25.12
2015,Dominican Republic,9442,0.06,89,16907,0.1,79,26349,0.08,83,7465,7374,1.23
2015,Azerbaijan,16592,0.1,72,9217,0.06,103,25809,0.08,84,-7375,-19072,-61.33
2015,Costa Rica,9422,0.06,90,16273,0.1,82,25695,0.08,85,6851,6259,9.46
2015,Ghana,10321,0.06,86,13465,0.08,86,23786,0.07,86,3144,1383,127.33
2015,Lebanese Republic,3982,0.02,115,18965,0.11,75,22947,0.07,87,14983,17533,-14.54
2015,Côte d'Ivoire,11730,0.07,79,10406,0.06,96,22136,0.07,88,-1324,-1833,-27.77
2015,Kenya,5906,0.04,104,16093,0.1,83,21999,0.07,89,10187,12281,-17.05
2015,Cambodia,8542,0.05,94,13261,0.08,87,21803,0.07,90,4719,3846,22.7
2015,Uzbekistan,9443,0.06,88,11461,0.07,91,20904,0.06,91,2018,2425,-16.78
2015,Trinidad and Tobago,10748,0.06,82,9233,0.06,102,19981,0.06,92,-1515,-3281,-53.83
2015,Ethiopia,2914,0.02,122,16702,0.1,81,19616,0.06,93,13788,12082,14.12
2015,Honduras,8226,0.05,97,11175,0.07,92,19401,0.06,94,2949,2934,0.51
2015,Congo,8623,0.05,93,10550,0.06,95,19173,0.06,95,1927,1426,35.13
2015,Paraguay,8357,0.05,96,10291,0.06,98,18648,0.06,96,1934,2533,-23.65
2015,"Bolivia, Plurinational State of",8726,0.05,91,9766,0.06,99,18492,0.06,97,1040,-1781,-158.39
2015,Uruguay,7688,0.05,99,9489,0.06,101,17177,0.05,98,1801,2353,-23.46
2015,Turkmenistan,10000,0.06,87,7000,0.04,114,17000,0.05,99,-3000,-7500,-60.0
2015,Gabon,10654,0.06,84,6121,0.04,119,16775,0.05,100,-4533,-4350,4.21
2015,Democratic Republic of the Congo,8685,0.05,92,8068,0.05,106,16753,0.05,101,-617,-828,-25.48
2015,El Salvador,5509,0.03,105,10293,0.06,97,15802,0.05,102,4784,5212,-8.21
2015,Tanzania,4834,0.03,108,10789,0.06,93,15623,0.05,103,5955,7365,-19.14
2015,Cuba,3350,0.02,118,11702,0.07,90,15052,0.05,104,8352,8180,2.1
2015,Zambia,6607,0.04,100,7935,0.05,107,14542,0.04,105,1328,13,10115.38
2015,Bosnia and Herzegovina,5098,0.03,106,8986,0.05,104,14084,0.04,106,3888,5096,-23.7
2015,Botswana,6316,0.04,103,7238,0.04,111,13554,0.04,107,922,-432,-313.43
2015,Sudan,3169,0.02,121,9509,0.06,100,12678,0.04,108,6340,4861,30.43
2015,"Macao, China",1339,0.01,142,10603,0.06,94,11942,0.04,109,9264,10021,-7.55
2015,Nicaragua,4839,0.03,107,7060,0.04,112,11899,0.04,110,2221,1820,22.03
2015,Namibia,4067,0.02,113,7697,0.05,109,11764,0.04,111,3630,3911,-7.18
2015,Mozambique,3413,0.02,117,8334,0.05,105,11747,0.04,112,4921,4326,13.75
2015,Papua New Guinea,8453,0.05,95,2551,0.02,147,11004,0.03,113,-5902,-4794,23.11
2015,North Macedonia,4536,0.03,111,6427,0.04,117,10963,0.03,114,1891,2332,-18.91
2015,Cyprus,3295,0.02,119,7023,0.04,113,10318,0.03,115,3728,4833,-22.86
2015,Cameroon,4058,0.02,114,6045,0.04,121,10103,0.03,116,1987,2408,-17.48
2015,Iceland,4732,0.03,109,5299,0.03,126,10031,0.03,117,567,322,76.09
2015,Equatorial Guinea,6500,0.04,101,3525,0.02,138,10025,0.03,118,-2975,-6854,-56.59
2015,Brunei Darussalam,6353,0.04,102,3229,0.02,141,9582,0.03,119,-3124,-6910,-54.79
2015,Georgia,2204,0.01,130,7300,0.04,110,9504,0.03,120,5096,5741,-11.23
2015,Lao People's Democratic Republic,3653,0.02,116,5675,0.03,123,9328,0.03,121,2022,1609,25.67
2015,Zimbabwe,3248,0.02,120,6053,0.04,120,9301,0.03,122,2805,2204,27.27
2015,"Korea, Democratic People's Republic of",4152,0.03,112,4822,0.03,128,8974,0.03,123,670,1220,-45.08
2015,Malta,2607,0.02,126,6036,0.04,122,8643,0.03,124,3429,3869,-11.37
2015,Syrian Arab Republic,2357,0.01,128,6275,0.04,118,8632,0.03,125,3918,9058,-56.75
2015,Mongolia,4669,0.03,110,3798,0.02,134,8467,0.03,126,-871,-538,61.9
2015,Afghanistan,571,0.0,156,7723,0.05,108,8294,0.02,127,7152,7159,-0.1
2015,Senegal,2612,0.02,125,5595,0.03,124,8207,0.02,128,2983,3805,-21.6
2015,Uganda,2267,0.01,129,5528,0.03,125,7795,0.02,129,3261,3812,-14.45
2015,Mauritius,2662,0.02,124,4790,0.03,129,7452,0.02,130,2128,2516,-15.42
2015,Nepal,721,0.0,153,6652,0.04,115,7373,0.02,131,5931,6701,-11.49
2015,Yemen,510,0.0,160,6573,0.04,116,7083,0.02,132,6063,9625,-37.01
2015,Mali,2717,0.02,123,3800,0.02,133,6517,0.02,133,1083,1133,-4.41
2015,Jamaica,1263,0.01,143,4993,0.03,127,6256,0.02,134,3730,4388,-15.0
2015,Albania,1917,0.01,134,4302,0.03,130,6219,0.02,135,2385,2793,-14.61
2015,Chad,2426,0.01,127,3700,0.02,136,6126,0.02,136,1274,206,518.45
2015,"Moldova, Republic of",1967,0.01,133,3987,0.02,132,5954,0.02,137,2020,2977,-32.15
2015,Mauritania,1832,0.01,135,3703,0.02,135,5535,0.02,138,1871,1502,24.57
2015,Kyrgyz Republic,1441,0.01,141,4070,0.02,131,5511,0.02,139,2629,3835,-31.45
2015,Burkina Faso,2176,0.01,131,3080,0.02,143,5256,0.02,140,904,1123,-19.5
2015,Madagascar,2048,0.01,132,2795,0.02,144,4843,0.01,141,747,1031,-27.55
2015,Armenia,1485,0.01,140,3239,0.02,140,4724,0.01,142,1754,2882,-39.14
2015,Haiti,882,0.01,152,3683,0.02,137,4565,0.01,143,2801,2784,0.61
2015,Tajikistan,891,0.01,151,3436,0.02,139,4327,0.01,144,2545,3320,-23.34
2015,Benin,1682,0.01,138,2561,0.02,146,4243,0.01,145,879,1268,-30.68
2015,Guinea,1781,0.01,137,2192,0.01,152,3973,0.01,146,411,306,34.31
2015,New Caledonia,1219,0.01,144,2689,0.02,145,3908,0.01,147,1470,1728,-14.93
2015,Suriname,1652,0.01,139,2028,0.01,156,3680,0.01,148,376,-131,-387.02
2015,Bahamas,443,0.0,164,3162,0.02,142,3605,0.01,149,2719,3100,-12.29
2015,Niger,1087,0.01,146,2490,0.01,148,3577,0.01,150,1403,1316,6.61
2015,Togo,1011,0.01,148,2336,0.01,150,3347,0.01,151,1325,1202,10.23
2015,Malawi,1072,0.01,147,2270,0.01,151,3342,0.01,152,1198,1335,-10.26
2015,Eswatini,1812,0.01,136,1412,0.01,165,3224,0.01,153,-400,-314,27.39
2015,Rwanda,682,0.0,154,2382,0.01,149,3064,0.01,154,1700,1747,-2.69
2015,Fiji,895,0.01,150,2081,0.01,154,2976,0.01,155,1186,1877,-36.81
2015,Lesotho,929,0.01,149,1997,0.01,157,2926,0.01,156,1068,1381,-22.66
2015,Somalia,678,0.0,155,2158,0.01,153,2836,0.01,157,1480,1364,8.5
2015,Guyana,1151,0.01,145,1492,0.01,164,2643,0.01,158,341,624,-45.35
2015,Montenegro,352,0.0,169,2040,0.01,155,2392,0.01,159,1688,1928,-12.45
2015,Maldives,240,0.0,173,1896,0.01,158,2136,0.01,160,1656,1692,-2.13
2015,Barbados,483,0.0,162,1618,0.01,160,2101,0.01,161,1135,1265,-10.28
2015,Sierra Leone,512,0.0,159,1530,0.01,162,2042,0.01,162,1018,16,6262.5
2015,Curaçao,466,0.0,163,1532,0.01,161,1998,0.01,163,1066,1117,-4.57
2015,Liberia,283,0.0,171,1687,0.01,159,1970,0.01,164,1404,1553,-9.59
2015,French Polynesia,130,0.0,176,1527,0.01,163,1657,0.0,165,1397,1595,-12.41
2015,Bhutan,549,0.0,157,1061,0.01,168,1610,0.0,166,512,349,46.7
2015,"Aruba, Netherlands with respect to",330,0.0,170,1250,0.01,167,1580,0.0,167,920,1091,-15.67
2015,Belize,538,0.0,158,991,0.01,170,1529,0.0,168,453,373,21.45
2015,Eritrea,499,0.0,161,1020,0.01,169,1519,0.0,169,521,500,4.2
2015,Seychelles,415,0.0,165,991,0.01,170,1406,0.0,170,576,604,-4.64
2015,Andorra,90,0.0,180,1294,0.01,166,1384,0.0,171,1204,1461,-17.59
2015,Greenland,406,0.0,166,667,0.0,179,1073,0.0,172,261,308,-15.26
2015,American Samoa,379,0.0,168,675,0.0,178,1054,0.0,173,296,265,11.7
2015,Cayman Islands,65,0.0,184,986,0.01,172,1051,0.0,174,921,975,-5.54
2015,Djibouti,134,0.0,175,871,0.01,174,1005,0.0,175,737,674,9.35
2015,Sint Maarten,129,0.0,177,857,0.01,175,986,0.0,176,728,881,-17.37
2015,Burundi,121,0.0,178,857,0.01,175,978,0.0,177,736,637,15.54
2015,Bermuda,22,0.0,194,934,0.01,173,956,0.0,178,912,940,-2.98
2015,Solomon Islands,400,0.0,167,466,0.0,184,866,0.0,179,66,40,65.0
2015,Saint Lucia,180,0.0,174,570,0.0,182,750,0.0,180,390,466,-16.31
2015,Guam,32,0.0,192,705,0.0,177,737,0.0,181,673,1035,-34.98
2015,Cabo Verde,67,0.0,182,604,0.0,180,671,0.0,182,537,688,-21.95
2015,Timor-Leste,18,0.0,195,578,0.0,181,596,0.0,183,560,843,-33.57
2015,The Gambia,115,0.0,179,420,0.0,186,535,0.0,184,305,262,16.41
2015,Antigua and Barbuda,66,0.0,183,449,0.0,185,515,0.0,185,383,433,-11.55
2015,Guinea-Bissau,252,0.0,172,251,0.0,194,503,0.0,186,-1,94,-101.06
2015,Northern Mariana Islands,2,0.0,206,472,0.0,183,474,0.0,187,470,440,6.82
2015,Central African Republic,86,0.0,181,346,0.0,191,432,0.0,188,260,307,-15.31
2015,Samoa,59,0.0,185,371,0.0,189,430,0.0,189,312,337,-7.42
2015,Turks and Caicos Islands,5,0.0,204,410,0.0,187,415,0.0,190,405,400,1.25
2015,Vanuatu,39,0.0,190,367,0.0,190,406,0.0,191,328,250,31.2
2015,Grenada,33,0.0,191,372,0.0,188,405,0.0,192,339,303,11.88
2015,Saint Vincent and the Grenadines,46,0.0,188,334,0.0,192,380,0.0,193,288,313,-7.99
2015,Saint Kitts and Nevis,55,0.0,186,297,0.0,193,352,0.0,194,242,211,14.69
2015,Dominica,30,0.0,193,214,0.0,195,244,0.0,195,184,194,-5.15
2015,Comoros,17,0.0,197,214,0.0,195,231,0.0,196,197,252,-21.83
2015,Tonga,18,0.0,195,209,0.0,197,227,0.0,197,191,200,-4.5
2015,Anguilla,11,0.0,199,204,0.0,198,215,0.0,198,193,170,13.53
2015,"Micronesia, Federated States of",40,0.0,189,160,0.0,199,200,0.0,199,120,129,-6.98
2015,Marshall Islands,52,0.0,187,108,0.0,204,160,0.0,200,56,81,-30.86
2015,Palau,6,0.0,203,150,0.0,200,156,0.0,201,144,154,-6.49
2015,Sao Tomé and Principe,11,0.0,199,142,0.0,201,153,0.0,202,131,153,-14.38
2015,Kiribati,10,0.0,202,117,0.0,202,127,0.0,203,107,97,10.31
2015,Cook Islands,14,0.0,198,109,0.0,203,123,0.0,204,95,103,-7.77
2015,Nauru,11,0.0,199,91,0.0,206,102,0.0,205,80,92,-13.04
2015,Saint Pierre and Miquelon,1,0.0,207,93,0.0,205,94,0.0,206,92,116,-20.69
2015,"Bonaire, Sint Eustatius and Saba",1,0.0,207,75,0.0,207,76,0.0,207,74,69,7.25
2015,Wallis and Futuna Islands,0,0.0,209,65,0.0,208,65,0.0,208,65,66,-1.52
2015,Montserrat,3,0.0,205,39,0.0,209,42,0.0,209,36,38,-5.26
2015,Tuvalu,0,0.0,209,37,0.0,210,37,0.0,210,37,22,68.18
2015,Niue,0,0.0,209,12,0.0,211,12,0.0,211,12,12,0.0
2015,Tokelau,0,0.0,209,0,0.0,212,0,0.0,212,0,0,
2014,China,2342293,12.32,1,1959233,10.28,2,4301526,11.3,1,-383060,-259015,47.89
2014,United States of America,1620532,8.53,2,2412547,12.66,1,4033079,10.59,2,792015,749467,5.68
2014,Germany,1494214,7.86,3,1207193,6.33,3,2701407,7.1,3,-287021,-263834,8.79
2014,Japan,690203,3.63,4,812208,4.26,4,1502411,3.95,4,122005,118069,3.33
2014,Netherlands,672410,3.54,5,589570,3.09,8,1261980,3.31,5,-82840,-81859,1.2
2014,France,581393,3.06,6,676617,3.55,6,1258010,3.3,6,95224,100504,-5.25
2014,United Kingdom,510789,2.69,10,694126,3.64,5,1204915,3.17,7,183337,115405,58.86
2014,"Hong Kong, China",524130,2.76,9,600765,3.15,7,1124895,2.95,8,76635,86731,-11.64
2014,"Korea, Republic of",573091,3.02,7,525564,2.76,9,1098655,2.89,9,-47527,-44048,7.9
2014,Italy,529797,2.79,8,474394,2.49,11,1004191,2.64,10,-55403,-38821,42.71
2014,Canada,476300,2.51,12,475319,2.49,10,951619,2.5,11,-981,17459,-105.62
2014,Belgium,472192,2.48,13,453700,2.38,13,925892,2.43,12,-18492,-17083,8.25
2014,Mexico,396912,2.09,15,411581,2.16,14,808493,2.12,13,14669,10950,33.96
2014,Russian Federation,496807,2.61,11,307877,1.62,17,804684,2.11,14,-188930,-180567,4.63
2014,Singapore,415378,2.19,14,377914,1.98,15,793292,2.08,15,-37464,-37234,0.62
2014,India,322694,1.7,19,462910,2.43,12,785604,2.06,16,140216,150549,-6.86
2014,Spain,324533,1.71,18,358860,1.88,16,683393,1.8,17,34327,22765,50.79
2014,United Arab Emirates,343036,1.8,16,276025,1.45,19,619061,1.63,18,-67011,-103635,-35.34
2014,Chinese Taipei,320092,1.68,20,281850,1.48,18,601942,1.58,19,-38242,-33418,14.44
2014,Switzerland,311204,1.64,21,275741,1.45,20,586945,1.54,20,-35463,-36343,-2.42
2014,"Saudi Arabia, Kingdom of",342433,1.8,17,173834,0.91,29,516267,1.36,21,-168599,-207717,-18.83
2014,Australia,239975,1.26,22,237352,1.25,23,477327,1.25,22,-2623,-10841,-75.8
2014,Brazil,220923,1.16,25,240763,1.26,22,461686,1.21,23,19840,19738,0.52
2014,Thailand,227462,1.2,24,227749,1.19,24,455211,1.2,24,287,21902,-98.69
2014,Poland,220052,1.16,26,223556,1.17,25,443608,1.17,25,3504,2623,33.59
2014,Malaysia,233927,1.23,23,208851,1.1,26,442778,1.16,26,-25076,-22434,11.78
2014,Türkiye,166505,0.88,30,251142,1.32,21,417647,1.1,27,84637,99342,-14.8
2014,Austria,178223,0.94,27,182076,0.96,27,360299,0.95,28,3853,8121,-52.56
2014,Indonesia,176293,0.93,28,178179,0.93,28,354472,0.93,29,1886,4077,-53.74
2014,Czech Republic,175021,0.92,29,154237,0.81,31,329258,0.86,30,-20784,-18015,15.37
2014,Sweden,164645,0.87,31,162211,0.85,30,326856,0.86,31,-2434,-6941,-64.93
2014,Viet Nam,150217,0.79,32,147849,0.78,32,298066,0.78,32,-2368,0,
2014,Norway,144677,0.76,33,89460,0.47,36,234137,0.62,33,-55217,-66214,-16.61
2014,Hungary,110622,0.58,37,104897,0.55,34,215519,0.57,34,-5725,-7392,-22.55
2014,South Africa,93043,0.49,41,121950,0.64,33,214993,0.56,35,28907,30177,-4.21
2014,Denmark,111493,0.59,36,99572,0.52,35,211065,0.55,36,-11921,-13601,-12.35
2014,Ireland,121057,0.64,35,82016,0.43,37,203073,0.53,37,-39041,-44503,-12.27
2014,Slovak Republic,86227,0.45,42,81549,0.43,38,167776,0.44,38,-4678,-3786,23.56
2014,Qatar,131592,0.69,34,30448,0.16,66,162040,0.43,39,-101144,-109821,-7.9
2014,Nigeria,103100,0.54,38,58300,0.31,51,161400,0.42,40,-44800,-34555,29.65
2014,Finland,74333,0.39,47,76765,0.4,41,151098,0.4,41,2432,3133,-22.37
2014,Iran,95160,0.5,40,55106,0.29,52,150266,0.39,42,-40054,-44194,-9.37
2014,Chile,75065,0.39,45,72852,0.38,42,147917,0.39,43,-2213,2583,-185.68
2014,Romania,69725,0.37,48,77748,0.41,40,147473,0.39,44,8023,7646,4.93
2014,Iraq,85370,0.45,43,58602,0.31,49,143972,0.38,45,-26768,-27267,-1.83
2014,Portugal,63832,0.34,51,78389,0.41,39,142221,0.37,46,14557,12896,12.88
2014,Israel,68507,0.36,49,71480,0.37,43,139987,0.37,47,2973,4495,-33.86
2014,Argentina,68405,0.36,50,65735,0.34,46,134140,0.35,48,-2670,-1521,75.54
2014,"Kuwait, the State of",102111,0.54,39,31021,0.16,65,133132,0.35,49,-71090,-85805,-17.15
2014,Philippines,62102,0.33,52,68704,0.36,44,130806,0.34,50,6602,9041,-26.98
2014,Kazakhstan,79460,0.42,44,41296,0.22,59,120756,0.32,51,-38164,-35894,6.32
2014,Colombia,54857,0.29,55,64029,0.34,47,118886,0.31,52,9172,573,1500.7
2014,Algeria,60061,0.32,53,58580,0.31,50,118641,0.31,53,-1481,-9946,-85.11
2014,"Venezuela, Bolivarian Republic of",74714,0.39,46,43169,0.23,56,117883,0.31,54,-31545,-39980,-21.1
2014,Ukraine,53901,0.28,56,54430,0.29,53,108331,0.28,55,529,12449,-95.75
2014,Greece,35960,0.19,61,61983,0.33,48,97943,0.26,56,26023,24719,5.28
2014,Egypt,26853,0.14,68,66786,0.35,45,93639,0.25,57,39933,37162,7.46
2014,Angola,59170,0.31,54,28580,0.15,68,87750,0.23,58,-30590,-41916,-27.02
2014,New Zealand,41622,0.22,58,42518,0.22,57,84140,0.22,59,896,196,357.14
2014,Peru,38612,0.2,59,42346,0.22,58,80958,0.21,60,3734,1094,241.32
2014,Oman,50718,0.27,57,29303,0.15,67,80021,0.21,61,-21415,-21166,1.18
2014,Belarus,36081,0.19,60,40502,0.21,61,76583,0.2,62,4421,5390,-17.98
2014,Pakistan,24731,0.13,70,47590,0.25,54,72321,0.19,63,22859,19526,17.07
2014,Bangladesh,30405,0.16,65,41119,0.22,60,71524,0.19,64,10714,7971,34.41
2014,Morocco,23920,0.13,71,46283,0.24,55,70203,0.18,65,22363,23218,-3.68
2014,Slovenia,35956,0.19,62,33934,0.18,64,69890,0.18,66,-2022,-646,213.0
2014,Lithuania,32319,0.17,63,34359,0.18,63,66678,0.18,67,2040,2208,-7.61
2014,Bulgaria,29245,0.15,66,34651,0.18,62,63896,0.17,68,5406,4724,14.44
2014,Ecuador,25724,0.14,69,27726,0.15,69,53450,0.14,69,2002,2298,-12.88
2014,Libya,32022,0.17,64,19427,0.1,77,51449,0.14,70,-12595,-21467,-41.33
2014,Luxembourg,19099,0.1,73,26656,0.14,70,45755,0.12,71,7557,8251,-8.41
2014,Tunisia,16756,0.09,75,24828,0.13,71,41584,0.11,72,8072,7205,12.03
2014,Azerbaijan,28260,0.15,67,9188,0.05,109,37448,0.1,73,-19072,-21382,-10.8
2014,Panama,12960,0.07,83,24401,0.13,72,37361,0.1,74,11441,8256,38.58
2014,Croatia,13835,0.07,81,22809,0.12,74,36644,0.1,75,8974,9363,-4.15
2014,Serbia,14845,0.08,77,20601,0.11,76,35446,0.09,76,5756,5929,-2.92
2014,Estonia,16042,0.08,76,18296,0.1,80,34338,0.09,77,2254,2144,5.13
2014,Latvia,14715,0.08,78,17964,0.09,82,32679,0.09,78,3249,3398,-4.38
2014,"Bahrain, Kingdom of",20130,0.11,72,12216,0.06,90,32346,0.08,79,-7914,-11933,-33.68
2014,Jordan,8385,0.04,100,22930,0.12,73,31315,0.08,80,14545,13629,6.72
2014,Sri Lanka,11298,0.06,89,19417,0.1,78,30715,0.08,81,8119,7795,4.16
2014,Guatemala,10803,0.06,91,18282,0.1,81,29085,0.08,82,7479,7493,-0.19
2014,Costa Rica,11250,0.06,90,17509,0.09,83,28759,0.08,83,6259,6647,-5.84
2014,Myanmar,11453,0.06,88,16459,0.09,85,27912,0.07,84,5006,810,518.02
2014,Ghana,13217,0.07,82,14600,0.08,87,27817,0.07,85,1383,3848,-64.06
2014,Turkmenistan,17500,0.09,74,10000,0.05,105,27500,0.07,86,-7500,-6800,10.29
2014,Dominican Republic,9899,0.05,93,17273,0.09,84,27172,0.07,87,7374,7222,2.1
2014,Lebanese Republic,4548,0.02,115,22081,0.12,75,26629,0.07,88,17533,16854,4.03
2014,Trinidad and Tobago,14530,0.08,79,11249,0.06,96,25779,0.07,89,-3281,-6116,-46.35
2014,Uzbekistan,11500,0.06,87,13925,0.07,88,25425,0.07,90,2425,1138,113.09
2014,Kenya,6115,0.03,104,18396,0.1,79,24511,0.06,91,12281,10502,16.94
2014,Côte d'Ivoire,12951,0.07,84,11118,0.06,97,24069,0.06,92,-1833,672,-372.77
2014,Gabon,13914,0.07,80,9564,0.05,107,23478,0.06,93,-4350,-6502,-33.1
2014,"Bolivia, Plurinational State of",12300,0.06,86,10519,0.06,101,22819,0.06,94,-1781,-2319,-23.2
2014,Paraguay,9636,0.05,95,12169,0.06,91,21805,0.06,95,2533,2686,-5.7
2014,Uruguay,9132,0.05,96,11485,0.06,94,20617,0.05,96,2353,2575,-8.62
2014,Zambia,9694,0.05,94,9707,0.05,106,19401,0.05,97,13,-21,-161.9
2014,Honduras,8117,0.04,101,11051,0.06,98,19168,0.05,98,2934,3120,-5.96
2014,Congo,8673,0.05,98,10099,0.05,104,18772,0.05,99,1426,-2081,-168.52
2014,Equatorial Guinea,12800,0.07,85,5946,0.03,125,18746,0.05,100,-6854,-8596,-20.27
2014,Ethiopia,3275,0.02,121,15357,0.08,86,18632,0.05,101,12082,9099,32.78
2014,Cuba,4857,0.03,112,13037,0.07,89,17894,0.05,102,8180,9424,-13.2
2014,Cambodia,6846,0.04,103,10692,0.06,100,17538,0.05,103,3846,2889,33.13
2014,Bosnia and Herzegovina,5892,0.03,105,10988,0.06,99,16880,0.04,104,5096,4608,10.59
2014,Tanzania,4628,0.02,113,11993,0.06,93,16621,0.04,105,7365,7532,-2.22
2014,Botswana,8510,0.04,99,8078,0.04,113,16588,0.04,106,-432,441,-197.96
2014,El Salvador,5302,0.03,107,10514,0.06,102,15816,0.04,107,5212,5281,-1.31
2014,Democratic Republic of the Congo,7915,0.04,102,7087,0.04,119,15002,0.04,108,-828,100,-928.0
2014,Yemen,2417,0.01,132,12042,0.06,92,14459,0.04,109,9625,6143,56.68
2014,Brunei Darussalam,10509,0.06,92,3599,0.02,144,14108,0.04,110,-6910,-7835,-11.81
2014,Sudan,4350,0.02,118,9211,0.05,108,13561,0.04,111,4861,5128,-5.21
2014,Mozambique,4421,0.02,116,8747,0.05,110,13168,0.03,112,4326,6075,-28.79
2014,Namibia,4612,0.02,114,8523,0.04,112,13135,0.03,113,3911,2992,30.72
2014,Papua New Guinea,8794,0.05,97,4000,0.02,138,12794,0.03,114,-4794,-541,786.14
2014,Cameroon,5145,0.03,108,7553,0.04,117,12698,0.03,115,2408,2134,12.84
2014,"Macao, China",1241,0.01,149,11262,0.06,95,12503,0.03,116,10021,9002,11.32
2014,North Macedonia,4969,0.03,111,7301,0.04,118,12270,0.03,117,2332,2321,0.47
2014,Nicaragua,5126,0.03,109,6946,0.04,120,12072,0.03,118,1820,1894,-3.91
2014,Georgia,2861,0.02,125,8602,0.05,111,11463,0.03,119,5741,5113,12.28
2014,Syrian Arab Republic,1162,0.01,151,10220,0.05,103,11382,0.03,120,9058,7137,26.92
2014,Cyprus,3163,0.02,122,7996,0.04,114,11159,0.03,121,4833,4295,12.53
2014,Mongolia,5775,0.03,106,5237,0.03,132,11012,0.03,122,-538,2089,-125.75
2014,Iceland,5053,0.03,110,5375,0.03,130,10428,0.03,123,322,22,1363.64
2014,"Korea, Democratic People's Republic of",4365,0.02,117,5585,0.03,129,9950,0.03,124,1220,815,49.69
2014,Zimbabwe,3866,0.02,120,6070,0.03,124,9936,0.03,125,2204,3309,-33.39
2014,Malta,2929,0.02,124,6798,0.04,121,9727,0.03,126,3869,2505,54.45
2014,Senegal,2750,0.01,127,6555,0.03,122,9305,0.02,127,3805,3891,-2.21
2014,Mauritius,3094,0.02,123,5610,0.03,128,8704,0.02,128,2516,2528,-0.47
2014,Chad,4194,0.02,119,4400,0.02,135,8594,0.02,129,206,-800,-125.75
2014,Nepal,889,0.0,154,7590,0.04,116,8479,0.02,130,6701,5692,17.73
2014,Uganda,2262,0.01,134,6074,0.03,123,8336,0.02,131,3812,3410,11.79
2014,Afghanistan,570,0.0,163,7729,0.04,115,8299,0.02,132,7159,8039,-10.95
2014,"Moldova, Republic of",2340,0.01,133,5317,0.03,131,7657,0.02,133,2977,3064,-2.84
2014,Albania,2429,0.01,131,5222,0.03,133,7651,0.02,134,2793,2581,8.21
2014,Kyrgyz Republic,1897,0.01,140,5732,0.03,127,7629,0.02,135,3835,4012,-4.41
2014,Jamaica,1452,0.01,144,5840,0.03,126,7292,0.02,136,4388,4647,-5.57
2014,Lao People's Democratic Republic,2662,0.01,128,4271,0.02,137,6933,0.02,137,1609,817,96.94
2014,Mali,2776,0.01,126,3909,0.02,139,6685,0.02,138,1133,1468,-22.82
2014,Benin,2560,0.01,129,3828,0.02,140,6388,0.02,139,1268,1028,23.35
2014,Burkina Faso,2453,0.01,130,3576,0.02,145,6029,0.02,140,1123,2009,-44.1
2014,Armenia,1519,0.01,143,4401,0.02,134,5920,0.02,141,2882,2997,-3.84
2014,Mauritania,2140,0.01,136,3642,0.02,143,5782,0.02,142,1502,1515,-0.86
2014,Madagascar,2196,0.01,135,3227,0.02,148,5423,0.01,143,1031,1337,-22.89
2014,Tajikistan,977,0.01,152,4297,0.02,136,5274,0.01,144,3320,2989,11.07
2014,New Caledonia,1595,0.01,141,3323,0.02,146,4918,0.01,145,1728,1979,-12.68
2014,Haiti,950,0.0,153,3734,0.02,142,4684,0.01,146,2784,2695,3.3
2014,Fiji,1373,0.01,147,3250,0.02,147,4623,0.01,147,1877,1718,9.25
2014,Bahamas,690,0.0,158,3790,0.02,141,4480,0.01,148,3100,2555,21.33
2014,Guinea,2066,0.01,138,2372,0.01,153,4438,0.01,149,306,-17,-1900.0
2014,Niger,1445,0.01,145,2761,0.01,149,4206,0.01,150,1316,950,38.53
2014,Malawi,1418,0.01,146,2753,0.01,150,4171,0.01,151,1335,1636,-18.4
2014,Suriname,2113,0.01,137,1982,0.01,159,4095,0.01,152,-131,-242,-45.87
2014,Togo,1324,0.01,148,2526,0.01,151,3850,0.01,153,1202,1247,-3.61
2014,Eswatini,2004,0.01,139,1690,0.01,164,3694,0.01,154,-314,-202,55.45
2014,Rwanda,723,0.0,156,2470,0.01,152,3193,0.01,155,1747,1599,9.26
2014,Sierra Leone,1552,0.01,142,1568,0.01,165,3120,0.01,156,16,-137,-111.68
2014,Lesotho,826,0.0,155,2207,0.01,155,3033,0.01,157,1381,1328,3.99
2014,Guyana,1167,0.01,150,1791,0.01,161,2958,0.01,158,624,500,24.8
2014,Montenegro,441,0.0,169,2369,0.01,154,2810,0.01,159,1928,1856,3.88
2014,Somalia,671,0.0,159,2035,0.01,156,2706,0.01,160,1364,1211,12.63
2014,Curaçao,702,0.0,157,1819,0.01,160,2521,0.01,161,1117,1201,-6.99
2014,Liberia,444,0.0,168,1997,0.01,157,2441,0.01,162,1553,591,162.77
2014,Maldives,301,0.0,171,1993,0.01,158,2294,0.01,163,1692,1402,20.68
2014,Barbados,474,0.0,166,1739,0.01,163,2213,0.01,164,1265,1302,-2.84
2014,French Polynesia,170,0.0,173,1765,0.01,162,1935,0.01,165,1595,1650,-3.33
2014,Eritrea,630,0.0,160,1130,0.01,169,1760,0.0,166,500,724,-30.94
2014,Seychelles,540,0.0,165,1144,0.01,168,1684,0.0,167,604,504,19.84
2014,Andorra,95,0.0,182,1556,0.01,166,1651,0.0,168,1461,,
2014,"Aruba, Netherlands with respect to",259,0.0,172,1350,0.01,167,1609,0.0,169,1091,1098,-0.64
2014,Belize,589,0.0,161,962,0.01,173,1551,0.0,170,373,319,16.93
2014,Bhutan,583,0.0,162,932,0.0,175,1515,0.0,171,349,365,-4.38
2014,Greenland,559,0.0,164,867,0.0,176,1426,0.0,172,308,413,-25.42
2014,Sint Maarten,132,0.0,176,1013,0.01,172,1145,0.0,173,881,761,15.77
2014,Guam,41,0.0,190,1076,0.01,170,1117,0.0,174,1035,635,62.99
2014,Cayman Islands,48,0.0,188,1023,0.01,171,1071,0.0,175,975,929,4.95
2014,Bermuda,22,0.0,195,962,0.01,173,984,0.0,176,940,1000,-6.0
2014,Solomon Islands,459,0.0,167,499,0.0,184,958,0.0,177,40,50,-20.0
2014,American Samoa,346,0.0,170,611,0.0,182,957,0.0,178,265,91,191.21
2014,Djibouti,129,0.0,178,803,0.0,178,932,0.0,179,674,599,12.52
2014,Burundi,132,0.0,176,769,0.0,179,901,0.0,180,637,717,-11.16
2014,Timor-Leste,15,0.0,200,858,0.0,177,873,0.0,181,843,825,2.18
2014,Cabo Verde,80,0.0,183,768,0.0,180,848,0.0,182,688,656,4.88
2014,Saint Lucia,161,0.0,175,627,0.0,181,788,0.0,183,466,446,4.48
2014,Antigua and Barbuda,99,0.0,180,532,0.0,183,631,0.0,184,433,434,-0.23
2014,The Gambia,125,0.0,179,387,0.0,189,512,0.0,185,262,216,21.3
2014,Central African Republic,99,0.0,180,406,0.0,186,505,0.0,186,307,97,216.49
2014,Northern Mariana Islands,2,0.0,206,442,0.0,185,444,0.0,187,440,331,32.93
2014,Samoa,51,0.0,187,388,0.0,188,439,0.0,188,337,305,10.49
2014,Guinea-Bissau,166,0.0,174,260,0.0,195,426,0.0,189,94,61,54.1
2014,Turks and Caicos Islands,6,0.0,203,406,0.0,186,412,0.0,190,400,,
2014,Saint Vincent and the Grenadines,48,0.0,188,361,0.0,190,409,0.0,191,313,321,-2.49
2014,Grenada,37,0.0,191,340,0.0,191,377,0.0,192,303,331,-8.46
2014,Vanuatu,63,0.0,184,313,0.0,192,376,0.0,193,250,274,-8.76
2014,Saint Kitts and Nevis,57,0.0,185,268,0.0,194,325,0.0,194,211,193,9.33
2014,Comoros,26,0.0,194,278,0.0,193,304,0.0,195,252,263,-4.18
2014,Dominica,36,0.0,192,230,0.0,196,266,0.0,196,194,168,15.48
2014,Tonga,19,0.0,197,219,0.0,197,238,0.0,197,200,181,10.5
2014,"Micronesia, Federated States of",32,0.0,193,161,0.0,201,193,0.0,198,129,153,-15.69
2014,Marshall Islands,55,0.0,186,136,0.0,202,191,0.0,199,81,82,-1.22
2014,Sao Tomé and Principe,17,0.0,199,170,0.0,199,187,0.0,200,153,139,10.07
2014,Anguilla,5,0.0,204,175,0.0,198,180,0.0,201,170,,
2014,Palau,11,0.0,201,165,0.0,200,176,0.0,202,154,162,-4.94
2014,Cook Islands,18,0.0,198,121,0.0,203,139,0.0,203,103,103,0.0
2014,Nauru,22,0.0,195,114,0.0,205,136,0.0,204,92,,
2014,Saint Pierre and Miquelon,2,0.0,206,118,0.0,204,120,0.0,205,116,121,-4.13
2014,Kiribati,10,0.0,202,107,0.0,206,117,0.0,206,97,90,7.78
2014,"Bonaire, Sint Eustatius and Saba",1,0.0,208,70,0.0,207,71,0.0,207,69,,
2014,Wallis and Futuna Islands,0,0.0,209,66,0.0,208,66,0.0,208,66,,
2014,Montserrat,3,0.0,205,41,0.0,209,44,0.0,209,38,36,5.56
2014,Tuvalu,0,0.0,209,22,0.0,210,22,0.0,210,22,21,4.76
2014,Niue,0,0.0,209,12,0.0,211,12,0.0,211,12,9,33.33
2014,Tokelau,0,0.0,209,0,0.0,212,0,0.0,212,0,,
2013,China,2209005,11.65,1,1949990,10.28,2,4158995,10.97,1,-259015,-230309,12.46
2013,United States of America,1579593,8.33,2,2329060,12.28,1,3908653,10.3,2,749467,790821,-5.23
2013,Germany,1445067,7.62,3,1181233,6.23,3,2626300,6.92,3,-263834,-246261,7.14
2013,Japan,715097,3.77,4,833166,4.39,4,1548263,4.08,4,118069,87275,35.28
2013,France,580963,3.06,6,681467,3.59,5,1262430,3.33,5,100504,105707,-4.92
2013,Netherlands,671556,3.54,5,589697,3.11,8,1261253,3.33,6,-81859,-68447,19.59
2013,United Kingdom,546755,2.88,8,662160,3.49,6,1208915,3.19,7,115405,224060,-48.49
2013,"Hong Kong, China",535546,2.82,9,622277,3.28,7,1157823,3.05,8,86731,60579,43.17
2013,"Korea, Republic of",559632,2.95,7,515584,2.72,9,1075216,2.83,9,-44048,-28285,55.73
2013,Italy,518268,2.73,11,479447,2.53,10,997715,2.63,10,-38821,-12706,205.53
2013,Canada,458318,2.42,13,475777,2.51,11,934095,2.46,11,17459,20704,-15.67
2013,Belgium,468760,2.47,12,451677,2.38,13,920437,2.43,12,-17083,-6811,150.81
2013,Russian Federation,521836,2.75,10,341269,1.8,16,863105,2.28,13,-180567,-193810,-6.83
2013,Singapore,410250,2.16,14,373016,1.97,15,783266,2.07,14,-37234,-28670,29.87
2013,India,314848,1.66,20,465397,2.45,12,780245,2.06,15,150549,192866,-21.94
2013,Mexico,380015,2.0,15,390965,2.06,14,770980,2.03,16,10950,9707,12.81
2013,Switzerland,357852,1.89,18,321509,1.69,18,679361,1.79,17,-36343,-17202,111.27
2013,Spain,317833,1.68,19,340598,1.8,17,658431,1.74,18,22765,42088,-45.91
2013,United Arab Emirates,374214,1.97,17,270579,1.43,20,644793,1.7,19,-103635,-103200,0.42
2013,Chinese Taipei,311428,1.64,21,278010,1.47,19,589438,1.55,20,-33418,-29085,14.9
2013,"Saudi Arabia, Kingdom of",375872,1.98,16,168155,0.89,29,544027,1.43,21,-207717,-232808,-10.78
2013,Australia,252981,1.33,22,242140,1.28,24,495121,1.31,22,-10841,4265,-354.19
2013,Brazil,232544,1.23,23,252282,1.33,22,484826,1.28,23,19738,-4549,-533.9
2013,Thailand,228505,1.21,24,250407,1.32,23,478912,1.26,24,21902,20009,9.46
2013,Malaysia,228331,1.2,25,205897,1.09,26,434228,1.14,25,-22434,-31145,-27.97
2013,Türkiye,161481,0.85,31,260823,1.37,21,422304,1.11,26,99342,84083,18.15
2013,Poland,204984,1.08,26,207607,1.09,25,412591,1.09,27,2623,13686,-80.83
2013,Indonesia,182552,0.96,27,186629,0.98,27,369181,0.97,28,4077,1659,145.75
2013,Austria,175156,0.92,28,183277,0.97,28,358433,0.94,29,8121,11902,-31.77
2013,Sweden,167550,0.88,29,160609,0.85,30,328159,0.87,30,-6941,-7909,-12.24
2013,Czech Republic,162274,0.86,30,144259,0.76,31,306533,0.81,31,-18015,-15629,15.27
2013,Viet Nam,132033,0.7,34,132033,0.7,32,264066,0.7,32,0,-749,-100.0
2013,Norway,156022,0.82,32,89808,0.47,36,245830,0.65,33,-66214,-73645,-10.09
2013,South Africa,96153,0.51,39,126330,0.67,33,222483,0.59,34,30177,27548,9.54
2013,Denmark,110949,0.59,37,97348,0.51,35,208297,0.55,35,-13601,-13544,0.42
2013,Hungary,107503,0.57,38,100111,0.53,34,207614,0.55,36,-7392,-8394,-11.94
2013,Ireland,116637,0.62,35,72134,0.38,44,188771,0.5,37,-44503,-54004,-17.59
2013,Slovak Republic,85701,0.45,44,81915,0.43,37,167616,0.44,38,-3786,-3278,15.5
2013,Qatar,136855,0.72,33,27034,0.14,69,163889,0.43,39,-109821,-102175,7.48
2013,Chile,76770,0.4,46,79353,0.42,38,156123,0.41,40,2583,2282,13.19
2013,Iraq,90587,0.48,41,63320,0.33,48,153907,0.41,41,-27267,-35203,-22.54
2013,Finland,74437,0.39,48,77570,0.41,39,152007,0.4,42,3133,3391,-7.61
2013,Argentina,75963,0.4,47,74442,0.39,42,150405,0.4,43,-1521,-12008,-87.33
2013,Nigeria,90555,0.48,42,56000,0.3,51,146555,0.39,44,-34555,-63700,-45.75
2013,"Kuwait, the State of",115104,0.61,36,29299,0.15,66,144403,0.38,45,-85805,-91653,-6.38
2013,Ukraine,64338,0.34,53,76787,0.4,40,141125,0.37,46,12449,16109,-22.72
2013,Romania,65835,0.35,51,73481,0.39,43,139316,0.37,47,7646,12366,-38.17
2013,Portugal,62823,0.33,54,75719,0.4,41,138542,0.37,48,12896,14339,-10.06
2013,Israel,66607,0.35,50,71102,0.37,45,137709,0.36,49,4495,9079,-50.49
2013,"Venezuela, Bolivarian Republic of",88753,0.47,43,48773,0.26,54,137526,0.36,50,-39980,-46009,-13.1
2013,Iran,90765,0.48,40,46571,0.25,55,137336,0.36,51,-44194,-51049,-13.43
2013,Kazakhstan,84700,0.45,45,48806,0.26,53,133506,0.35,52,-35894,-40091,-10.47
2013,Philippines,56698,0.3,56,65739,0.35,47,122437,0.32,53,9041,13739,-34.19
2013,Algeria,64974,0.34,52,55028,0.29,52,120002,0.32,54,-9946,-21488,-53.71
2013,Colombia,58824,0.31,55,59397,0.31,50,118221,0.31,55,573,-1077,-153.2
2013,Greece,36140,0.19,62,60859,0.32,49,96999,0.26,56,24719,26362,-6.23
2013,Egypt,29018,0.15,68,66180,0.35,46,95198,0.25,57,37162,39791,-6.61
2013,Angola,68247,0.36,49,26331,0.14,71,94578,0.25,58,-41916,-47376,-11.52
2013,Oman,55497,0.29,57,34331,0.18,63,89828,0.24,59,-21166,-23502,-9.94
2013,Peru,42576,0.22,59,43670,0.23,58,86246,0.23,60,1094,-3362,-132.54
2013,Belarus,37558,0.2,61,42948,0.23,59,80506,0.21,61,5390,344,1466.86
2013,New Zealand,39445,0.21,60,39641,0.21,60,79086,0.21,62,196,949,-79.35
2013,Libya,49550,0.26,58,28083,0.15,67,77633,0.2,63,-21467,-38349,-44.02
2013,Pakistan,25121,0.13,69,44647,0.24,57,69768,0.18,64,19526,19538,-0.06
2013,Lithuania,32598,0.17,64,34806,0.18,62,67404,0.18,65,2208,2354,-6.2
2013,Slovenia,34019,0.18,63,33373,0.18,65,67392,0.18,66,-646,-128,404.69
2013,Morocco,21972,0.12,71,45190,0.24,56,67162,0.18,67,23218,23426,-0.89
2013,Bangladesh,29114,0.15,67,37085,0.2,61,66199,0.17,68,7971,9046,-11.88
2013,Bulgaria,29579,0.16,66,34303,0.18,64,63882,0.17,69,4724,6024,-21.58
2013,Ecuador,24848,0.13,70,27146,0.14,68,51994,0.14,70,2298,1712,34.23
2013,Luxembourg,18441,0.1,74,26692,0.14,70,45133,0.12,71,8251,8710,-5.27
2013,Azerbaijan,31703,0.17,65,10321,0.05,99,42024,0.11,72,-21382,-22217,-3.76
2013,Tunisia,17061,0.09,75,24266,0.13,72,41327,0.11,73,7205,7464,-3.47
2013,Panama,14732,0.08,78,22988,0.12,73,37720,0.1,74,8256,10579,-21.96
2013,Serbia,14614,0.08,80,20543,0.11,77,35157,0.09,75,5929,7696,-22.96
2013,Estonia,16320,0.09,77,18464,0.1,78,34784,0.09,76,2144,1998,7.31
2013,Croatia,12659,0.07,84,22022,0.12,75,34681,0.09,77,9363,8461,10.66
2013,Latvia,14467,0.08,81,17865,0.09,81,32332,0.09,78,3398,3115,9.09
2013,"Bahrain, Kingdom of",21930,0.12,72,9997,0.05,104,31927,0.08,79,-11933,-8877,34.43
2013,Trinidad and Tobago,18745,0.1,73,12629,0.07,90,31374,0.08,80,-6116,-3918,56.1
2013,Ghana,13752,0.07,82,17600,0.09,82,31352,0.08,81,3848,4211,-8.62
2013,Costa Rica,11480,0.06,88,18127,0.1,79,29607,0.08,82,6647,6158,7.94
2013,Jordan,7920,0.04,98,21549,0.11,76,29469,0.08,83,13629,12865,5.94
2013,Sri Lanka,10208,0.05,93,18003,0.09,80,28211,0.07,84,7795,9810,-20.54
2013,Guatemala,10025,0.05,94,17518,0.09,83,27543,0.07,85,7493,7015,6.81
2013,Lebanese Republic,5170,0.03,109,22024,0.12,74,27194,0.07,86,16854,16330,3.21
2013,Turkmenistan,16800,0.09,76,10000,0.05,103,26800,0.07,87,-6800,-6600,3.03
2013,Dominican Republic,9651,0.05,95,16873,0.09,84,26524,0.07,88,7222,8670,-16.7
2013,Uzbekistan,12000,0.06,86,13138,0.07,88,25138,0.07,89,1138,824,38.11
2013,Côte d'Ivoire,12049,0.06,85,12721,0.07,89,24770,0.07,90,672,-2355,-128.54
2013,Myanmar,11233,0.06,90,12043,0.06,94,23276,0.06,91,810,324,150.0
2013,Kenya,5856,0.03,105,16358,0.09,85,22214,0.06,92,10502,10163,3.34
2013,Paraguay,9456,0.05,96,12142,0.06,91,21598,0.06,93,2686,4272,-37.13
2013,Zambia,10607,0.06,91,10586,0.06,98,21193,0.06,94,-21,-560,-96.25
2013,"Bolivia, Plurinational State of",11657,0.06,87,9338,0.05,107,20995,0.06,95,-2319,-2676,-13.34
2013,Equatorial Guinea,14700,0.08,79,6104,0.03,126,20804,0.05,96,-8596,-7995,7.52
2013,Uruguay,9067,0.05,97,11642,0.06,95,20709,0.05,97,2575,2943,-12.5
2013,Yemen,7130,0.04,101,13273,0.07,87,20403,0.05,98,6143,4198,46.33
2013,Cuba,5283,0.03,108,14707,0.08,86,19990,0.05,99,9424,7969,18.26
2013,Gabon,13039,0.07,83,6537,0.03,120,19576,0.05,100,-6502,-6588,-1.31
2013,Congo,10453,0.06,92,8372,0.04,110,18825,0.05,101,-2081,-89,2238.2
2013,Honduras,7833,0.04,100,10953,0.06,96,18786,0.05,102,3120,3012,3.59
2013,Tanzania,4559,0.02,114,12091,0.06,92,16650,0.04,103,7532,6271,20.11
2013,El Salvador,5491,0.03,107,10772,0.06,97,16263,0.04,104,5281,4919,7.36
2013,Botswana,7911,0.04,99,8352,0.04,111,16263,0.04,104,441,2054,-78.53
2013,Cambodia,6666,0.04,102,9555,0.05,106,16221,0.04,106,2889,3512,-17.74
2013,Bosnia and Herzegovina,5687,0.03,106,10295,0.05,100,15982,0.04,107,4608,4857,-5.13
2013,Brunei Darussalam,11447,0.06,89,3612,0.02,140,15059,0.04,108,-7835,-9429,-16.91
2013,Ethiopia,2973,0.02,123,12072,0.06,93,15045,0.04,109,9099,8543,6.51
2013,Sudan,4790,0.03,112,9918,0.05,105,14708,0.04,110,5128,5164,-0.7
2013,Mozambique,4024,0.02,118,10099,0.05,102,14123,0.04,111,6075,4832,25.72
2013,Democratic Republic of the Congo,6200,0.03,103,6300,0.03,123,12500,0.03,112,100,-200,-150.0
2013,Namibia,4629,0.02,113,7621,0.04,113,12250,0.03,113,2992,2867,4.36
2013,Nicaragua,4794,0.03,111,6688,0.04,115,11482,0.03,114,1894,2092,-9.46
2013,Papua New Guinea,5951,0.03,104,5410,0.03,130,11361,0.03,115,-541,-1573,-65.61
2013,"Macao, China",1138,0.01,151,10140,0.05,101,11278,0.03,116,9002,7961,13.08
2013,Cameroon,4515,0.02,115,6649,0.04,116,11164,0.03,117,2134,2241,-4.77
2013,Zimbabwe,3907,0.02,119,7216,0.04,114,11123,0.03,118,3309,3057,8.24
2013,Georgia,2910,0.02,124,8023,0.04,112,10933,0.03,119,5113,5661,-9.68
2013,North Macedonia,4299,0.02,116,6620,0.03,117,10919,0.03,120,2321,2507,-7.42
2013,Mongolia,4269,0.02,117,6358,0.03,121,10627,0.03,121,2089,2353,-11.22
2013,Syrian Arab Republic,1709,0.01,142,8846,0.05,108,10555,0.03,122,7137,9524,-25.06
2013,Iceland,4998,0.03,110,5020,0.03,132,10018,0.03,123,22,-292,-107.53
2013,Malta,3637,0.02,122,6142,0.03,125,9779,0.03,124,2505,2348,6.69
2013,Senegal,2661,0.01,126,6552,0.03,119,9213,0.02,125,3891,3902,-0.28
2013,Afghanistan,515,0.0,165,8554,0.05,109,9069,0.02,126,8039,8640,-6.96
2013,"Korea, Democratic People's Republic of",3835,0.02,120,4650,0.02,134,8485,0.02,127,815,870,-6.32
2013,Cyprus,2019,0.01,136,6314,0.03,122,8333,0.02,128,4295,5556,-22.7
2013,Mauritius,2869,0.02,125,5397,0.03,131,8266,0.02,129,2528,2705,-6.54
2013,Uganda,2408,0.01,130,5818,0.03,128,8226,0.02,130,3410,3687,-7.51
2013,Kyrgyz Republic,2058,0.01,135,6070,0.03,127,8128,0.02,131,4012,3480,15.29
2013,"Moldova, Republic of",2428,0.01,128,5492,0.03,129,7920,0.02,132,3064,3051,0.43
2013,Jamaica,1569,0.01,144,6216,0.03,124,7785,0.02,133,4647,4619,0.61
2013,Nepal,879,0.0,154,6571,0.03,118,7450,0.02,134,5692,5155,10.42
2013,Albania,2339,0.01,132,4920,0.03,133,7259,0.02,135,2581,2912,-11.37
2013,Chad,3800,0.02,121,3000,0.02,147,6800,0.02,136,-800,-2000,-60.0
2013,Burkina Faso,2356,0.01,131,4365,0.02,136,6721,0.02,137,2009,1393,44.22
2013,Mauritania,2463,0.01,127,3978,0.02,138,6441,0.02,138,1515,488,210.45
2013,Mali,2339,0.01,132,3807,0.02,139,6146,0.02,139,1468,914,60.61
2013,Armenia,1480,0.01,146,4477,0.02,135,5957,0.02,140,2997,2881,4.03
2013,Lao People's Democratic Republic,2264,0.01,134,3081,0.02,145,5345,0.01,141,817,784,4.21
2013,Tajikistan,1162,0.01,150,4151,0.02,137,5313,0.01,142,2989,2418,23.61
2013,Madagascar,1923,0.01,138,3260,0.02,143,5183,0.01,143,1337,1578,-15.27
2013,Benin,1982,0.01,137,3010,0.02,146,4992,0.01,144,1028,896,14.73
2013,Suriname,2416,0.01,129,2174,0.01,155,4590,0.01,145,-242,-701,-65.48
2013,Haiti,885,0.0,153,3580,0.02,141,4465,0.01,146,2695,2355,14.44
2013,New Caledonia,1223,0.01,148,3202,0.02,144,4425,0.01,147,1979,1919,3.13
2013,Togo,1522,0.01,145,2769,0.01,150,4291,0.01,148,1247,1066,16.98
2013,Bahamas,811,0.0,156,3366,0.02,142,4177,0.01,149,2555,2819,-9.37
2013,Niger,1588,0.01,143,2538,0.01,151,4126,0.01,150,950,944,0.64
2013,Malawi,1200,0.01,149,2836,0.01,148,4036,0.01,151,1636,1525,7.28
2013,Fiji,1108,0.01,152,2826,0.01,149,3934,0.01,152,1718,1032,66.47
2013,Guinea,1886,0.01,141,1869,0.01,158,3755,0.01,153,-17,326,-105.21
2013,Sierra Leone,1917,0.01,139,1780,0.01,161,3697,0.01,154,-137,482,-128.42
2013,Eswatini,1895,0.01,140,1693,0.01,164,3588,0.01,155,-202,-78,158.97
2013,Guyana,1375,0.01,147,1875,0.01,157,3250,0.01,156,500,581,-13.94
2013,Lesotho,847,0.0,155,2175,0.01,154,3022,0.01,157,1328,1630,-18.53
2013,Rwanda,703,0.0,158,2302,0.01,153,3005,0.01,158,1599,1709,-6.44
2013,Montenegro,498,0.0,166,2354,0.01,152,2852,0.01,159,1856,1867,-0.59
2013,Curaçao,705,0.0,157,1906,0.01,156,2611,0.01,160,1201,1306,-8.04
2013,Somalia,633,0.0,159,1844,0.01,159,2477,0.01,161,1211,1184,2.28
2013,Barbados,457,0.0,168,1759,0.01,162,2216,0.01,162,1302,1215,7.16
2013,Maldives,331,0.0,170,1733,0.01,163,2064,0.01,163,1402,1240,13.06
2013,French Polynesia,151,0.0,176,1801,0.01,160,1952,0.01,164,1650,1566,5.36
2013,Liberia,559,0.0,162,1150,0.01,166,1709,0.0,165,591,545,8.44
2013,Seychelles,578,0.0,161,1082,0.01,167,1660,0.0,166,504,574,-12.2
2013,"Aruba, Netherlands with respect to",279,0.0,172,1377,0.01,165,1656,0.0,167,1098,657,67.12
2013,Belize,609,0.0,160,928,0.0,172,1537,0.0,168,319,234,36.32
2013,Greenland,542,0.0,164,955,0.01,171,1497,0.0,169,413,386,6.99
2013,Bhutan,544,0.0,163,909,0.0,174,1453,0.0,170,365,456,-19.96
2013,Eritrea,316,0.0,171,1040,0.01,168,1356,0.0,171,724,490,47.76
2013,Sint Maarten,164,0.0,174,925,0.0,173,1089,0.0,172,761,637,19.47
2013,Cayman Islands,51,0.0,186,980,0.01,170,1031,0.0,173,929,921,0.87
2013,Solomon Islands,487,0.0,167,537,0.0,181,1024,0.0,174,50,-14,-457.14
2013,Bermuda,12,0.0,197,1012,0.01,169,1024,0.0,174,1000,889,12.49
2013,Burundi,94,0.0,180,811,0.0,176,905,0.0,176,717,617,16.21
2013,American Samoa,388,0.0,169,479,0.0,183,867,0.0,177,91,-26,-450.0
2013,Timor-Leste,18,0.0,194,843,0.0,175,861,0.0,178,825,633,30.33
2013,Djibouti,120,0.0,178,719,0.0,178,839,0.0,179,599,446,34.3
2013,Cabo Verde,69,0.0,181,725,0.0,177,794,0.0,180,656,710,-7.61
2013,Saint Lucia,174,0.0,173,620,0.0,180,794,0.0,180,446,462,-3.46
2013,Guam,45,0.0,188,680,0.0,179,725,0.0,182,635,594,6.9
2013,Antigua and Barbuda,69,0.0,181,503,0.0,182,572,0.0,183,434,429,1.17
2013,The Gambia,134,0.0,177,350,0.0,187,484,0.0,184,216,254,-14.96
2013,Samoa,62,0.0,184,367,0.0,186,429,0.0,185,305,270,12.96
2013,Saint Vincent and the Grenadines,49,0.0,187,370,0.0,184,419,0.0,186,321,313,2.56
2013,Grenada,37,0.0,190,368,0.0,185,405,0.0,187,331,306,8.17
2013,Guinea-Bissau,153,0.0,175,214,0.0,192,367,0.0,188,61,80,-23.75
2013,Vanuatu,39,0.0,189,313,0.0,189,352,0.0,189,274,241,13.69
2013,Northern Mariana Islands,4,0.0,202,335,0.0,188,339,0.0,190,331,325,1.85
2013,Central African Republic,116,0.0,179,213,0.0,193,329,0.0,191,97,120,-19.17
2013,Comoros,21,0.0,193,284,0.0,190,305,0.0,192,263,253,3.95
2013,Saint Kitts and Nevis,56,0.0,185,249,0.0,191,305,0.0,192,193,180,7.22
2013,Dominica,35,0.0,191,203,0.0,194,238,0.0,194,168,174,-3.45
2013,"Micronesia, Federated States of",35,0.0,191,188,0.0,196,223,0.0,195,153,142,7.75
2013,Tonga,17,0.0,195,198,0.0,195,215,0.0,196,181,183,-1.09
2013,Marshall Islands,65,0.0,183,147,0.0,199,212,0.0,197,82,33,148.48
2013,Palau,7,0.0,199,169,0.0,197,176,0.0,198,162,133,21.8
2013,Sao Tomé and Principe,13,0.0,196,152,0.0,198,165,0.0,199,139,119,16.81
2013,Saint Pierre and Miquelon,3,0.0,203,124,0.0,200,127,0.0,200,121,100,21.0
2013,Cook Islands,11,0.0,198,114,0.0,201,125,0.0,201,103,107,-3.74
2013,Kiribati,7,0.0,199,97,0.0,202,104,0.0,202,90,103,-12.62
2013,Montserrat,6,0.0,201,42,0.0,203,48,0.0,203,36,35,2.86
2013,Tuvalu,0,0.0,204,21,0.0,204,21,0.0,204,21,21,0.0
2013,Niue,0,0.0,204,9,0.0,205,9,0.0,205,9,7,28.57
2012,United States of America,1545703,8.35,2,2336524,12.52,1,3882227,10.44,1,790821,783516,0.93
2012,China,2048714,11.07,1,1818405,9.74,2,3867119,10.4,2,-230309,-154897,48.69
2012,Germany,1401113,7.57,3,1154852,6.19,3,2555965,6.88,3,-246261,-219116,12.39
2012,Japan,798568,4.31,4,885843,4.75,4,1684411,4.53,4,87275,32196,171.07
2012,France,568708,3.07,6,674415,3.61,6,1243123,3.34,5,105707,123555,-14.45
2012,Netherlands,655374,3.54,5,586927,3.14,7,1242301,3.34,6,-68447,-72735,-5.9
2012,United Kingdom,478780,2.59,11,702840,3.77,5,1181620,3.18,7,224060,170559,31.37
2012,"Korea, Republic of",547870,2.96,7,519585,2.78,9,1067455,2.87,8,-28285,-30801,-8.17
2012,"Hong Kong, China",492907,2.66,10,553486,2.97,8,1046393,2.82,9,60579,55282,9.58
2012,Italy,501306,2.71,9,488600,2.62,11,989906,2.66,10,-12706,35529,-135.76
2012,Canada,455592,2.46,12,476296,2.55,12,931888,2.51,11,20704,12305,68.26
2012,Belgium,445939,2.41,13,439128,2.35,13,885067,2.38,12,-6811,-8729,-21.97
2012,Russian Federation,529256,2.86,8,335446,1.8,17,864702,2.33,13,-193810,-198180,-2.21
2012,Singapore,408393,2.21,14,379723,2.03,15,788116,2.12,14,-28670,-43733,-34.44
2012,India,296828,1.6,20,489694,2.62,10,786522,2.12,15,192866,161557,19.38
2012,Mexico,370770,2.0,16,380477,2.04,14,751247,2.02,16,9707,11499,-15.58
2012,Spain,295250,1.6,21,337338,1.81,16,632588,1.7,17,42088,70055,-39.92
2012,United Arab Emirates,359728,1.94,17,256528,1.37,21,616256,1.66,18,-103200,-72105,43.12
2012,Switzerland,312257,1.69,18,295055,1.58,18,607312,1.63,19,-17202,-26599,-35.33
2012,Chinese Taipei,306409,1.66,19,277324,1.49,19,583733,1.57,20,-29085,-26819,8.45
2012,"Saudi Arabia, Kingdom of",388401,2.1,15,155593,0.83,30,543994,1.46,21,-232808,-233113,-0.13
2012,Australia,256675,1.39,22,260940,1.4,20,517615,1.39,22,4265,-28032,-115.21
2012,Thailand,229106,1.24,24,249115,1.33,22,478221,1.29,23,20009,6211,222.15
2012,Brazil,239953,1.3,23,235404,1.26,24,475357,1.28,24,-4549,-14960,-69.59
2012,Malaysia,227538,1.23,25,196393,1.05,26,423931,1.14,25,-31145,-40613,-23.31
2012,Türkiye,152462,0.82,32,236545,1.27,23,389007,1.05,26,84083,105935,-20.63
2012,Poland,185374,1.0,27,199060,1.07,25,384434,1.03,27,13686,21901,-37.51
2012,Indonesia,190032,1.03,26,191691,1.03,27,381723,1.03,28,1659,-26061,-106.37
2012,Austria,166611,0.9,29,178513,0.96,28,345124,0.93,29,11902,13989,-14.92
2012,Sweden,172345,0.93,28,164436,0.88,29,336781,0.91,30,-7909,-9937,-20.41
2012,Czech Republic,157041,0.85,31,141412,0.76,31,298453,0.8,31,-15629,-10814,44.53
2012,Norway,160953,0.87,30,87308,0.47,36,248261,0.67,32,-73645,-69626,5.77
2012,Viet Nam,114529,0.62,37,113780,0.61,33,228309,0.61,33,-749,9844,-107.61
2012,South Africa,99606,0.54,41,127154,0.68,32,226760,0.61,34,27548,15615,76.42
2012,Hungary,103570,0.56,40,95176,0.51,34,198746,0.53,35,-8394,-9872,-14.97
2012,Denmark,105469,0.57,39,91925,0.49,35,197394,0.53,36,-13544,-16201,-16.4
2012,Ireland,116773,0.63,35,62769,0.34,47,179542,0.48,37,-54004,-59134,-8.68
2012,Nigeria,114700,0.62,36,51000,0.27,53,165700,0.45,38,-63700,-60000,6.17
2012,Iran,108341,0.59,38,57292,0.31,51,165633,0.45,39,-51049,-70240,-27.32
2012,Qatar,132962,0.72,33,30787,0.16,65,163749,0.44,40,-102175,-92120,10.92
2012,Slovak Republic,80721,0.44,45,77443,0.41,39,158164,0.43,41,-3278,451,-826.83
2012,Chile,77791,0.42,47,80073,0.43,38,157864,0.42,42,2282,-6743,-133.84
2012,Iraq,94209,0.51,43,59006,0.32,50,153215,0.41,43,-35203,-31878,10.43
2012,Ukraine,68530,0.37,51,84639,0.45,37,153169,0.41,44,16109,14134,13.97
2012,Finland,73077,0.39,48,76468,0.41,40,149545,0.4,45,3391,5122,-33.8
2012,"Venezuela, Bolivarian Republic of",97340,0.53,42,51331,0.28,52,148671,0.4,46,-46009,-44811,2.67
2012,Argentina,79982,0.43,46,67974,0.36,45,147956,0.4,47,-12008,-9732,23.39
2012,"Kuwait, the State of",118912,0.64,34,27259,0.15,68,146171,0.39,48,-91653,-77013,19.01
2012,Israel,63191,0.34,52,72270,0.39,42,135461,0.36,49,9079,5099,78.05
2012,Kazakhstan,86449,0.47,44,46358,0.25,56,132807,0.36,50,-40091,-47430,-15.47
2012,Portugal,58090,0.31,55,72429,0.39,41,130519,0.35,51,14339,23279,-38.4
2012,Romania,57841,0.31,56,70207,0.38,43,128048,0.34,52,12366,13445,-8.03
2012,Algeria,71866,0.39,49,50378,0.27,54,122244,0.33,53,-21488,-26242,-18.12
2012,Colombia,60125,0.32,53,59048,0.32,49,119173,0.32,54,-1077,-2682,-59.84
2012,Philippines,52100,0.28,58,65839,0.35,46,117939,0.32,55,13739,15792,-13.0
2012,Egypt,29409,0.16,66,69200,0.37,44,98609,0.27,56,39791,28375,40.23
2012,Greece,35324,0.19,62,61686,0.33,48,97010,0.26,57,26362,32926,-19.94
2012,Angola,71093,0.38,50,23717,0.13,72,94810,0.26,58,-47376,-47082,0.62
2012,Belarus,46060,0.25,59,46404,0.25,55,92464,0.25,59,344,5923,-94.19
2012,Peru,45907,0.25,60,42545,0.23,59,88452,0.24,60,-3362,-9102,-63.06
2012,Libya,59944,0.32,54,21595,0.12,74,81539,0.22,61,-38349,-12545,205.69
2012,Oman,52138,0.28,57,28636,0.15,66,80774,0.22,62,-23502,-23073,1.86
2012,New Zealand,37305,0.2,61,38254,0.2,60,75559,0.2,63,949,-564,-268.26
2012,Pakistan,24567,0.13,69,44105,0.24,58,68672,0.18,64,19538,18629,4.88
2012,Morocco,21446,0.12,71,44872,0.24,57,66318,0.18,65,23426,22618,3.57
2012,Slovenia,32163,0.17,64,32035,0.17,63,64198,0.17,66,-128,849,-115.08
2012,Lithuania,29611,0.16,65,31965,0.17,64,61576,0.17,67,2354,3723,-36.77
2012,Bulgaria,26686,0.14,67,32710,0.18,62,59396,0.16,68,6024,4374,37.72
2012,Bangladesh,25127,0.14,68,34173,0.18,61,59300,0.16,69,9046,11775,-23.18
2012,Ecuador,23765,0.13,70,25477,0.14,70,49242,0.13,70,1712,2116,-19.09
2012,Luxembourg,18833,0.1,73,27543,0.15,67,46376,0.12,71,8710,7994,8.96
2012,Azerbaijan,32634,0.18,63,10417,0.06,97,43051,0.12,72,-22217,-24329,-8.68
2012,Panama,15945,0.09,77,26524,0.14,69,42469,0.11,73,10579,7247,45.98
2012,Tunisia,17007,0.09,74,24471,0.13,71,41478,0.11,74,7464,6105,22.26
2012,Estonia,16087,0.09,76,18085,0.1,79,34172,0.09,75,1998,750,166.4
2012,Croatia,12371,0.07,83,20832,0.11,75,33203,0.09,76,8461,9325,-9.27
2012,Latvia,14112,0.08,79,17227,0.09,83,31339,0.08,77,3115,3160,-1.42
2012,Ghana,13552,0.07,80,17763,0.1,80,31315,0.08,78,4211,3053,37.93
2012,"Bahrain, Kingdom of",19768,0.11,72,10891,0.06,96,30659,0.08,79,-8877,-6920,28.28
2012,Serbia,11229,0.06,88,18925,0.1,78,30154,0.08,80,7696,8083,-4.79
2012,Costa Rica,11433,0.06,86,17591,0.09,82,29024,0.08,81,6158,5812,5.95
2012,Jordan,7887,0.04,97,20752,0.11,76,28639,0.08,82,12865,10924,17.77
2012,Sri Lanka,9380,0.05,91,19190,0.1,77,28570,0.08,83,9810,10033,-2.22
2012,Lebanese Republic,5615,0.03,107,21945,0.12,73,27560,0.07,84,16330,15086,8.25
2012,Guatemala,9979,0.05,90,16994,0.09,84,26973,0.07,85,7015,6212,12.93
2012,Dominican Republic,9069,0.05,93,17739,0.1,81,26808,0.07,86,8670,8917,-2.77
2012,Turkmenistan,16500,0.09,75,9900,0.05,100,26400,0.07,87,-6600,-5400,22.22
2012,Uzbekistan,11210,0.06,89,12034,0.06,88,23244,0.06,88,824,-2782,-129.62
2012,Equatorial Guinea,15500,0.08,78,7505,0.04,112,23005,0.06,89,-7995,-6528,22.47
2012,Kenya,6127,0.03,104,16290,0.09,85,22417,0.06,90,10163,9026,12.6
2012,Trinidad and Tobago,12983,0.07,82,9065,0.05,105,22048,0.06,91,-3918,-5433,-27.89
2012,Côte d'Ivoire,12124,0.07,85,9769,0.05,101,21893,0.06,92,-2355,-5915,-60.19
2012,Uruguay,8709,0.05,95,11652,0.06,90,20361,0.05,93,2943,2814,4.58
2012,"Bolivia, Plurinational State of",11254,0.06,87,8578,0.05,109,19832,0.05,94,-2676,-431,520.88
2012,Cuba,5900,0.03,106,13869,0.07,86,19769,0.05,95,7969,7803,2.13
2012,Honduras,8359,0.05,96,11371,0.06,92,19730,0.05,96,3012,3149,-4.35
2012,Cambodia,7838,0.04,98,11350,0.06,93,19188,0.05,97,3512,2596,35.29
2012,Paraguay,7283,0.04,100,11555,0.06,91,18838,0.05,98,4272,4603,-7.19
2012,Yemen,7062,0.04,101,11260,0.06,95,18322,0.05,99,4198,3086,36.03
2012,Zambia,9365,0.05,92,8805,0.05,107,18170,0.05,100,-560,-1823,-69.28
2012,Myanmar,8877,0.05,94,9201,0.05,103,18078,0.05,101,324,-219,-247.95
2012,Gabon,12129,0.07,84,5541,0.03,127,17670,0.05,102,-6588,-6101,7.98
2012,Brunei Darussalam,13001,0.07,81,3572,0.02,139,16573,0.04,103,-9429,-8836,6.71
2012,Tanzania,5075,0.03,110,11346,0.06,94,16421,0.04,104,6271,6064,3.41
2012,Syrian Arab Republic,3059,0.02,124,12583,0.07,87,15642,0.04,105,9524,9472,0.55
2012,El Salvador,5339,0.03,108,10258,0.05,98,15597,0.04,106,4919,4657,5.63
2012,Ethiopia,3370,0.02,123,11913,0.06,89,15283,0.04,107,8543,6021,41.89
2012,Bosnia and Herzegovina,5162,0.03,109,10019,0.05,99,15181,0.04,108,4857,5201,-6.61
2012,Congo,7438,0.04,99,7349,0.04,113,14787,0.04,109,-89,-6811,-98.69
2012,Botswana,5971,0.03,105,8025,0.04,111,13996,0.04,110,2054,1390,47.77
2012,Sudan,4066,0.02,118,9230,0.05,102,13296,0.04,111,5164,-957,-639.6
2012,Mozambique,3856,0.02,122,8688,0.05,108,12544,0.03,112,4832,2708,78.43
2012,Democratic Republic of the Congo,6300,0.03,103,6100,0.03,124,12400,0.03,113,-200,-1100,-81.82
2012,Namibia,4389,0.02,114,7256,0.04,115,11645,0.03,114,2867,2186,31.15
2012,Nicaragua,4686,0.03,113,6778,0.04,117,11464,0.03,115,2092,2222,-5.85
2012,Mongolia,4385,0.02,115,6738,0.04,118,11123,0.03,116,2353,1780,32.19
2012,Papua New Guinea,6328,0.03,102,4755,0.03,134,11083,0.03,117,-1573,-2636,-40.33
2012,Malta,4250,0.02,117,6598,0.04,119,10848,0.03,118,2348,1907,23.13
2012,Zimbabwe,3882,0.02,121,6939,0.04,116,10821,0.03,119,3057,4472,-31.64
2012,Cameroon,4274,0.02,116,6515,0.03,121,10789,0.03,120,2241,2283,-1.84
2012,North Macedonia,4015,0.02,119,6522,0.03,120,10537,0.03,121,2507,2549,-1.65
2012,Georgia,2376,0.01,130,8037,0.04,110,10413,0.03,122,5661,4876,16.1
2012,"Macao, China",1021,0.01,153,8982,0.05,106,10003,0.03,123,7961,7058,12.79
2012,Iceland,5064,0.03,111,4772,0.03,133,9836,0.03,124,-292,-506,-42.29
2012,Afghanistan,429,0.0,170,9069,0.05,104,9498,0.03,125,8640,6139,40.74
2012,Cyprus,1740,0.01,139,7296,0.04,114,9036,0.02,126,5556,6860,-19.01
2012,Senegal,2532,0.01,129,6434,0.03,122,8966,0.02,127,3902,3367,15.89
2012,"Korea, Democratic People's Republic of",3955,0.02,120,4825,0.03,132,8780,0.02,128,870,665,30.83
2012,Uganda,2357,0.01,131,6044,0.03,126,8401,0.02,129,3687,3472,6.19
2012,Jamaica,1712,0.01,140,6331,0.03,123,8043,0.02,130,4619,4816,-4.09
2012,Mauritius,2649,0.01,126,5354,0.03,129,8003,0.02,131,2705,2584,4.68
2012,Chad,4800,0.03,112,2800,0.02,146,7600,0.02,132,-2000,-1500,33.33
2012,"Moldova, Republic of",2162,0.01,134,5213,0.03,130,7375,0.02,133,3051,2974,2.59
2012,Kyrgyz Republic,1894,0.01,138,5374,0.03,128,7268,0.02,134,3480,2282,52.5
2012,Nepal,911,0.0,156,6066,0.03,125,6977,0.02,135,5155,4855,6.18
2012,Albania,1967,0.01,135,4879,0.03,131,6846,0.02,136,2912,3436,-15.25
2012,Mali,2610,0.01,128,3524,0.02,140,6134,0.02,137,914,978,-6.54
2012,Mauritania,2641,0.01,127,3129,0.02,143,5770,0.02,138,488,-282,-273.05
2012,Burkina Faso,2182,0.01,133,3575,0.02,138,5757,0.02,139,1393,7,19800.0
2012,Armenia,1380,0.01,146,4261,0.02,135,5641,0.02,140,2881,2811,2.49
2012,Lao People's Democratic Republic,2271,0.01,132,3055,0.02,145,5326,0.01,141,784,214,266.36
2012,Tajikistan,1360,0.01,147,3778,0.02,136,5138,0.01,142,2418,1949,24.06
2012,Suriname,2695,0.01,125,1994,0.01,159,4689,0.01,143,-701,-829,-15.44
2012,Madagascar,1516,0.01,141,3094,0.02,144,4610,0.01,144,1578,1315,20.0
2012,New Caledonia,1326,0.01,148,3245,0.02,141,4571,0.01,145,1919,2035,-5.7
2012,Bahamas,828,0.0,157,3647,0.02,137,4475,0.01,146,2819,2684,5.03
2012,Guinea,1928,0.01,136,2254,0.01,154,4182,0.01,147,326,673,-51.56
2012,Haiti,815,0.0,158,3170,0.02,142,3985,0.01,148,2355,2253,4.53
2012,Malawi,1203,0.01,151,2728,0.01,147,3931,0.01,149,1525,993,53.58
2012,Niger,1450,0.01,142,2394,0.01,149,3844,0.01,150,944,1544,-38.86
2012,Benin,1443,0.01,143,2339,0.01,151,3782,0.01,151,896,719,24.62
2012,Eswatini,1926,0.01,137,1848,0.01,160,3774,0.01,152,-78,40,-295.0
2012,Togo,1314,0.01,149,2380,0.01,150,3694,0.01,153,1066,1008,5.75
2012,Lesotho,972,0.01,154,2602,0.01,148,3574,0.01,154,1630,1328,22.74
2012,Fiji,1221,0.01,150,2253,0.01,156,3474,0.01,155,1032,1113,-7.28
2012,"Aruba, Netherlands with respect to",1389,0.01,145,2046,0.01,157,3435,0.01,156,657,737,-10.85
2012,Guyana,1416,0.01,144,1997,0.01,158,3413,0.01,157,581,642,-9.5
2012,Curaçao,948,0.01,155,2254,0.01,154,3202,0.01,158,1306,1202,8.65
2012,Rwanda,591,0.0,160,2300,0.01,153,2891,0.01,159,1709,1575,8.51
2012,Montenegro,469,0.0,167,2336,0.01,152,2805,0.01,160,1867,1916,-2.56
2012,Sierra Leone,1122,0.01,152,1604,0.01,164,2726,0.01,161,482,1367,-64.74
2012,Barbados,565,0.0,161,1780,0.01,161,2345,0.01,162,1215,1330,-8.65
2012,Somalia,464,0.0,168,1648,0.01,163,2112,0.01,163,1184,1021,15.96
2012,Maldives,314,0.0,172,1554,0.01,165,1868,0.01,164,1240,1119,10.81
2012,French Polynesia,139,0.0,175,1705,0.01,162,1844,0.0,165,1566,1628,-3.81
2012,Seychelles,497,0.0,164,1071,0.01,166,1568,0.0,166,574,566,1.41
2012,Bhutan,535,0.0,162,991,0.01,168,1526,0.0,167,456,368,23.91
2012,Belize,627,0.0,159,861,0.0,172,1488,0.0,168,234,227,3.08
2012,Liberia,460,0.0,169,1005,0.01,167,1465,0.0,169,545,677,-19.5
2012,Eritrea,480,0.0,165,970,0.01,169,1450,0.0,170,490,520,-5.77
2012,Greenland,475,0.0,166,861,0.0,172,1336,0.0,171,386,424,-8.96
2012,Cayman Islands,39,0.0,190,960,0.01,170,999,0.0,172,921,925,-0.43
2012,Solomon Islands,500,0.0,163,486,0.0,182,986,0.0,173,-14,51,-127.45
2012,Bermuda,11,0.0,197,900,0.0,171,911,0.0,174,889,887,0.23
2012,Sint Maarten,131,0.0,177,768,0.0,174,899,0.0,175,637,607,4.94
2012,Burundi,134,0.0,176,751,0.0,176,885,0.0,176,617,629,-1.91
2012,Saint Lucia,182,0.0,174,644,0.0,178,826,0.0,177,462,537,-13.97
2012,Cabo Verde,56,0.0,184,766,0.0,175,822,0.0,178,710,878,-19.13
2012,American Samoa,422,0.0,171,396,0.0,183,818,0.0,179,-26,45,-157.78
2012,Timor-Leste,31,0.0,193,664,0.0,177,695,0.0,180,633,306,106.86
2012,Guam,46,0.0,187,640,0.0,179,686,0.0,181,594,707,-15.98
2012,Djibouti,118,0.0,180,564,0.0,180,682,0.0,182,446,418,6.7
2012,Antigua and Barbuda,63,0.0,183,492,0.0,181,555,0.0,183,429,374,14.71
2012,Central African Republic,203,0.0,173,323,0.0,189,526,0.0,184,120,120,0.0
2012,The Gambia,126,0.0,179,380,0.0,184,506,0.0,185,254,239,6.28
2012,Samoa,76,0.0,182,346,0.0,186,422,0.0,186,270,280,-3.57
2012,Saint Vincent and the Grenadines,43,0.0,189,356,0.0,185,399,0.0,187,313,294,6.46
2012,Grenada,35,0.0,191,341,0.0,187,376,0.0,188,306,305,0.33
2012,Vanuatu,55,0.0,185,296,0.0,190,351,0.0,189,241,237,1.69
2012,Guinea-Bissau,131,0.0,177,211,0.0,193,342,0.0,190,80,37,116.22
2012,Northern Mariana Islands,4,0.0,201,329,0.0,188,333,0.0,191,325,348,-6.61
2012,Comoros,20,0.0,194,273,0.0,191,293,0.0,192,253,251,0.8
2012,Saint Kitts and Nevis,46,0.0,187,226,0.0,192,272,0.0,193,180,202,-10.89
2012,Marshall Islands,107,0.0,181,140,0.0,198,247,0.0,194,33,80,-58.75
2012,"Micronesia, Federated States of",52,0.0,186,194,0.0,196,246,0.0,195,142,115,23.48
2012,Dominica,34,0.0,192,208,0.0,194,242,0.0,196,174,197,-11.68
2012,Tonga,16,0.0,195,199,0.0,195,215,0.0,197,183,179,2.23
2012,Palau,9,0.0,198,142,0.0,197,151,0.0,198,133,123,8.13
2012,Sao Tomé and Principe,12,0.0,196,131,0.0,199,143,0.0,199,119,123,-3.25
2012,Cook Islands,5,0.0,200,112,0.0,200,117,0.0,200,107,107,0.0
2012,Kiribati,6,0.0,199,109,0.0,201,115,0.0,201,103,83,24.1
2012,Saint Pierre and Miquelon,2,0.0,202,102,0.0,202,104,0.0,202,100,107,-6.54
2012,Montserrat,2,0.0,202,37,0.0,203,39,0.0,203,35,31,12.9
2012,Tuvalu,0,0.0,204,21,0.0,204,21,0.0,204,21,27,-22.22
2012,Niue,0,0.0,204,7,0.0,205,7,0.0,205,7,8,-12.5
2011,United States of America,1482508,8.09,2,2266024,12.29,1,3748532,10.19,1,783516,690689,13.44
2011,China,1898381,10.36,1,1743484,9.46,2,3641865,9.9,2,-154897,-181507,-14.66
2011,Germany,1473985,8.04,3,1254869,6.81,3,2728854,7.42,3,-219116,-204110,7.35
2011,Japan,823184,4.49,4,855380,4.64,4,1678564,4.57,4,32196,-75715,-142.52
2011,France,596473,3.25,6,720028,3.91,5,1316501,3.58,5,123555,87303,41.52
2011,Netherlands,667101,3.64,5,594366,3.22,7,1261467,3.43,6,-72735,-57842,25.75
2011,United Kingdom,510380,2.78,10,680939,3.69,6,1191319,3.24,7,170559,172089,-0.89
2011,Italy,523258,2.85,8,558787,3.03,8,1082045,2.94,8,35529,39748,-10.61
2011,"Korea, Republic of",555214,3.03,7,524413,2.84,9,1079627,2.94,9,-30801,-41172,-25.19
2011,"Hong Kong, China",455573,2.49,12,510855,2.77,10,966428,2.63,10,55282,40677,35.9
2011,Belgium,475672,2.59,11,466943,2.53,11,942615,2.56,11,-8729,-16515,-47.15
2011,Canada,451335,2.46,13,463640,2.51,13,914975,2.49,12,12305,15209,-19.09
2011,Russian Federation,522011,2.85,9,323831,1.76,17,845842,2.3,13,-198180,-151996,30.39
2011,Singapore,409503,2.23,14,365770,1.98,15,775273,2.11,14,-43733,-41076,6.47
2011,India,302905,1.65,19,464462,2.52,12,767367,2.09,15,161557,123882,30.41
2011,Mexico,349569,1.91,16,361068,1.96,16,710637,1.93,16,11499,11900,-3.37
2011,Spain,306551,1.67,18,376606,2.04,14,683157,1.86,17,70055,72598,-3.5
2011,Chinese Taipei,308257,1.68,17,281438,1.53,18,589695,1.6,18,-26819,-23365,14.78
2011,United Arab Emirates,302037,1.65,20,229932,1.25,22,531969,1.45,19,-72105,-26538,171.7
2011,Australia,271733,1.48,21,243701,1.32,19,515434,1.4,20,-28032,-10995,154.95
2011,"Saudi Arabia, Kingdom of",364699,1.99,15,131586,0.71,31,496285,1.35,21,-233113,-144280,61.57
2011,Brazil,253666,1.38,22,238706,1.29,21,492372,1.34,22,-14960,-7250,106.34
2011,Thailand,222576,1.21,25,228787,1.24,23,451363,1.23,23,6211,-10385,-159.81
2011,Switzerland,234819,1.28,23,208220,1.13,25,443039,1.2,24,-26599,-19328,37.62
2011,Malaysia,228086,1.24,24,187473,1.02,27,415559,1.13,25,-40613,-33990,19.49
2011,Poland,188696,1.03,27,210597,1.14,24,399293,1.09,26,21901,18325,19.51
2011,Indonesia,203497,1.11,26,177436,0.96,28,380933,1.04,27,-26061,-22116,17.84
2011,Türkiye,134907,0.74,32,240842,1.31,20,375749,1.02,28,105935,71661,47.83
2011,Austria,177428,0.97,29,191417,1.04,26,368845,1.0,29,13989,6449,116.92
2011,Sweden,186963,1.02,28,177026,0.96,29,363989,0.99,30,-9937,-9603,3.48
2011,Czech Republic,162939,0.89,30,152125,0.83,30,315064,0.86,31,-10814,-6330,70.84
2011,Norway,160410,0.88,31,90784,0.49,36,251194,0.68,32,-69626,-53327,30.56
2011,South Africa,108815,0.59,39,124430,0.67,32,233245,0.63,33,15615,5488,184.53
2011,Hungary,112312,0.61,37,102440,0.56,34,214752,0.58,34,-9872,-7305,35.14
2011,Denmark,111864,0.61,38,95663,0.52,35,207527,0.56,35,-16201,-13388,21.01
2011,Viet Nam,96906,0.53,41,106750,0.58,33,203656,0.55,36,9844,12602,-21.89
2011,Iran,132000,0.72,33,61760,0.33,48,193760,0.53,37,-70240,-35912,95.59
2011,Ireland,125740,0.69,34,66606,0.36,46,192346,0.52,38,-59134,-56221,5.18
2011,Nigeria,116000,0.63,35,56000,0.3,50,172000,0.47,39,-60000,-39765,50.89
2011,Finland,79142,0.43,48,84264,0.46,37,163406,0.44,40,5122,-715,-816.36
2011,Slovak Republic,79736,0.43,46,80187,0.43,40,159923,0.43,41,451,658,-31.46
2011,Argentina,84051,0.46,44,74319,0.4,43,158370,0.43,42,-9732,-11394,-14.59
2011,Chile,81438,0.44,45,74695,0.41,42,156133,0.42,43,-6743,-11902,-43.35
2011,Ukraine,68460,0.37,50,82594,0.45,39,151054,0.41,44,14134,9433,49.84
2011,Portugal,59617,0.33,54,82896,0.45,38,142513,0.39,45,23279,28343,-17.87
2011,"Venezuela, Bolivarian Republic of",92811,0.51,42,48000,0.26,52,140811,0.38,46,-44811,-26745,67.55
2011,Israel,67648,0.37,51,72747,0.39,44,140395,0.38,47,5099,290,1658.28
2011,Romania,63035,0.34,53,76480,0.41,41,139515,0.38,48,13445,12530,7.3
2011,Qatar,114448,0.62,36,22328,0.12,71,136776,0.37,49,-92120,-51724,78.1
2011,Iraq,79681,0.43,47,47803,0.26,53,127484,0.35,50,-31878,-7849,306.14
2011,"Kuwait, the State of",102103,0.56,40,25090,0.14,66,127193,0.35,51,-77013,-47303,62.81
2011,Kazakhstan,84336,0.46,43,36906,0.2,60,121242,0.33,52,-47430,-28864,64.32
2011,Algeria,73489,0.4,49,47247,0.26,54,120736,0.33,53,-26242,-16580,58.28
2011,Philippines,48305,0.26,56,64097,0.35,47,112402,0.31,54,15792,6970,126.57
2011,Colombia,56915,0.31,55,54233,0.29,51,111148,0.3,55,-2682,773,-446.96
2011,Greece,33779,0.18,63,66705,0.36,45,100484,0.27,56,32926,37890,-13.1
2011,Egypt,30528,0.17,64,58903,0.32,49,89431,0.24,57,28375,26485,7.14
2011,Angola,67310,0.37,52,20228,0.11,75,87538,0.24,58,-47082,-33928,38.77
2011,Belarus,39807,0.22,59,45730,0.25,55,85537,0.23,59,5923,9600,-38.3
2011,Peru,46849,0.26,58,37747,0.2,58,84596,0.23,60,-9102,-5963,52.64
2011,New Zealand,37669,0.21,60,37105,0.2,59,74774,0.2,61,-564,-779,-27.6
2011,Oman,47092,0.26,57,24019,0.13,68,71111,0.19,62,-23073,-16628,38.76
2011,Slovenia,34682,0.19,61,35531,0.19,62,70213,0.19,63,849,894,-5.03
2011,Pakistan,25383,0.14,67,44012,0.24,57,69395,0.19,64,18629,16397,13.61
2011,Morocco,21654,0.12,70,44272,0.24,56,65926,0.18,65,22618,17610,28.44
2011,Bulgaria,28208,0.15,65,32582,0.18,63,60790,0.17,66,4374,4883,-10.42
2011,Bangladesh,24439,0.13,68,36214,0.2,61,60653,0.16,67,11775,8627,36.49
2011,Lithuania,28050,0.15,66,31773,0.17,64,59823,0.16,68,3723,2655,40.23
2011,Luxembourg,20866,0.11,71,28860,0.16,65,49726,0.14,69,7994,5344,49.59
2011,Ecuador,22322,0.12,69,24438,0.13,67,46760,0.13,70,2116,3101,-31.76
2011,Azerbaijan,34495,0.19,62,10166,0.06,94,44661,0.12,71,-24329,-19730,23.31
2011,Tunisia,17847,0.1,74,23952,0.13,69,41799,0.11,72,6105,5788,5.48
2011,Panama,14555,0.08,77,21802,0.12,72,36357,0.1,73,7247,5750,26.03
2011,Croatia,13338,0.07,80,22663,0.12,70,36001,0.1,74,9325,8261,12.88
2011,Estonia,16709,0.09,75,17459,0.09,79,34168,0.09,75,750,696,7.76
2011,"Bahrain, Kingdom of",19650,0.11,73,12730,0.07,87,32380,0.09,76,-6920,-2711,155.26
2011,Serbia,11779,0.06,87,19862,0.11,77,31641,0.09,77,8083,6940,16.47
2011,Sri Lanka,10236,0.06,91,20269,0.11,74,30505,0.08,78,10033,4910,104.34
2011,Syrian Arab Republic,10513,0.06,88,19985,0.11,76,30498,0.08,79,9472,4766,98.74
2011,Latvia,13130,0.07,82,16290,0.09,82,29420,0.08,80,3160,2159,46.36
2011,Ghana,12785,0.07,84,15838,0.09,84,28623,0.08,81,3053,2962,3.07
2011,Guatemala,10401,0.06,90,16613,0.09,81,27014,0.07,82,6212,5375,15.57
2011,Jordan,8006,0.04,98,18930,0.1,78,26936,0.07,83,10924,8536,27.98
2011,Libya,19712,0.11,72,7167,0.04,109,26879,0.07,84,-12545,-22421,-44.05
2011,Costa Rica,10408,0.06,89,16220,0.09,83,26628,0.07,85,5812,4122,41.0
2011,Lebanese Republic,5664,0.03,110,20750,0.11,73,26414,0.07,86,15086,13439,12.26
2011,Dominican Republic,8492,0.05,96,17409,0.09,80,25901,0.07,87,8917,8735,2.08
2011,Trinidad and Tobago,14944,0.08,76,9511,0.05,97,24455,0.07,88,-5433,-4502,20.68
2011,Uzbekistan,13254,0.07,81,10472,0.06,93,23726,0.06,89,-2782,-3006,-7.45
2011,Congo,13824,0.08,78,7013,0.04,112,20837,0.06,90,-6811,-2549,167.2
2011,Cuba,6440,0.04,106,14243,0.08,86,20683,0.06,91,7803,6582,18.55
2011,Turkmenistan,13000,0.07,83,7600,0.04,106,20600,0.06,92,-5400,-800,575.0
2011,Kenya,5756,0.03,109,14782,0.08,85,20538,0.06,93,9026,6924,30.36
2011,Equatorial Guinea,13500,0.07,79,6972,0.04,113,20472,0.06,94,-6528,-4515,44.58
2011,Paraguay,7763,0.04,101,12366,0.07,88,20129,0.05,95,4603,3528,30.47
2011,Sudan,10193,0.06,92,9236,0.05,99,19429,0.05,96,-957,-1359,-29.58
2011,Côte d'Ivoire,12635,0.07,85,6720,0.04,115,19355,0.05,97,-5915,-3561,66.11
2011,Honduras,7977,0.04,99,11126,0.06,89,19103,0.05,98,3149,2643,19.14
2011,Uruguay,7912,0.04,100,10726,0.06,92,18638,0.05,99,2814,1898,48.26
2011,Myanmar,9238,0.05,94,9019,0.05,100,18257,0.05,100,-219,-3901,-94.39
2011,Yemen,6948,0.04,102,10034,0.05,95,16982,0.05,101,3086,2818,9.51
2011,Bosnia and Herzegovina,5850,0.03,108,11051,0.06,90,16901,0.05,102,5201,4420,17.67
2011,"Bolivia, Plurinational State of",8358,0.05,97,7927,0.04,104,16285,0.04,103,-431,-812,-46.92
2011,Zambia,9001,0.05,95,7178,0.04,108,16179,0.04,104,-1823,-1879,-2.98
2011,Brunei Darussalam,12465,0.07,86,3629,0.02,138,16094,0.04,105,-8836,-6369,38.73
2011,Cambodia,6704,0.04,104,9300,0.05,98,16004,0.04,106,2596,1648,57.52
2011,Tanzania,4735,0.03,116,10799,0.06,91,15534,0.04,107,6064,3823,58.62
2011,El Salvador,5308,0.03,112,9965,0.05,96,15273,0.04,108,4657,3917,18.89
2011,Gabon,9766,0.05,93,3665,0.02,137,13431,0.04,109,-6101,-5703,6.98
2011,Botswana,5882,0.03,107,7272,0.04,107,13154,0.04,110,1390,964,44.19
2011,Democratic Republic of the Congo,6600,0.04,105,5500,0.03,127,12100,0.03,111,-1100,-800,37.5
2011,Ethiopia,2875,0.02,125,8896,0.05,101,11771,0.03,112,6021,6272,-4.0
2011,North Macedonia,4478,0.02,118,7027,0.04,111,11505,0.03,113,2549,2123,20.07
2011,Zimbabwe,3512,0.02,124,7984,0.04,103,11496,0.03,114,4472,2138,109.17
2011,Mongolia,4818,0.03,114,6598,0.04,116,11416,0.03,115,1780,379,369.66
2011,Cameroon,4517,0.02,117,6800,0.04,114,11317,0.03,116,2283,1255,81.91
2011,Papua New Guinea,6908,0.04,103,4272,0.02,133,11180,0.03,117,-2636,-2218,18.85
2011,"Aruba, Netherlands with respect to",5180,0.03,113,5917,0.03,123,11097,0.03,118,737,1129,-34.72
2011,Namibia,4407,0.02,119,6593,0.04,117,11000,0.03,119,2186,1544,41.58
2011,Malta,4386,0.02,120,6293,0.03,122,10679,0.03,120,1907,1476,29.2
2011,Cyprus,1818,0.01,139,8678,0.05,102,10496,0.03,121,6860,7167,-4.28
2011,Nicaragua,4133,0.02,121,6355,0.03,120,10488,0.03,122,2222,1541,44.19
2011,Iceland,5347,0.03,111,4841,0.03,131,10188,0.03,123,-506,-684,-26.02
2011,Mozambique,3604,0.02,123,6312,0.03,121,9916,0.03,124,2708,1600,69.25
2011,Georgia,2189,0.01,134,7065,0.04,110,9254,0.03,125,4876,3580,36.2
2011,"Macao, China",869,0.0,155,7927,0.04,104,8796,0.02,126,7058,4759,48.31
2011,Senegal,2542,0.01,128,5909,0.03,124,8451,0.02,127,3367,2621,28.46
2011,Chad,4800,0.03,115,3300,0.02,141,8100,0.02,128,-1500,-1200,25.0
2011,"Korea, Democratic People's Republic of",3705,0.02,122,4370,0.02,132,8075,0.02,129,665,975,-31.79
2011,Jamaica,1623,0.01,141,6439,0.03,119,8062,0.02,130,4816,3897,23.58
2011,Uganda,2159,0.01,135,5631,0.03,126,7790,0.02,131,3472,3045,14.02
2011,Mauritius,2565,0.01,127,5149,0.03,130,7714,0.02,132,2584,2125,21.6
2011,"Moldova, Republic of",2217,0.01,132,5191,0.03,129,7408,0.02,133,2974,2314,28.52
2011,Albania,1947,0.01,137,5383,0.03,128,7330,0.02,134,3436,2862,20.06
2011,Afghanistan,376,0.0,168,6515,0.04,118,6891,0.02,135,6139,4766,28.81
2011,Nepal,919,0.01,154,5774,0.03,125,6693,0.02,136,4855,4277,13.51
2011,Kyrgyz Republic,1979,0.01,136,4261,0.02,134,6240,0.02,137,2282,1467,55.56
2011,Mali,2374,0.01,131,3352,0.02,140,5726,0.02,138,978,1432,-31.7
2011,Armenia,1334,0.01,146,4145,0.02,135,5479,0.01,139,2811,2772,1.41
2011,New Caledonia,1663,0.01,140,3698,0.02,136,5361,0.01,140,2035,1819,11.87
2011,Mauritania,2749,0.01,126,2467,0.01,148,5216,0.01,141,-282,-139,102.88
2011,Burkina Faso,2399,0.01,130,2406,0.01,150,4805,0.01,142,7,457,-98.47
2011,Lao People's Democratic Republic,2190,0.01,133,2404,0.01,151,4594,0.01,143,214,314,-31.85
2011,Madagascar,1590,0.01,142,2905,0.02,144,4495,0.01,144,1315,1435,-8.36
2011,Tajikistan,1257,0.01,147,3206,0.02,142,4463,0.01,145,1949,1462,33.31
2011,Bahamas,727,0.0,157,3411,0.02,139,4138,0.01,146,2684,2243,19.66
2011,Suriname,2467,0.01,129,1638,0.01,163,4105,0.01,147,-829,-628,32.01
2011,Niger,1250,0.01,148,2794,0.02,145,4044,0.01,148,1544,1326,16.44
2011,Malawi,1434,0.01,143,2427,0.01,149,3861,0.01,149,993,1056,-5.97
2011,Eswatini,1910,0.01,138,1950,0.01,158,3860,0.01,150,40,160,-75.0
2011,Haiti,767,0.0,156,3020,0.02,143,3787,0.01,151,2253,2567,-12.23
2011,Lesotho,1172,0.01,150,2500,0.01,147,3672,0.01,152,1328,1422,-6.61
2011,Benin,1410,0.01,145,2129,0.01,155,3539,0.01,153,719,772,-6.87
2011,Guinea,1433,0.01,144,2106,0.01,156,3539,0.01,153,673,-66,-1119.7
2011,Togo,1179,0.01,149,2187,0.01,152,3366,0.01,155,1008,707,42.57
2011,Fiji,1069,0.01,152,2182,0.01,153,3251,0.01,156,1113,967,15.1
2011,Montenegro,628,0.0,159,2544,0.01,146,3172,0.01,157,1916,1745,9.8
2011,Curaçao,928,0.01,153,2130,0.01,154,3058,0.01,158,1202,,
2011,Guyana,1129,0.01,151,1771,0.01,161,2900,0.01,159,642,517,24.18
2011,Rwanda,464,0.0,165,2039,0.01,157,2503,0.01,160,1575,1134,38.89
2011,Barbados,475,0.0,163,1805,0.01,159,2280,0.01,161,1330,1140,16.67
2011,Sierra Leone,350,0.0,170,1717,0.01,162,2067,0.01,162,1367,429,218.65
2011,French Polynesia,168,0.0,175,1796,0.01,160,1964,0.01,163,1628,1573,3.5
2011,Somalia,467,0.0,164,1488,0.01,164,1955,0.01,164,1021,712,43.4
2011,Maldives,346,0.0,171,1465,0.01,165,1811,0.0,165,1119,893,25.31
2011,Bhutan,675,0.0,158,1043,0.01,168,1718,0.0,166,368,213,72.77
2011,Seychelles,483,0.0,162,1049,0.01,166,1532,0.0,167,566,584,-3.08
2011,Belize,604,0.0,160,831,0.0,174,1435,0.0,168,227,228,-0.44
2011,Liberia,367,0.0,169,1044,0.01,167,1411,0.0,169,677,488,38.73
2011,Greenland,491,0.0,161,915,0.0,172,1406,0.0,170,424,428,-0.93
2011,Eritrea,430,0.0,166,950,0.01,170,1380,0.0,171,520,647,-19.63
2011,Cabo Verde,69,0.0,182,947,0.01,171,1016,0.0,172,878,698,25.79
2011,Cayman Islands,37,0.0,190,962,0.01,169,999,0.0,173,925,848,9.08
2011,Bermuda,13,0.0,195,900,0.0,173,913,0.0,174,887,957,-7.31
2011,Solomon Islands,418,0.0,167,469,0.0,180,887,0.0,175,51,180,-71.67
2011,Burundi,123,0.0,178,752,0.0,175,875,0.0,176,629,408,54.17
2011,Sint Maarten,127,0.0,177,734,0.0,177,861,0.0,177,607,,
2011,Saint Lucia,160,0.0,176,697,0.0,178,857,0.0,178,537,447,20.13
2011,Guam,43,0.0,188,750,0.0,176,793,0.0,179,707,-46,-1636.96
2011,American Samoa,300,0.0,172,345,0.0,184,645,0.0,180,45,41,9.76
2011,Djibouti,93,0.0,180,511,0.0,179,604,0.0,181,418,289,44.64
2011,Guinea-Bissau,242,0.0,173,279,0.0,191,521,0.0,182,37,334,-88.92
2011,Central African Republic,190,0.0,174,310,0.0,189,500,0.0,183,120,160,-25.0
2011,Antigua and Barbuda,56,0.0,185,430,0.0,181,486,0.0,184,374,455,-17.8
2011,The Gambia,102,0.0,179,341,0.0,185,443,0.0,185,239,217,10.14
2011,Samoa,66,0.0,184,346,0.0,183,412,0.0,186,280,240,16.67
2011,Vanuatu,67,0.0,183,304,0.0,190,371,0.0,187,237,236,0.42
2011,Saint Vincent and the Grenadines,38,0.0,189,332,0.0,187,370,0.0,188,294,296,-0.68
2011,Grenada,31,0.0,191,336,0.0,186,367,0.0,189,305,293,4.1
2011,Northern Mariana Islands,2,0.0,202,350,0.0,182,352,0.0,190,348,344,1.16
2011,Timor-Leste,13,0.0,195,319,0.0,188,332,0.0,191,306,230,33.04
2011,Comoros,26,0.0,193,277,0.0,192,303,0.0,192,251,212,18.4
2011,Saint Kitts and Nevis,45,0.0,187,247,0.0,193,292,0.0,193,202,238,-15.13
2011,"Micronesia, Federated States of",73,0.0,181,188,0.0,196,261,0.0,194,115,138,-16.67
2011,Dominica,29,0.0,192,226,0.0,194,255,0.0,195,197,187,5.35
2011,Tonga,14,0.0,194,193,0.0,195,207,0.0,196,179,151,18.54
2011,Marshall Islands,50,0.0,186,130,0.0,198,180,0.0,197,80,118,-32.2
2011,Sao Tomé and Principe,11,0.0,197,134,0.0,197,145,0.0,198,123,101,21.78
2011,Palau,6,0.0,199,129,0.0,199,135,0.0,199,123,101,21.78
2011,Cook Islands,3,0.0,200,110,0.0,200,113,0.0,200,107,86,24.42
2011,Saint Pierre and Miquelon,3,0.0,200,110,0.0,200,113,0.0,200,107,93,15.05
2011,Kiribati,9,0.0,198,92,0.0,202,101,0.0,202,83,69,20.29
2011,Montserrat,2,0.0,202,33,0.0,203,35,0.0,203,31,28,10.71
2011,Tuvalu,0,0.0,204,27,0.0,204,27,0.0,204,27,22,22.73
2011,Niue,0,0.0,204,8,0.0,205,8,0.0,205,8,6,33.33
2010,United States of America,1278495,8.36,2,1969184,12.75,1,3247679,10.56,1,690689,549253,25.75
2010,China,1577754,10.31,1,1396247,9.04,2,2974001,9.67,2,-181507,-195689,-7.25
2010,Germany,1258924,8.23,3,1054814,6.83,3,2313738,7.53,3,-204110,-193694,5.38
2010,Japan,769774,5.03,4,694059,4.49,4,1463833,4.76,4,-75715,-28738,163.47
2010,France,523767,3.42,6,611070,3.96,5,1134837,3.69,5,87303,76092,14.73
2010,Netherlands,574251,3.75,5,516409,3.34,7,1090660,3.55,6,-57842,-54738,5.67
2010,United Kingdom,420182,2.75,9,592271,3.83,6,1012453,3.29,7,172089,164702,4.49
2010,Italy,447301,2.92,8,487049,3.15,8,934350,3.04,8,39748,8196,384.97
2010,"Korea, Republic of",466384,3.05,7,425212,2.75,10,891596,2.9,9,-41172,-40449,1.79
2010,"Hong Kong, China",400692,2.62,11,441369,2.86,9,842061,2.74,10,40677,22819,78.26
2010,Belgium,407692,2.66,10,391177,2.53,12,798869,2.6,11,-16515,-16761,-1.47
2010,Canada,387481,2.53,13,402690,2.61,11,790171,2.57,12,15209,13813,10.11
2010,Singapore,351867,2.3,14,310791,2.01,15,662658,2.16,13,-41076,-24047,70.82
2010,Russian Federation,400630,2.62,12,248634,1.61,18,649264,2.11,14,-151996,-111585,36.22
2010,Mexico,298305,1.95,15,310205,2.01,16,608510,1.98,15,11900,11803,0.82
2010,Spain,254418,1.66,17,327016,2.12,14,581434,1.89,16,72598,65880,10.2
2010,India,226351,1.48,19,350233,2.27,13,576584,1.88,17,123882,92293,34.23
2010,Chinese Taipei,274601,1.79,16,251236,1.63,17,525837,1.71,18,-23365,-29304,-20.27
2010,Australia,212634,1.39,21,201639,1.31,19,414273,1.35,19,-10995,11140,-198.7
2010,United Arab Emirates,213539,1.4,20,187001,1.21,21,400540,1.3,20,-26538,-21681,22.4
2010,Brazil,200434,1.31,22,193184,1.25,20,393618,1.28,21,-7250,-16414,-55.83
2010,Thailand,193306,1.26,25,182921,1.18,23,376227,1.22,22,-10385,-18713,-44.5
2010,Switzerland,195609,1.28,24,176281,1.14,25,371890,1.21,23,-19328,3391,-669.98
2010,Malaysia,198612,1.3,23,164622,1.07,26,363234,1.18,24,-33990,-33487,1.5
2010,"Saudi Arabia, Kingdom of",251143,1.64,18,106863,0.69,31,358006,1.16,25,-144280,-96762,49.11
2010,Poland,159724,1.04,26,178049,1.15,24,337773,1.1,26,18325,12956,41.44
2010,Austria,152560,1.0,29,159009,1.03,27,311569,1.01,27,6449,6074,6.17
2010,Sweden,158549,1.04,27,148946,0.96,28,307495,1.0,28,-9603,-10905,-11.94
2010,Türkiye,113883,0.74,33,185544,1.2,22,299427,0.97,29,71661,38785,84.76
2010,Indonesia,157779,1.03,28,135663,0.88,29,293442,0.95,30,-22116,-25860,-14.48
2010,Czech Republic,132982,0.87,30,126652,0.82,30,259634,0.84,31,-6330,-7907,-19.94
2010,Norway,130657,0.85,31,77330,0.5,37,207987,0.68,32,-53327,-47808,11.54
2010,South Africa,91347,0.6,37,96835,0.63,32,188182,0.61,33,5488,12377,-55.66
2010,Hungary,95483,0.62,36,88178,0.57,33,183661,0.6,34,-7305,-5247,39.22
2010,Denmark,96440,0.63,35,83052,0.54,35,179492,0.58,35,-13388,-10851,23.38
2010,Ireland,116497,0.76,32,60276,0.39,44,176773,0.57,36,-56221,-53224,5.63
2010,Iran,101316,0.66,34,65404,0.42,41,166720,0.54,37,-35912,-28062,27.97
2010,Viet Nam,72237,0.47,40,84839,0.55,34,157076,0.51,38,12602,12853,-1.95
2010,Finland,69518,0.45,43,68803,0.45,38,138321,0.45,39,-715,-1965,-63.61
2010,Slovak Republic,65957,0.43,45,66615,0.43,39,132572,0.43,40,658,-472,-239.41
2010,Chile,71109,0.46,41,59207,0.38,45,130316,0.42,41,-11902,-12657,-5.97
2010,Nigeria,84000,0.55,38,44235,0.29,50,128235,0.42,42,-39765,-22836,74.13
2010,Portugal,49406,0.32,55,77749,0.5,36,127155,0.41,43,28343,27452,3.25
2010,Argentina,68187,0.45,44,56793,0.37,48,124980,0.41,44,-11394,-16886,-32.52
2010,Israel,58415,0.38,48,58705,0.38,46,117120,0.38,45,290,-1007,-128.8
2010,Ukraine,51478,0.34,52,60911,0.39,43,112389,0.37,46,9433,5705,65.35
2010,Romania,49579,0.32,54,62109,0.4,42,111688,0.36,47,12530,13757,-8.92
2010,Philippines,51498,0.34,51,58468,0.38,47,109966,0.36,48,6970,7442,-6.34
2010,"Venezuela, Bolivarian Republic of",65745,0.43,46,39000,0.25,54,104745,0.34,49,-26745,-16063,66.5
2010,Qatar,74964,0.49,39,23240,0.15,67,98204,0.32,50,-51724,-23085,124.06
2010,Algeria,57053,0.37,49,40473,0.26,53,97526,0.32,51,-16580,-5880,181.97
2010,Iraq,51764,0.34,50,43915,0.28,51,95679,0.31,52,-7849,2082,-476.99
2010,Greece,28017,0.18,62,65907,0.43,40,93924,0.31,53,37890,48982,-22.65
2010,"Kuwait, the State of",69978,0.46,42,22675,0.15,68,92653,0.3,54,-47303,-34116,38.65
2010,Kazakhstan,59971,0.39,47,31107,0.2,58,91078,0.3,55,-28864,-14787,95.2
2010,Colombia,39713,0.26,57,40486,0.26,52,80199,0.26,56,773,45,1617.78
2010,Egypt,26438,0.17,64,52923,0.34,49,79361,0.26,57,26485,21884,21.02
2010,Libya,48745,0.32,56,26324,0.17,63,75069,0.24,58,-22421,-14174,58.18
2010,Angola,50595,0.33,53,16667,0.11,77,67262,0.22,59,-33928,-18168,86.75
2010,Peru,35993,0.24,59,30030,0.19,61,66023,0.21,60,-5963,-5513,8.16
2010,New Zealand,31396,0.21,60,30617,0.2,59,62013,0.2,61,-779,641,-221.53
2010,Belarus,25284,0.17,65,34884,0.23,57,60168,0.2,62,9600,7265,32.14
2010,Slovenia,29200,0.19,61,30094,0.19,60,59294,0.19,63,894,330,170.91
2010,Pakistan,21410,0.14,66,37807,0.24,55,59217,0.19,64,16397,14145,15.92
2010,Oman,36601,0.24,58,19973,0.13,72,56574,0.18,65,-16628,-9715,71.16
2010,Morocco,17771,0.12,71,35381,0.23,56,53152,0.17,66,17610,18827,-6.46
2010,Bangladesh,19194,0.13,70,27821,0.18,62,47015,0.15,67,8627,6750,27.81
2010,Bulgaria,20630,0.13,68,25513,0.17,64,46143,0.15,68,4883,7221,-32.38
2010,Luxembourg,19748,0.13,69,25092,0.16,65,44840,0.15,69,5344,3991,33.9
2010,Lithuania,20748,0.14,67,23403,0.15,66,44151,0.14,70,2655,1850,43.51
2010,Tunisia,16427,0.11,73,22215,0.14,69,38642,0.13,71,5788,4651,24.45
2010,Ecuador,17490,0.11,72,20591,0.13,70,38081,0.12,72,3101,1227,152.73
2010,Azerbaijan,26476,0.17,63,6746,0.04,102,33222,0.11,73,-19730,-14583,35.29
2010,Croatia,11806,0.08,76,20067,0.13,71,31873,0.1,74,8261,10720,-22.94
2010,Syrian Arab Republic,12796,0.08,75,17562,0.11,74,30358,0.1,75,4766,4588,3.88
2010,Panama,10987,0.07,81,16737,0.11,75,27724,0.09,76,5750,3160,81.96
2010,"Bahrain, Kingdom of",14971,0.1,74,12260,0.08,84,27231,0.09,77,-2711,-1774,52.82
2010,Serbia,9795,0.06,84,16735,0.11,76,26530,0.09,78,6940,7702,-9.89
2010,Estonia,11591,0.08,78,12287,0.08,83,23878,0.08,79,696,1092,-36.26
2010,Lebanese Republic,5021,0.03,107,18460,0.12,73,23481,0.08,80,13439,12387,8.49
2010,Costa Rica,9448,0.06,86,13570,0.09,81,23018,0.07,81,4122,2611,57.87
2010,Jordan,7028,0.05,94,15564,0.1,78,22592,0.07,82,8536,7861,8.59
2010,Guatemala,8463,0.06,91,13838,0.09,80,22301,0.07,83,5375,4317,24.51
2010,Dominican Republic,6754,0.04,96,15489,0.1,79,22243,0.07,84,8735,6813,28.21
2010,Sri Lanka,8602,0.06,90,13512,0.09,82,22114,0.07,85,4910,2704,81.58
2010,Sudan,11404,0.07,80,10045,0.07,89,21449,0.07,86,-1359,1434,-194.77
2010,Latvia,9532,0.06,85,11691,0.08,86,21223,0.07,87,2159,2109,2.37
2010,Uzbekistan,11695,0.08,77,8689,0.06,94,20384,0.07,88,-3006,-1712,75.58
2010,Côte d'Ivoire,11410,0.07,79,7849,0.05,100,19259,0.06,89,-3561,-4367,-18.46
2010,Ghana,7960,0.05,92,10922,0.07,88,18882,0.06,90,2962,2206,34.27
2010,Trinidad and Tobago,10982,0.07,82,6480,0.04,103,17462,0.06,91,-4502,-2171,107.37
2010,Kenya,5169,0.03,105,12093,0.08,85,17262,0.06,92,6924,5739,20.65
2010,Paraguay,6505,0.04,98,10033,0.06,90,16538,0.05,93,3528,1860,89.68
2010,Cuba,4914,0.03,108,11496,0.07,87,16410,0.05,94,6582,6527,0.84
2010,Yemen,6437,0.04,100,9255,0.06,91,15692,0.05,95,2818,2926,-3.69
2010,Equatorial Guinea,10000,0.07,83,5485,0.04,109,15485,0.05,96,-4515,-3503,28.89
2010,Uruguay,6724,0.04,97,8622,0.06,95,15346,0.05,97,1898,1502,26.36
2010,Honduras,6264,0.04,102,8907,0.06,93,15171,0.05,98,2643,2545,3.85
2010,Bosnia and Herzegovina,4803,0.03,109,9223,0.06,92,14026,0.05,99,4420,4819,-8.28
2010,Myanmar,8661,0.06,89,4760,0.03,121,13421,0.04,100,-3901,-2314,68.58
2010,El Salvador,4499,0.03,112,8416,0.05,98,12915,0.04,101,3917,3459,13.24
2010,Zambia,7200,0.05,93,5321,0.03,112,12521,0.04,102,-1879,-480,291.46
2010,Turkmenistan,6500,0.04,99,5700,0.04,104,12200,0.04,103,-800,1800,-144.44
2010,"Bolivia, Plurinational State of",6402,0.04,101,5590,0.04,107,11992,0.04,104,-812,-415,95.66
2010,Cambodia,5143,0.03,106,6791,0.04,101,11934,0.04,105,1648,1634,0.86
2010,Tanzania,4051,0.03,113,7874,0.05,99,11925,0.04,106,3823,3429,11.49
2010,Gabon,8686,0.06,88,2983,0.02,138,11669,0.04,107,-5703,-2855,99.75
2010,Brunei Darussalam,8907,0.06,87,2538,0.02,143,11445,0.04,108,-6369,-4751,34.06
2010,Congo,6918,0.05,95,4369,0.03,127,11287,0.04,109,-2549,-3755,-32.12
2010,Ethiopia,2330,0.02,124,8602,0.06,96,10932,0.04,110,6272,6050,3.67
2010,Botswana,4693,0.03,110,5657,0.04,105,10350,0.03,111,964,1272,-24.21
2010,Cyprus,1402,0.01,140,8569,0.06,97,9971,0.03,112,7167,6578,8.95
2010,Democratic Republic of the Congo,5300,0.03,104,4500,0.03,124,9800,0.03,113,-800,400,-300.0
2010,Namibia,4026,0.03,114,5570,0.04,108,9596,0.03,114,1544,1834,-15.81
2010,Papua New Guinea,5742,0.04,103,3524,0.02,132,9266,0.03,115,-2218,-1527,45.25
2010,Cameroon,3878,0.03,115,5133,0.03,116,9011,0.03,116,1255,890,41.01
2010,North Macedonia,3351,0.02,118,5474,0.04,110,8825,0.03,117,2123,2365,-10.23
2010,Malta,3586,0.02,117,5062,0.03,118,8648,0.03,118,1476,1621,-8.95
2010,Zimbabwe,3199,0.02,120,5337,0.03,111,8536,0.03,119,2138,3450,-38.03
2010,Iceland,4604,0.03,111,3920,0.03,128,8524,0.03,120,-684,-453,50.99
2010,Nicaragua,3251,0.02,119,4792,0.03,119,8043,0.03,121,1541,1538,0.2
2010,Mozambique,3000,0.02,121,4600,0.03,123,7600,0.02,122,1600,1617,-1.05
2010,Senegal,2161,0.01,126,4782,0.03,120,6943,0.02,123,2621,2696,-2.78
2010,Georgia,1677,0.01,133,5257,0.03,113,6934,0.02,124,3580,3366,6.36
2010,Mauritius,2261,0.01,125,4386,0.03,126,6647,0.02,125,2125,1794,18.45
2010,Jamaica,1328,0.01,141,5225,0.03,114,6553,0.02,126,3897,3748,3.98
2010,"Macao, China",870,0.01,151,5629,0.04,106,6499,0.02,127,4759,3790,25.57
2010,Uganda,1619,0.01,134,4664,0.03,122,6283,0.02,128,3045,2679,13.66
2010,Mongolia,2899,0.02,122,3278,0.02,135,6177,0.02,129,379,228,66.23
2010,"Korea, Democratic People's Republic of",2555,0.02,123,3530,0.02,131,6085,0.02,130,975,1100,-11.36
2010,Chad,3600,0.02,116,2400,0.02,145,6000,0.02,131,-1200,-800,50.0
2010,Nepal,856,0.01,152,5133,0.03,116,5989,0.02,132,4277,3561,20.11
2010,Albania,1544,0.01,136,4406,0.03,125,5950,0.02,133,2862,3462,-17.33
2010,Afghanistan,388,0.0,162,5154,0.03,115,5542,0.02,134,4766,2933,62.5
2010,Mali,1996,0.01,129,3428,0.02,133,5424,0.02,135,1432,712,101.12
2010,"Moldova, Republic of",1541,0.01,137,3855,0.02,129,5396,0.02,136,2314,1995,15.99
2010,Kyrgyz Republic,1756,0.01,131,3223,0.02,136,4979,0.02,137,1467,1367,7.32
2010,New Caledonia,1493,0.01,138,3312,0.02,134,4805,0.02,138,1819,1581,15.05
2010,Armenia,1011,0.01,147,3783,0.02,130,4794,0.02,139,2772,2611,6.17
2010,Mauritania,2074,0.01,127,1935,0.01,153,4009,0.01,140,-139,134,-203.73
2010,Tajikistan,1195,0.01,143,2657,0.02,140,3852,0.01,141,1462,1560,-6.28
2010,Lao People's Democratic Republic,1746,0.01,132,2060,0.01,149,3806,0.01,142,314,408,-23.04
2010,Eswatini,1800,0.01,130,1960,0.01,152,3760,0.01,143,160,120,33.33
2010,Madagascar,1149,0.01,145,2584,0.02,142,3733,0.01,144,1435,2147,-33.16
2010,Haiti,579,0.0,157,3146,0.02,137,3725,0.01,145,2567,1548,65.83
2010,Burkina Faso,1591,0.01,135,2048,0.01,151,3639,0.01,146,457,970,-52.89
2010,Niger,1150,0.01,144,2476,0.02,144,3626,0.01,147,1326,1264,4.91
2010,Bahamas,620,0.0,156,2863,0.02,139,3483,0.01,148,2243,2114,6.1
2010,Netherlands Antilles,807,0.01,154,2622,0.02,141,3429,0.01,149,1815,1797,1.0
2010,Suriname,2026,0.01,128,1398,0.01,160,3424,0.01,150,-628,-12,5133.33
2010,Benin,1282,0.01,142,2054,0.01,150,3336,0.01,151,772,839,-7.99
2010,Malawi,1109,0.01,146,2165,0.01,148,3274,0.01,152,1056,910,16.04
2010,Lesotho,878,0.01,150,2300,0.01,146,3178,0.01,153,1422,1116,27.42
2010,Guinea,1471,0.01,139,1405,0.01,159,2876,0.01,154,-66,10,-760.0
2010,Togo,976,0.01,148,1683,0.01,156,2659,0.01,155,707,606,16.67
2010,Fiji,841,0.01,153,1808,0.01,154,2649,0.01,156,967,810,19.38
2010,Montenegro,437,0.0,159,2182,0.01,147,2619,0.01,157,1745,1925,-9.35
2010,Guyana,880,0.01,149,1397,0.01,161,2277,0.01,158,517,398,29.9
2010,Barbados,429,0.0,160,1569,0.01,157,1998,0.01,159,1140,1070,6.54
2010,French Polynesia,153,0.0,173,1726,0.01,155,1879,0.01,160,1573,1569,0.25
2010,Rwanda,297,0.0,167,1431,0.01,158,1728,0.01,161,1134,1073,5.68
2010,"Aruba, Netherlands with respect to",265,0.0,168,1394,0.01,162,1659,0.01,162,1129,497,127.16
2010,Bhutan,641,0.0,155,854,0.01,168,1495,0.0,163,213,33,545.45
2010,Somalia,355,0.0,164,1067,0.01,164,1422,0.0,164,712,486,46.5
2010,Seychelles,400,0.0,161,984,0.01,165,1384,0.0,165,584,399,46.37
2010,Maldives,198,0.0,172,1091,0.01,163,1289,0.0,166,893,794,12.47
2010,Greenland,380,0.0,163,808,0.01,169,1188,0.0,167,428,382,12.04
2010,Belize,478,0.0,158,706,0.0,173,1184,0.0,168,228,288,-20.83
2010,Sierra Leone,341,0.0,165,770,0.0,170,1111,0.0,169,429,289,48.44
2010,Bermuda,15,0.0,193,972,0.01,166,987,0.0,170,957,1035,-7.54
2010,Liberia,222,0.0,170,710,0.0,172,932,0.0,171,488,402,21.39
2010,Cayman Islands,24,0.0,190,872,0.01,167,896,0.0,172,848,908,-6.61
2010,Saint Lucia,215,0.0,171,662,0.0,174,877,0.0,173,447,354,26.27
2010,Cabo Verde,44,0.0,183,742,0.0,171,786,0.0,174,698,674,3.56
2010,American Samoa,320,0.0,166,361,0.0,181,681,0.0,175,41,-2,-2150.0
2010,Eritrea,13,0.0,194,660,0.0,175,673,0.0,176,647,579,11.74
2010,Solomon Islands,224,0.0,169,404,0.0,179,628,0.0,177,180,103,74.76
2010,Burundi,101,0.0,176,509,0.0,176,610,0.0,178,408,335,21.79
2010,Guinea-Bissau,127,0.0,175,461,0.0,178,588,0.0,179,334,376,-11.17
2010,Antigua and Barbuda,46,0.0,181,501,0.0,177,547,0.0,180,455,483,-5.8
2010,Djibouti,85,0.0,177,374,0.0,180,459,0.0,181,289,374,-22.73
2010,Central African Republic,140,0.0,174,300,0.0,186,440,0.0,182,160,150,6.67
2010,Saint Vincent and the Grenadines,42,0.0,184,338,0.0,183,380,0.0,183,296,284,4.23
2010,Samoa,70,0.0,178,310,0.0,185,380,0.0,183,240,185,29.73
2010,Northern Mariana Islands,5,0.0,199,349,0.0,182,354,0.0,185,344,325,5.85
2010,The Gambia,68,0.0,179,285,0.0,187,353,0.0,186,217,238,-8.82
2010,Grenada,25,0.0,189,318,0.0,184,343,0.0,187,293,253,15.81
2010,Vanuatu,49,0.0,180,285,0.0,187,334,0.0,188,236,237,-0.42
2010,Saint Kitts and Nevis,32,0.0,186,270,0.0,189,302,0.0,189,238,258,-7.75
2010,Timor-Leste,16,0.0,192,246,0.0,190,262,0.0,190,230,287,-19.86
2010,Dominica,37,0.0,185,224,0.0,192,261,0.0,191,187,192,-2.6
2010,Comoros,21,0.0,191,233,0.0,191,254,0.0,192,212,195,8.72
2010,"Micronesia, Federated States of",30,0.0,188,168,0.0,193,198,0.0,193,138,147,-6.12
2010,Marshall Islands,32,0.0,186,150,0.0,195,182,0.0,194,118,84,40.48
2010,Tonga,8,0.0,196,159,0.0,194,167,0.0,195,151,137,10.22
2010,Sao Tomé and Principe,11,0.0,195,112,0.0,196,123,0.0,196,101,95,6.32
2010,Palau,6,0.0,197,107,0.0,197,113,0.0,197,101,84,20.24
2010,Saint Pierre and Miquelon,6,0.0,197,99,0.0,198,105,0.0,198,93,78,19.23
2010,Cook Islands,5,0.0,199,91,0.0,199,96,0.0,199,86,69,24.64
2010,Kiribati,4,0.0,201,73,0.0,200,77,0.0,200,69,61,13.11
2010,Guam,46,0.0,181,0,0.0,204,46,0.0,201,-46,-51,-9.8
2010,Montserrat,1,0.0,202,29,0.0,201,30,0.0,202,28,27,3.7
2010,Tuvalu,0,0.0,203,22,0.0,202,22,0.0,203,22,14,57.14
2010,Niue,0,0.0,203,6,0.0,203,6,0.0,204,6,6,0.0
2009,United States of America,1056043,8.39,3,1605296,12.57,1,2661339,10.5,1,549253,882045,-37.73
2009,China,1201612,9.55,1,1005923,7.88,2,2207535,8.71,2,-195689,-298126,-34.36
2009,Germany,1120041,8.9,2,926347,7.25,3,2046388,8.07,3,-193694,-261104,-25.82
2009,Japan,580719,4.62,4,551981,4.32,5,1132700,4.47,4,-28738,-18878,52.23
2009,France,484781,3.85,6,560873,4.39,4,1045654,4.12,5,76092,100555,-24.33
2009,Netherlands,497891,3.96,5,443153,3.47,7,941044,3.71,6,-54738,-56981,-3.94
2009,United Kingdom,358158,2.85,10,522860,4.09,6,881018,3.47,7,164702,191125,-13.82
2009,Italy,406909,3.23,7,415105,3.25,8,822014,3.24,8,8196,19171,-57.25
2009,Belgium,370125,2.94,8,353364,2.77,9,723489,2.85,9,-16761,-5533,202.93
2009,"Korea, Republic of",363534,2.89,9,323085,2.53,12,686619,2.71,10,-40449,13268,-404.86
2009,"Hong Kong, China",329422,2.62,11,352241,2.76,10,681663,2.69,11,22819,22720,0.44
2009,Canada,316094,2.51,12,329907,2.58,11,646001,2.55,12,13813,-37460,-136.87
2009,Spain,227338,1.81,16,293218,2.3,13,520556,2.05,13,65880,139310,-52.71
2009,Singapore,269832,2.14,14,245785,1.92,15,515617,2.03,14,-24047,-18396,30.72
2009,Russian Federation,303388,2.41,13,191803,1.5,18,495191,1.95,15,-111585,-179745,-37.92
2009,Mexico,229712,1.83,15,241515,1.89,16,471227,1.86,16,11803,27039,-56.35
2009,India,164909,1.31,21,257202,2.01,14,422111,1.66,17,92293,126204,-26.87
2009,Switzerland,204305,1.62,17,207696,1.63,17,412001,1.63,18,3391,-6507,-152.11
2009,Chinese Taipei,203675,1.62,18,174371,1.37,19,378046,1.49,19,-29304,-15181,93.03
2009,United Arab Emirates,191802,1.52,20,170121,1.33,20,361923,1.43,20,-21681,-38886,-44.24
2009,Australia,154331,1.23,23,165471,1.3,21,319802,1.26,21,11140,13016,-14.41
2009,"Saudi Arabia, Kingdom of",192314,1.53,19,95552,0.75,30,287866,1.14,22,-96762,-198328,-51.21
2009,Brazil,151792,1.21,25,135378,1.06,25,287170,1.13,23,-16414,-11844,38.58
2009,Thailand,152422,1.21,24,133709,1.05,26,286131,1.13,24,-18713,1447,-1393.23
2009,Poland,136503,1.08,27,149459,1.17,22,285962,1.13,25,12956,38346,-66.21
2009,Malaysia,157244,1.25,22,123757,0.97,27,281001,1.11,26,-33487,-43066,-22.24
2009,Austria,136989,1.09,26,143063,1.12,23,280052,1.1,27,6074,3004,102.2
2009,Sweden,130781,1.04,28,119876,0.94,28,250657,0.99,28,-10905,-14824,-26.44
2009,Türkiye,102143,0.81,33,140928,1.1,24,243071,0.96,29,38785,69937,-44.54
2009,Czech Republic,112955,0.9,32,105048,0.82,29,218003,0.86,30,-7907,-4761,66.08
2009,Indonesia,119646,0.95,29,93786,0.73,31,213432,0.84,31,-25860,-12068,114.29
2009,Norway,116778,0.93,30,68970,0.54,38,185748,0.73,32,-47808,-81471,-41.32
2009,Ireland,115928,0.92,31,62704,0.49,39,178632,0.7,33,-53224,-41754,27.47
2009,Denmark,93984,0.75,34,83133,0.65,32,177117,0.7,34,-10851,-7561,43.51
2009,Hungary,83008,0.66,35,77761,0.61,33,160769,0.63,35,-5247,436,-1303.44
2009,South Africa,61677,0.49,38,74054,0.58,35,135731,0.54,36,12377,20858,-40.66
2009,Iran,78830,0.63,36,50768,0.4,43,129598,0.51,37,-28062,-56267,-50.13
2009,Viet Nam,57096,0.45,40,69949,0.55,37,127045,0.5,38,12853,18029,-28.71
2009,Finland,62854,0.5,37,60889,0.48,40,123743,0.49,39,-1965,-4674,-57.96
2009,Portugal,44211,0.35,49,71663,0.56,36,115874,0.46,40,27452,37279,-26.36
2009,Slovak Republic,56245,0.45,42,55773,0.44,41,112018,0.44,41,-472,2737,-117.25
2009,Greece,25149,0.2,61,74131,0.58,34,99280,0.39,42,48982,65336,-25.03
2009,"Venezuela, Bolivarian Republic of",57603,0.46,39,41540,0.33,49,99143,0.39,43,-16063,-44571,-63.96
2009,Chile,55463,0.44,44,42806,0.34,48,98269,0.39,44,-12657,-1723,634.59
2009,Romania,40567,0.32,52,54324,0.43,42,94891,0.37,45,13757,34518,-60.15
2009,Israel,47935,0.38,47,46928,0.37,44,94863,0.37,46,-1007,3706,-127.17
2009,Argentina,55672,0.44,43,38786,0.3,52,94458,0.37,47,-16886,-12556,34.49
2009,Nigeria,56742,0.45,41,33906,0.27,53,90648,0.36,48,-22836,-36323,-37.13
2009,Ukraine,39782,0.32,53,45487,0.36,46,85269,0.34,49,5705,18581,-69.3
2009,Algeria,45174,0.36,48,39294,0.31,51,84468,0.33,50,-5880,-39819,-85.23
2009,Philippines,38436,0.31,55,45878,0.36,45,84314,0.33,51,7442,11342,-34.39
2009,Iraq,39430,0.31,54,41512,0.33,50,80942,0.32,52,2082,-28714,-107.25
2009,"Kuwait, the State of",54008,0.43,45,19892,0.16,68,73900,0.29,53,-34116,-62617,-45.52
2009,Qatar,48007,0.38,46,24922,0.2,62,72929,0.29,54,-23085,-39407,-41.42
2009,Kazakhstan,43196,0.34,50,28409,0.22,58,71605,0.28,55,-14787,-33283,-55.57
2009,Egypt,23062,0.18,63,44946,0.35,47,68008,0.27,56,21884,22158,-1.24
2009,Colombia,32853,0.26,56,32898,0.26,54,65751,0.26,57,45,2043,-97.8
2009,Angola,40828,0.32,51,22660,0.18,64,63488,0.25,58,-18168,-42932,-57.68
2009,Slovenia,26177,0.21,60,26507,0.21,59,52684,0.21,59,330,2906,-88.64
2009,New Zealand,24933,0.2,62,25574,0.2,60,50507,0.2,60,641,3789,-83.08
2009,Belarus,21304,0.17,65,28569,0.22,57,49873,0.2,61,7265,6810,6.68
2009,Pakistan,17523,0.14,67,31668,0.25,56,49191,0.19,62,14145,22006,-35.72
2009,Peru,27327,0.22,59,21814,0.17,66,49141,0.19,63,-5513,-873,531.5
2009,Morocco,14054,0.11,72,32881,0.26,55,46935,0.19,64,18827,22021,-14.5
2009,Luxembourg,21339,0.17,64,25330,0.2,61,46669,0.18,65,3991,6463,-38.25
2009,Oman,27651,0.22,58,17936,0.14,71,45587,0.18,66,-9715,-14582,-33.38
2009,Libya,27735,0.22,57,13561,0.11,78,41296,0.16,67,-14174,-37589,-62.29
2009,Bulgaria,16318,0.13,69,23539,0.18,63,39857,0.16,68,7221,14546,-50.36
2009,Bangladesh,15083,0.12,70,21833,0.17,65,36916,0.15,69,6750,8490,-20.49
2009,Lithuania,16454,0.13,68,18304,0.14,70,34758,0.14,70,1850,7453,-75.18
2009,Tunisia,14445,0.11,71,19096,0.15,69,33541,0.13,71,4651,5318,-12.54
2009,Croatia,10403,0.08,79,21123,0.17,67,31526,0.12,72,10720,16616,-35.48
2009,Ecuador,13863,0.11,73,15090,0.12,75,28953,0.11,73,1227,34,3508.82
2009,Azerbaijan,21097,0.17,66,6514,0.05,102,27611,0.11,74,-14583,-23012,-36.63
2009,Syrian Arab Republic,10855,0.09,76,15443,0.12,74,26298,0.1,75,4588,2695,70.24
2009,Panama,10717,0.09,78,13877,0.11,77,24594,0.1,76,3160,5920,-46.62
2009,Serbia,8345,0.07,84,16047,0.13,73,24392,0.1,77,7702,13359,-42.35
2009,"Bahrain, Kingdom of",11874,0.09,74,10100,0.08,84,21974,0.09,78,-1774,-2336,-24.06
2009,Lebanese Republic,4187,0.03,106,16574,0.13,72,20761,0.08,79,12387,12300,0.71
2009,Jordan,6375,0.05,92,14236,0.11,76,20611,0.08,80,7861,9057,-13.21
2009,Costa Rica,8784,0.07,83,11395,0.09,81,20179,0.08,81,2611,5868,-55.5
2009,Uzbekistan,10735,0.09,77,9023,0.07,90,19758,0.08,82,-1712,-1021,67.68
2009,Estonia,9048,0.07,82,10140,0.08,83,19188,0.08,83,1092,3568,-69.39
2009,Guatemala,7214,0.06,89,11531,0.09,80,18745,0.07,84,4317,6810,-36.61
2009,Côte d'Ivoire,11327,0.09,75,6960,0.05,97,18287,0.07,85,-4367,-2506,74.26
2009,Sudan,8257,0.07,85,9691,0.08,87,17948,0.07,86,1434,-2319,-161.84
2009,Dominican Republic,5483,0.04,95,12296,0.1,79,17779,0.07,87,6813,9245,-26.31
2009,Latvia,7702,0.06,87,9811,0.08,86,17513,0.07,88,2109,5999,-64.84
2009,Sri Lanka,7345,0.06,88,10049,0.08,85,17394,0.07,89,2704,5501,-50.85
2009,Trinidad and Tobago,9126,0.07,80,6955,0.05,98,16081,0.06,90,-2171,-9059,-76.03
2009,Yemen,6259,0.05,93,9185,0.07,89,15444,0.06,91,2926,2962,-1.22
2009,Equatorial Guinea,9100,0.07,81,5597,0.04,106,14697,0.06,92,-3503,-11431,-69.36
2009,Kenya,4463,0.04,102,10202,0.08,82,14665,0.06,93,5739,6127,-6.33
2009,Ghana,5840,0.05,94,8046,0.06,92,13886,0.05,94,2206,4999,-55.87
2009,Bosnia and Herzegovina,3954,0.03,108,8773,0.07,91,12727,0.05,95,4819,7168,-32.77
2009,Cuba,3092,0.02,114,9619,0.08,88,12711,0.05,96,6527,11416,-42.83
2009,Congo,8202,0.07,86,4447,0.03,117,12649,0.05,97,-3755,-5630,-33.3
2009,Uruguay,5405,0.04,96,6907,0.05,100,12312,0.05,98,1502,3127,-51.97
2009,Honduras,4827,0.04,101,7372,0.06,95,12199,0.05,99,2545,4254,-40.17
2009,Paraguay,5080,0.04,98,6940,0.05,99,12020,0.05,100,1860,2626,-29.17
2009,Turkmenistan,5000,0.04,99,6800,0.05,101,11800,0.05,101,1800,-6345,-128.37
2009,El Salvador,3866,0.03,109,7325,0.06,96,11191,0.04,102,3459,5177,-33.19
2009,Myanmar,6662,0.05,91,4348,0.03,120,11010,0.04,103,-2314,-2626,-11.88
2009,Cambodia,4196,0.03,105,5830,0.05,104,10026,0.04,104,1634,1800,-9.22
2009,Brunei Darussalam,7200,0.06,90,2449,0.02,141,9649,0.04,105,-4751,-7747,-38.67
2009,"Bolivia, Plurinational State of",4960,0.04,100,4545,0.04,114,9505,0.04,106,-415,-1444,-71.26
2009,Tanzania,2982,0.02,115,6411,0.05,103,9393,0.04,107,3429,4582,-25.16
2009,Ethiopia,1618,0.01,130,7668,0.06,94,9286,0.04,108,6050,6675,-9.36
2009,Cyprus,1257,0.01,136,7835,0.06,93,9092,0.04,109,6578,9011,-27.0
2009,Botswana,3456,0.03,112,4728,0.04,111,8184,0.03,110,1272,260,389.23
2009,Zambia,4312,0.03,104,3832,0.03,124,8144,0.03,111,-480,-39,1130.77
2009,Namibia,3146,0.03,113,4980,0.04,109,8126,0.03,112,1834,1199,52.96
2009,Cameroon,3552,0.03,110,4442,0.03,118,7994,0.03,113,890,445,100.0
2009,Zimbabwe,2269,0.02,120,5719,0.04,105,7988,0.03,114,3450,-280,-1332.14
2009,Gabon,5356,0.04,97,2501,0.02,139,7857,0.03,115,-2855,-7003,-59.23
2009,North Macedonia,2708,0.02,118,5073,0.04,107,7781,0.03,116,2365,2892,-18.22
2009,Iceland,4057,0.03,107,3604,0.03,127,7661,0.03,117,-453,823,-155.04
2009,Democratic Republic of the Congo,3500,0.03,111,3900,0.03,123,7400,0.03,118,400,-100,-500.0
2009,Malta,2857,0.02,116,4478,0.04,116,7335,0.03,119,1621,1819,-10.89
2009,Papua New Guinea,4394,0.03,103,2867,0.02,134,7261,0.03,120,-1527,-2596,-41.18
2009,Senegal,2017,0.02,122,4713,0.04,112,6730,0.03,121,2696,4358,-38.14
2009,Jamaica,1316,0.01,134,5064,0.04,108,6380,0.03,122,3748,6026,-37.8
2009,Nicaragua,2391,0.02,119,3929,0.03,122,6320,0.02,123,1538,2200,-30.09
2009,Mozambique,2147,0.02,121,3764,0.03,125,5911,0.02,124,1617,1355,19.34
2009,Uganda,1568,0.01,131,4247,0.03,121,5815,0.02,125,2679,2802,-4.39
2009,"Macao, China",961,0.01,147,4751,0.04,110,5712,0.02,126,3790,3883,-2.4
2009,Mauritius,1939,0.02,125,3733,0.03,126,5672,0.02,127,1794,2267,-20.86
2009,Albania,1091,0.01,140,4553,0.04,113,5644,0.02,128,3462,4548,-23.88
2009,Georgia,1134,0.01,139,4500,0.04,115,5634,0.02,129,3366,4807,-29.98
2009,Nepal,823,0.01,150,4384,0.03,119,5207,0.02,130,3561,2651,34.33
2009,"Korea, Democratic People's Republic of",1995,0.02,123,3095,0.02,132,5090,0.02,131,1100,1520,-27.63
2009,Chad,2800,0.02,117,2000,0.02,149,4800,0.02,132,-800,-2169,-63.12
2009,Kyrgyz Republic,1673,0.01,128,3040,0.02,133,4713,0.02,133,1367,2216,-38.31
2009,"Moldova, Republic of",1283,0.01,135,3278,0.03,130,4561,0.02,134,1995,3308,-39.69
2009,"Aruba, Netherlands with respect to",1952,0.02,124,2449,0.02,141,4401,0.02,135,497,555,-10.45
2009,Mali,1774,0.01,127,2486,0.02,140,4260,0.02,136,712,1242,-42.67
2009,Madagascar,1052,0.01,142,3199,0.03,131,4251,0.02,137,2147,2471,-13.11
2009,Mongolia,1903,0.02,126,2131,0.02,145,4034,0.02,138,228,1077,-78.83
2009,Armenia,710,0.01,154,3321,0.03,129,4031,0.02,139,2611,3369,-22.5
2009,Afghanistan,403,0.0,160,3336,0.03,128,3739,0.01,140,2933,2480,18.27
2009,Tajikistan,1010,0.01,144,2570,0.02,138,3580,0.01,141,1560,1864,-16.31
2009,New Caledonia,993,0.01,146,2574,0.02,137,3567,0.01,142,1581,1933,-18.21
2009,Eswatini,1660,0.01,129,1780,0.01,152,3440,0.01,143,120,10,1100.0
2009,Netherlands Antilles,810,0.01,151,2607,0.02,136,3417,0.01,144,1797,1991,-9.74
2009,Malawi,1192,0.01,138,2102,0.02,147,3294,0.01,145,910,1153,-21.08
2009,Benin,1225,0.01,137,2064,0.02,148,3289,0.01,146,839,1007,-16.68
2009,Bahamas,585,0.0,156,2699,0.02,135,3284,0.01,147,2114,2505,-15.61
2009,Niger,1000,0.01,145,2264,0.02,144,3264,0.01,148,1264,786,60.81
2009,Mauritania,1364,0.01,133,1498,0.01,155,2862,0.01,149,134,153,-12.42
2009,Suriname,1402,0.01,132,1390,0.01,159,2792,0.01,150,-12,-439,-97.27
2009,Burkina Faso,900,0.01,149,1870,0.01,150,2770,0.01,151,970,1325,-26.79
2009,Montenegro,388,0.0,162,2313,0.02,143,2701,0.01,152,1925,3114,-38.18
2009,Haiti,576,0.0,157,2124,0.02,146,2700,0.01,153,1548,1835,-15.64
2009,Lesotho,734,0.01,153,1850,0.01,151,2584,0.01,154,1116,916,21.83
2009,Lao People's Democratic Republic,1053,0.01,141,1461,0.01,156,2514,0.01,155,408,311,31.19
2009,Togo,903,0.01,148,1509,0.01,154,2412,0.01,156,606,656,-7.62
2009,Guinea,1050,0.01,143,1060,0.01,163,2110,0.01,157,10,24,-58.33
2009,Fiji,630,0.01,155,1440,0.01,158,2070,0.01,158,810,1342,-39.64
2009,Guyana,763,0.01,152,1161,0.01,161,1924,0.01,159,398,517,-23.02
2009,French Polynesia,148,0.0,173,1717,0.01,153,1865,0.01,160,1569,1974,-20.52
2009,Barbados,379,0.0,164,1449,0.01,157,1828,0.01,161,1070,1432,-25.28
2009,Rwanda,235,0.0,167,1308,0.01,160,1543,0.01,162,1073,906,18.43
2009,Seychelles,395,0.0,161,794,0.01,166,1189,0.0,163,399,657,-39.27
2009,Maldives,169,0.0,169,963,0.01,164,1132,0.0,164,794,1057,-24.88
2009,Greenland,360,0.0,165,742,0.01,168,1102,0.0,165,382,408,-6.37
2009,Bermuda,29,0.0,187,1064,0.01,162,1093,0.0,166,1035,1135,-8.81
2009,Belize,381,0.0,163,669,0.01,170,1050,0.0,167,288,368,-21.74
2009,Somalia,271,0.0,166,757,0.01,167,1028,0.0,168,486,622,-21.86
2009,Bhutan,496,0.0,158,529,0.0,174,1025,0.0,169,33,22,50.0
2009,American Samoa,484,0.0,159,482,0.0,178,966,0.0,170,-2,231,-100.87
2009,Cayman Islands,28,0.0,189,936,0.01,165,964,0.0,171,908,1097,-17.23
2009,Sierra Leone,231,0.0,168,520,0.0,175,751,0.0,172,289,318,-9.12
2009,Cabo Verde,35,0.0,185,709,0.01,169,744,0.0,173,674,793,-15.01
2009,Liberia,149,0.0,172,551,0.0,172,700,0.0,174,402,571,-29.6
2009,Saint Lucia,166,0.0,170,520,0.0,175,686,0.0,175,354,492,-28.05
2009,Guinea-Bissau,122,0.0,174,498,0.0,177,620,0.0,176,376,388,-3.09
2009,Eritrea,11,0.0,193,590,0.0,171,601,0.0,177,579,589,-1.7
2009,Antigua and Barbuda,51,0.0,180,534,0.0,173,585,0.0,178,483,678,-28.76
2009,Djibouti,77,0.0,176,451,0.0,179,528,0.0,179,374,505,-25.94
2009,Burundi,67,0.0,177,402,0.0,180,469,0.0,180,335,346,-3.18
2009,Solomon Islands,165,0.0,171,268,0.0,189,433,0.0,181,103,118,-12.71
2009,Central African Republic,120,0.0,175,270,0.0,188,390,0.0,182,150,150,0.0
2009,Saint Vincent and the Grenadines,49,0.0,182,333,0.0,182,382,0.0,183,284,321,-11.53
2009,The Gambia,66,0.0,178,304,0.0,183,370,0.0,184,238,308,-22.73
2009,Vanuatu,57,0.0,179,294,0.0,186,351,0.0,185,237,257,-7.78
2009,Northern Mariana Islands,9,0.0,194,334,0.0,181,343,0.0,186,325,241,34.85
2009,Saint Kitts and Nevis,38,0.0,184,296,0.0,184,334,0.0,187,258,274,-5.84
2009,Grenada,29,0.0,187,282,0.0,187,311,0.0,188,253,332,-23.8
2009,Timor-Leste,8,0.0,195,295,0.0,185,303,0.0,189,287,256,12.11
2009,Samoa,46,0.0,183,231,0.0,190,277,0.0,190,185,216,-14.35
2009,Dominica,33,0.0,186,225,0.0,191,258,0.0,191,192,207,-7.25
2009,Comoros,15,0.0,192,210,0.0,192,225,0.0,192,195,173,12.72
2009,"Micronesia, Federated States of",25,0.0,190,172,0.0,193,197,0.0,193,147,128,14.84
2009,Tonga,8,0.0,195,145,0.0,194,153,0.0,194,137,159,-13.84
2009,Marshall Islands,21,0.0,191,105,0.0,195,126,0.0,195,84,80,5.0
2009,Sao Tomé and Principe,8,0.0,195,103,0.0,196,111,0.0,196,95,103,-7.77
2009,Palau,6,0.0,198,90,0.0,197,96,0.0,197,84,120,-30.0
2009,Saint Pierre and Miquelon,5,0.0,200,83,0.0,198,88,0.0,198,78,92,-15.22
2009,Cook Islands,3,0.0,201,72,0.0,199,75,0.0,199,69,107,-35.51
2009,Kiribati,6,0.0,198,67,0.0,200,73,0.0,200,61,67,-8.96
2009,Guam,51,0.0,180,0,0.0,204,51,0.0,201,-51,-105,-51.43
2009,Montserrat,3,0.0,201,30,0.0,201,33,0.0,202,27,34,-20.59
2009,Tuvalu,0,0.0,203,14,0.0,202,14,0.0,203,14,26,-46.15
2009,Niue,0,0.0,203,6,0.0,203,6,0.0,204,6,8,-25.0
2008,United States of America,1287442,7.95,3,2169487,13.11,1,3456929,10.56,1,882045,872204,1.13
2008,Germany,1446171,8.93,1,1185067,7.16,2,2631238,8.04,2,-261104,-266231,-1.93
2008,China,1430693,8.84,2,1132567,6.85,3,2563260,7.83,3,-298126,-264340,12.78
2008,Japan,781412,4.83,4,762534,4.61,4,1543946,4.72,4,-18878,-92084,-79.5
2008,France,616240,3.81,6,716795,4.33,5,1333035,4.07,5,100555,71249,41.13
2008,Netherlands,637918,3.94,5,580937,3.51,7,1218855,3.72,6,-56981,-58139,-1.99
2008,United Kingdom,477475,2.95,8,668600,4.04,6,1146075,3.5,7,191125,197760,-3.36
2008,Italy,542748,3.35,7,561919,3.4,8,1104667,3.37,8,19171,11780,62.74
2008,Belgium,471840,2.91,9,466307,2.82,9,938147,2.87,9,-5533,-19394,-71.47
2008,Canada,456471,2.82,11,419011,2.53,12,875482,2.67,10,-37460,-30505,22.8
2008,"Korea, Republic of",422007,2.61,12,435275,2.63,10,857282,2.62,11,13268,-14643,-190.61
2008,Russian Federation,471606,2.91,10,291861,1.76,17,763467,2.33,12,-179745,-130917,37.3
2008,"Hong Kong, China",370242,2.29,13,392962,2.38,13,763204,2.33,13,22720,20746,9.52
2008,Spain,281493,1.74,17,420803,2.54,11,702296,2.15,14,139310,136004,2.43
2008,Singapore,338176,2.09,14,319780,1.93,15,657956,2.01,15,-18396,-36153,-49.12
2008,Mexico,291265,1.8,16,318304,1.92,16,609569,1.86,16,27039,18425,46.75
2008,India,194828,1.2,23,321032,1.94,14,515860,1.58,17,126204,79211,59.33
2008,Chinese Taipei,255629,1.58,18,240448,1.45,18,496077,1.52,18,-15181,-27425,-44.65
2008,Switzerland,236386,1.46,20,229879,1.39,19,466265,1.42,19,-6507,-7301,-10.88
2008,United Arab Emirates,239213,1.48,19,200327,1.21,22,439540,1.34,20,-38886,-28507,36.41
2008,"Saudi Arabia, Kingdom of",313462,1.94,15,115134,0.7,31,428596,1.31,21,-198328,-143115,38.58
2008,Australia,187257,1.16,24,200273,1.21,23,387530,1.18,22,13016,23978,-45.72
2008,Brazil,195765,1.21,22,183921,1.11,25,379686,1.16,23,-11844,-31705,-62.64
2008,Poland,170458,1.05,29,208804,1.26,20,379262,1.16,24,38346,25564,50.0
2008,Austria,181289,1.12,26,184293,1.11,24,365582,1.12,25,3004,-583,-615.27
2008,Thailand,177778,1.1,27,179225,1.08,26,357003,1.09,26,1447,-13901,-110.41
2008,Malaysia,199414,1.23,21,156348,0.95,28,355762,1.09,27,-43066,-29796,44.54
2008,Sweden,183327,1.13,25,168503,1.02,27,351830,1.07,28,-14824,-15591,-4.92
2008,Türkiye,132027,0.82,32,201964,1.22,21,333991,1.02,29,69937,62791,11.38
2008,Czech Republic,146799,0.91,30,142038,0.86,29,288837,0.88,30,-4761,-4329,9.98
2008,Indonesia,139606,0.86,31,127538,0.77,30,267144,0.82,31,-12068,-24912,-51.56
2008,Norway,171764,1.06,28,90293,0.55,38,262057,0.8,32,-81471,-56057,45.34
2008,Denmark,116923,0.72,34,109362,0.66,32,226285,0.69,33,-7561,-5144,46.99
2008,Hungary,108504,0.67,36,108940,0.66,33,217444,0.66,34,436,165,164.24
2008,Ireland,125719,0.78,33,83965,0.51,41,209684,0.64,35,-41754,-37721,10.69
2008,Finland,96455,0.6,37,91781,0.55,37,188236,0.58,36,-4674,-8321,-43.83
2008,South Africa,80782,0.5,41,101640,0.61,34,182422,0.56,37,20858,18666,11.74
2008,Iran,113668,0.7,35,57401,0.35,48,171069,0.52,38,-56267,-43791,28.49
2008,Ukraine,66954,0.41,47,85535,0.52,39,152489,0.47,39,18581,11322,64.11
2008,Portugal,57137,0.35,53,94416,0.57,36,151553,0.46,40,37279,29647,25.74
2008,"Venezuela, Bolivarian Republic of",95021,0.59,38,50450,0.3,49,145471,0.44,41,-44571,-23883,86.62
2008,Slovak Republic,71242,0.44,43,73979,0.45,43,145221,0.44,42,2737,2160,26.71
2008,Viet Nam,62685,0.39,51,80714,0.49,42,143399,0.44,43,18029,14121,27.68
2008,Nigeria,86274,0.53,40,49951,0.3,50,136225,0.42,44,-36323,-31776,14.31
2008,Romania,49535,0.31,54,84053,0.51,40,133588,0.41,45,34518,29826,15.73
2008,Greece,31281,0.19,61,96617,0.58,35,127898,0.39,46,65336,58295,12.08
2008,Argentina,70018,0.43,45,57462,0.35,47,127480,0.39,47,-12556,-11073,13.39
2008,Chile,64510,0.4,48,62787,0.38,45,127297,0.39,48,-1723,-20808,-91.72
2008,Israel,60825,0.38,52,64531,0.39,44,125356,0.38,49,3706,2013,84.1
2008,Algeria,79298,0.49,42,39479,0.24,55,118777,0.36,50,-39819,-32532,22.4
2008,"Kuwait, the State of",87457,0.54,39,24840,0.15,67,112297,0.34,51,-62617,-41329,51.51
2008,Philippines,49078,0.3,55,60420,0.37,46,109498,0.33,52,11342,7530,50.62
2008,Kazakhstan,71172,0.44,44,37889,0.23,57,109061,0.33,53,-33283,-14999,121.9
2008,Iraq,63726,0.39,50,35012,0.21,60,98738,0.3,54,-28714,-20031,43.35
2008,Qatar,67307,0.42,46,27900,0.17,66,95207,0.29,55,-39407,-18591,111.97
2008,Angola,63914,0.39,49,20982,0.13,72,84896,0.26,56,-42932,-30735,39.68
2008,Colombia,37626,0.23,58,39669,0.24,54,77295,0.24,57,2043,2906,-29.7
2008,Egypt,26224,0.16,65,48382,0.29,51,74606,0.23,58,22158,17876,23.95
2008,Belarus,32571,0.2,60,39381,0.24,56,71952,0.22,59,6810,4418,54.14
2008,Slovenia,34128,0.21,59,37034,0.22,58,71162,0.22,60,2906,1457,99.45
2008,New Zealand,30580,0.19,64,34369,0.21,61,64949,0.2,61,3789,3939,-3.81
2008,Morocco,20345,0.13,69,42366,0.26,52,62711,0.19,62,22021,16670,32.1
2008,Pakistan,20323,0.13,70,42329,0.26,53,62652,0.19,63,22006,14752,49.17
2008,Oman,37719,0.23,57,23137,0.14,71,60856,0.19,64,-14582,-8667,68.25
2008,Peru,30826,0.19,62,29953,0.18,65,60779,0.19,65,-873,-7850,-88.88
2008,Bulgaria,22362,0.14,68,36908,0.22,59,59270,0.18,66,14546,11443,27.12
2008,Luxembourg,25694,0.16,66,32157,0.19,62,57851,0.18,67,6463,5096,26.82
2008,Libya,47310,0.29,56,9721,0.06,93,57031,0.17,68,-37589,-27581,36.29
2008,Lithuania,23646,0.15,67,31099,0.19,63,54745,0.17,69,7453,7268,2.55
2008,Croatia,14112,0.09,78,30728,0.19,64,44840,0.14,70,16616,13277,25.15
2008,Tunisia,19320,0.12,71,24638,0.15,68,43958,0.13,71,5318,3934,35.18
2008,Bangladesh,15370,0.09,76,23860,0.14,70,39230,0.12,72,8490,6143,38.21
2008,Azerbaijan,30586,0.19,63,7574,0.05,103,38160,0.12,73,-23012,-15224,51.16
2008,Ecuador,18818,0.12,72,18852,0.11,73,37670,0.12,74,34,-428,-107.94
2008,Serbia,10972,0.07,82,24331,0.15,69,35303,0.11,75,13359,10339,29.21
2008,Syrian Arab Republic,15410,0.1,75,18105,0.11,74,33515,0.1,76,2695,3109,-13.32
2008,"Bahrain, Kingdom of",17316,0.11,74,14980,0.09,83,32296,0.1,77,-2336,-2146,8.85
2008,Estonia,12458,0.08,79,16026,0.1,78,28484,0.09,78,3568,4667,-23.55
2008,Trinidad and Tobago,18650,0.12,73,9591,0.06,94,28241,0.09,79,-9059,-5733,58.02
2008,Latvia,10144,0.06,86,16143,0.1,77,26287,0.08,80,5999,7014,-14.47
2008,Panama,9817,0.06,87,15737,0.1,80,25554,0.08,81,5920,4448,33.09
2008,Jordan,7938,0.05,92,16995,0.1,75,24933,0.08,82,9057,7956,13.84
2008,Costa Rica,9504,0.06,89,15372,0.09,82,24876,0.08,83,5868,3615,62.32
2008,Dominican Republic,6748,0.04,96,15993,0.1,79,22741,0.07,84,9245,6437,43.62
2008,Sri Lanka,8452,0.05,91,13953,0.08,85,22405,0.07,85,5501,3561,54.48
2008,Guatemala,7737,0.05,93,14547,0.09,84,22284,0.07,86,6810,6678,1.98
2008,Lebanese Republic,4454,0.03,112,16754,0.1,76,21208,0.06,87,12300,8677,41.75
2008,Sudan,11671,0.07,81,9352,0.06,95,21023,0.06,88,-2319,-104,2129.81
2008,Uzbekistan,10298,0.06,85,9277,0.06,96,19575,0.06,89,-1021,-1689,-39.55
2008,Cuba,3957,0.02,116,15373,0.09,81,19330,0.06,90,11416,6905,65.33
2008,Equatorial Guinea,15218,0.09,77,3787,0.02,128,19005,0.06,91,-11431,-7443,53.58
2008,Côte d'Ivoire,10390,0.06,83,7884,0.05,101,18274,0.06,92,-2506,-1986,26.18
2008,Yemen,7584,0.05,94,10546,0.06,89,18130,0.06,93,2962,2212,33.91
2008,Turkmenistan,11945,0.07,80,5600,0.03,112,17545,0.05,94,-6345,-5313,19.42
2008,Bosnia and Herzegovina,5021,0.03,107,12189,0.07,86,17210,0.05,95,7168,5568,28.74
2008,Honduras,6199,0.04,99,10453,0.06,90,16652,0.05,96,4254,3104,37.05
2008,Kenya,5001,0.03,108,11128,0.07,87,16129,0.05,97,6127,4908,24.84
2008,Ghana,5270,0.03,104,10269,0.06,91,15539,0.05,98,4999,3866,29.31
2008,Paraguay,6407,0.04,98,9033,0.05,98,15440,0.05,99,2626,1135,131.37
2008,Uruguay,5942,0.04,100,9069,0.05,97,15011,0.05,100,3127,1110,181.71
2008,El Salvador,4641,0.03,111,9818,0.06,92,14459,0.04,101,5177,4806,7.72
2008,Brunei Darussalam,10319,0.06,84,2572,0.02,142,12891,0.04,102,-7747,-5567,39.16
2008,Congo,9170,0.06,90,3540,0.02,134,12710,0.04,103,-5630,-2364,138.16
2008,Cyprus,1633,0.01,134,10644,0.06,88,12277,0.04,104,9011,7221,24.79
2008,Gabon,9566,0.06,88,2563,0.02,143,12129,0.04,105,-7003,-4152,68.67
2008,"Bolivia, Plurinational State of",6525,0.04,97,5081,0.03,116,11606,0.04,106,-1444,-918,57.3
2008,Iceland,5382,0.03,103,6205,0.04,108,11587,0.04,107,823,1955,-57.9
2008,"Aruba, Netherlands with respect to",5456,0.03,102,6011,0.04,109,11467,0.04,108,555,-80,-793.75
2008,Cambodia,4708,0.03,110,6508,0.04,106,11216,0.03,109,1800,1351,33.23
2008,Myanmar,6882,0.04,95,4256,0.03,125,11138,0.03,110,-2626,-3006,-12.64
2008,Cameroon,5241,0.03,105,5686,0.03,111,10927,0.03,111,445,427,4.22
2008,Jamaica,2439,0.02,123,8465,0.05,99,10904,0.03,112,6026,4639,29.9
2008,North Macedonia,3991,0.02,115,6883,0.04,104,10874,0.03,113,2892,1883,53.58
2008,Tanzania,3121,0.02,119,7703,0.05,102,10824,0.03,114,4582,3198,43.28
2008,Botswana,4951,0.03,109,5211,0.03,115,10162,0.03,115,260,-1107,-123.49
2008,Zambia,5099,0.03,106,5060,0.03,117,10159,0.03,116,-39,-610,-93.61
2008,Ethiopia,1602,0.01,135,8277,0.05,100,9879,0.03,117,6675,4532,47.29
2008,Papua New Guinea,5713,0.04,101,3117,0.02,139,8830,0.03,118,-2596,-2059,26.08
2008,Malta,3481,0.02,117,5300,0.03,114,8781,0.03,119,1819,1364,33.36
2008,Democratic Republic of the Congo,4400,0.03,113,4300,0.03,124,8700,0.03,120,-100,300,-133.33
2008,Senegal,2170,0.01,126,6528,0.04,105,8698,0.03,121,4358,3197,36.32
2008,"Macao, China",1997,0.01,129,5880,0.04,110,7877,0.02,122,3883,3502,10.88
2008,Georgia,1495,0.01,138,6302,0.04,107,7797,0.02,123,4807,3983,20.69
2008,Namibia,3141,0.02,118,4340,0.03,123,7481,0.02,124,1199,598,100.5
2008,Nicaragua,2531,0.02,122,4731,0.03,119,7262,0.02,125,2200,1803,22.02
2008,Mauritius,2384,0.01,124,4651,0.03,120,7035,0.02,126,2267,1656,36.9
2008,Mozambique,2653,0.02,120,4008,0.02,127,6661,0.02,127,1355,638,112.38
2008,Albania,1027,0.01,147,5575,0.03,113,6602,0.02,128,4548,3112,46.14
2008,"Moldova, Republic of",1591,0.01,136,4899,0.03,118,6490,0.02,129,3308,2348,40.89
2008,Uganda,1724,0.01,133,4526,0.03,121,6250,0.02,130,2802,2156,29.96
2008,Chad,4169,0.03,114,2000,0.01,150,6169,0.02,131,-2169,-1866,16.24
2008,Mongolia,2539,0.02,121,3616,0.02,131,6155,0.02,132,1077,228,372.37
2008,Kyrgyz Republic,1856,0.01,130,4072,0.02,126,5928,0.02,133,2216,1468,50.95
2008,"Korea, Democratic People's Republic of",2060,0.01,128,3580,0.02,133,5640,0.02,134,1520,1370,10.95
2008,Armenia,1057,0.01,146,4426,0.03,122,5483,0.02,135,3369,2116,59.22
2008,Mali,2097,0.01,127,3339,0.02,135,5436,0.02,136,1242,629,97.46
2008,Madagascar,1310,0.01,141,3781,0.02,129,5091,0.02,137,2471,1397,76.88
2008,Tajikistan,1409,0.01,139,3273,0.02,136,4682,0.01,138,1864,987,88.86
2008,New Caledonia,1300,0.01,142,3233,0.02,137,4533,0.01,139,1933,705,174.18
2008,Nepal,939,0.01,148,3590,0.02,132,4529,0.01,140,2651,2254,17.61
2008,Montenegro,617,0.0,157,3731,0.02,130,4348,0.01,141,3114,2241,38.96
2008,Netherlands Antilles,1088,0.01,145,3079,0.02,140,4167,0.01,142,1991,1873,6.3
2008,Zimbabwe,2200,0.01,125,1920,0.01,152,4120,0.01,143,-280,783,-135.76
2008,Bahamas,696,0.0,155,3201,0.02,138,3897,0.01,144,2505,2434,2.92
2008,Mauritania,1788,0.01,131,1941,0.01,151,3729,0.01,145,153,-22,-795.45
2008,Benin,1282,0.01,143,2289,0.01,145,3571,0.01,146,1007,990,1.72
2008,Afghanistan,540,0.0,158,3020,0.02,141,3560,0.01,147,2480,2568,-3.43
2008,Fiji,922,0.01,149,2264,0.01,146,3186,0.01,148,1342,1045,28.42
2008,Eswatini,1570,0.01,137,1580,0.01,156,3150,0.01,149,10,100,-90.0
2008,Suriname,1743,0.01,132,1304,0.01,162,3047,0.01,150,-439,-315,39.37
2008,Malawi,880,0.01,152,2033,0.01,148,2913,0.01,151,1153,505,128.32
2008,Haiti,480,0.0,162,2315,0.01,144,2795,0.01,152,1835,1160,58.19
2008,Burkina Faso,693,0.0,156,2018,0.01,149,2711,0.01,153,1325,1055,25.59
2008,Guinea,1342,0.01,140,1366,0.01,160,2708,0.01,154,24,15,60.0
2008,Lesotho,884,0.01,151,1800,0.01,154,2684,0.01,155,916,908,0.88
2008,Niger,910,0.01,150,1696,0.01,155,2606,0.01,156,786,555,41.62
2008,Lao People's Democratic Republic,1092,0.01,144,1403,0.01,158,2495,0.01,157,311,144,115.97
2008,Barbados,488,0.0,160,1920,0.01,152,2408,0.01,158,1432,1222,17.18
2008,French Polynesia,195,0.0,172,2169,0.01,147,2364,0.01,159,1974,1666,18.49
2008,Togo,853,0.01,153,1509,0.01,157,2362,0.01,160,656,560,17.14
2008,Guyana,795,0.0,154,1312,0.01,161,2107,0.01,161,517,380,36.05
2008,Maldives,331,0.0,166,1388,0.01,159,1719,0.01,162,1057,868,21.77
2008,Seychelles,430,0.0,164,1087,0.01,166,1517,0.0,163,657,499,31.66
2008,Rwanda,268,0.0,167,1174,0.01,163,1442,0.0,164,906,594,52.53
2008,Greenland,487,0.0,161,895,0.01,167,1382,0.0,165,408,326,25.15
2008,Belize,469,0.0,163,837,0.01,168,1306,0.0,166,368,268,37.31
2008,Bermuda,24,0.0,190,1159,0.01,164,1183,0.0,167,1135,1140,-0.44
2008,Cayman Islands,33,0.0,186,1130,0.01,165,1163,0.0,168,1097,1032,6.3
2008,Bhutan,521,0.0,159,543,0.0,177,1064,0.0,169,22,-149,-114.77
2008,Liberia,242,0.0,168,813,0.0,171,1055,0.0,170,571,299,90.97
2008,Somalia,211,0.0,170,833,0.01,169,1044,0.0,171,622,341,82.4
2008,American Samoa,337,0.0,165,568,0.0,176,905,0.0,172,231,129,79.07
2008,Cabo Verde,32,0.0,187,825,0.0,170,857,0.0,173,793,731,8.48
2008,Saint Lucia,164,0.0,173,656,0.0,173,820,0.0,174,492,516,-4.65
2008,Antigua and Barbuda,65,0.0,180,743,0.0,172,808,0.0,175,678,669,1.35
2008,Sierra Leone,216,0.0,169,534,0.0,178,750,0.0,176,318,200,59.0
2008,Guinea-Bissau,128,0.0,175,516,0.0,179,644,0.0,177,388,300,29.33
2008,Djibouti,69,0.0,179,574,0.0,175,643,0.0,178,505,415,21.69
2008,Eritrea,11,0.0,194,600,0.0,174,611,0.0,179,589,497,18.51
2008,Solomon Islands,210,0.0,171,328,0.0,184,538,0.0,180,118,129,-8.53
2008,Northern Mariana Islands,115,0.0,176,356,0.0,183,471,0.0,181,241,110,119.09
2008,Burundi,57,0.0,181,403,0.0,180,460,0.0,182,346,260,33.08
2008,Central African Republic,150,0.0,174,300,0.0,188,450,0.0,183,150,71,111.27
2008,Saint Vincent and the Grenadines,52,0.0,183,373,0.0,181,425,0.0,184,321,279,15.05
2008,Grenada,31,0.0,188,363,0.0,182,394,0.0,185,332,332,0.0
2008,Saint Kitts and Nevis,51,0.0,184,325,0.0,185,376,0.0,186,274,238,15.13
2008,Vanuatu,57,0.0,181,314,0.0,187,371,0.0,187,257,179,43.58
2008,Samoa,72,0.0,178,288,0.0,189,360,0.0,188,216,169,27.81
2008,The Gambia,14,0.0,192,322,0.0,186,336,0.0,189,308,308,0.0
2008,Dominica,40,0.0,185,247,0.0,191,287,0.0,190,207,159,30.19
2008,Timor-Leste,13,0.0,193,269,0.0,190,282,0.0,191,256,175,46.29
2008,Comoros,7,0.0,200,180,0.0,192,187,0.0,192,173,124,39.52
2008,"Micronesia, Federated States of",27,0.0,189,155,0.0,194,182,0.0,193,128,120,6.67
2008,Tonga,9,0.0,198,168,0.0,193,177,0.0,194,159,135,17.78
2008,Palau,10,0.0,196,130,0.0,195,140,0.0,195,120,105,14.29
2008,Sao Tomé and Principe,11,0.0,194,114,0.0,196,125,0.0,196,103,72,43.06
2008,Marshall Islands,20,0.0,191,100,0.0,199,120,0.0,197,80,82,-2.44
2008,Cook Islands,4,0.0,201,111,0.0,197,115,0.0,198,107,102,4.9
2008,Saint Pierre and Miquelon,10,0.0,196,102,0.0,198,112,0.0,199,92,76,21.05
2008,Guam,105,0.0,177,0,0.0,204,105,0.0,200,-105,-91,15.38
2008,Kiribati,8,0.0,199,75,0.0,200,83,0.0,201,67,60,11.67
2008,Montserrat,4,0.0,201,38,0.0,201,42,0.0,202,34,27,25.93
2008,Tuvalu,0,0.0,203,26,0.0,202,26,0.0,203,26,16,62.5
2008,Niue,0,0.0,203,8,0.0,203,8,0.0,204,8,4,100.0
2007,United States of America,1148199,8.18,3,2020403,14.13,1,3168602,11.18,1,872204,892110,-2.23
2007,Germany,1321214,9.41,1,1054983,7.38,2,2376197,8.39,2,-266231,-201423,32.18
2007,China,1220456,8.69,2,956116,6.69,3,2176572,7.68,3,-264340,-177517,48.91
2007,Japan,714327,5.09,4,622243,4.35,6,1336570,4.72,4,-92084,-67661,36.1
2007,France,559612,3.99,5,630861,4.41,5,1190473,4.2,5,71249,46051,54.72
2007,United Kingdom,446805,3.18,8,644565,4.51,4,1091370,3.85,6,197760,161948,22.11
2007,Netherlands,550755,3.92,6,492616,3.45,8,1043371,3.68,7,-58139,-46797,24.24
2007,Italy,499882,3.56,7,511662,3.58,7,1011544,3.57,8,11780,25680,-54.13
2007,Belgium,430952,3.07,9,411558,2.88,9,842510,2.97,9,-19394,-15110,28.35
2007,Canada,420693,3.0,10,390188,2.73,10,810881,2.86,10,-30505,-29178,4.55
2007,"Korea, Republic of",371489,2.65,11,356846,2.5,13,728335,2.57,11,-14643,-16082,-8.95
2007,"Hong Kong, China",349386,2.49,13,370132,2.59,12,719518,2.54,12,20746,13085,58.55
2007,Spain,253297,1.8,16,389301,2.72,11,642598,2.27,13,136004,114979,18.29
2007,Russian Federation,354403,2.52,12,223486,1.56,17,577889,2.04,14,-130917,-139270,-6.0
2007,Singapore,299308,2.13,14,263155,1.84,15,562463,1.99,15,-36153,-33097,9.23
2007,Mexico,271821,1.94,15,290246,2.03,14,562067,1.98,16,18425,13515,36.33
2007,Chinese Taipei,246677,1.76,17,219252,1.53,18,465929,1.64,17,-27425,-21319,28.64
2007,Switzerland,196482,1.4,19,189181,1.32,19,385663,1.36,18,-7301,-2403,203.83
2007,India,150159,1.07,26,229370,1.6,16,379529,1.34,19,79211,56602,39.94
2007,United Arab Emirates,178630,1.27,20,150123,1.05,25,328753,1.16,20,-28507,-45530,-37.39
2007,Austria,163620,1.17,23,163037,1.14,23,326657,1.15,21,-583,461,-226.46
2007,"Saudi Arabia, Kingdom of",233329,1.66,18,90214,0.63,33,323543,1.14,22,-143115,-141505,1.14
2007,Malaysia,175966,1.25,21,146170,1.02,26,322136,1.14,23,-29796,-30308,-1.69
2007,Sweden,168817,1.2,22,153226,1.07,24,322043,1.14,24,-15591,-20246,-22.99
2007,Australia,141358,1.01,27,165336,1.16,22,306694,1.08,25,23978,15816,51.61
2007,Poland,140146,1.0,28,165710,1.16,21,305856,1.08,26,25564,16209,57.71
2007,Thailand,153867,1.1,25,139966,0.98,27,293833,1.04,27,-13901,-949,1364.81
2007,Brazil,159816,1.14,24,128111,0.9,28,287927,1.02,28,-31705,-40532,-21.78
2007,Türkiye,107272,0.76,33,170063,1.19,20,277335,0.98,29,62791,54041,16.19
2007,Czech Republic,122498,0.87,30,118169,0.83,29,240667,0.85,30,-4329,-1738,149.08
2007,Norway,136354,0.97,29,80297,0.56,39,216651,0.76,31,-56057,-57947,-3.26
2007,Indonesia,118013,0.84,32,93101,0.65,32,211114,0.75,32,-24912,-22877,8.9
2007,Ireland,121543,0.87,31,83822,0.59,36,205365,0.72,33,-37721,-35608,5.93
2007,Denmark,103171,0.73,34,98027,0.69,30,201198,0.71,34,-5144,-7051,-27.05
2007,Hungary,95400,0.68,35,95565,0.67,31,190965,0.67,35,165,3007,-94.51
2007,Finland,90025,0.64,36,81704,0.57,38,171729,0.61,36,-8321,-7831,6.26
2007,South Africa,69784,0.5,39,88450,0.62,34,158234,0.56,37,18666,20540,-9.12
2007,Portugal,52482,0.37,47,82129,0.57,37,134611,0.48,38,29647,25934,14.32
2007,Iran,88733,0.63,37,44942,0.31,48,133675,0.47,39,-43791,-36240,20.84
2007,Slovak Republic,58671,0.42,44,60831,0.43,42,119502,0.42,40,2160,3135,-31.1
2007,"Venezuela, Bolivarian Republic of",69980,0.5,38,46097,0.32,47,116077,0.41,41,-23883,-31962,-25.28
2007,Chile,67972,0.48,40,47164,0.33,46,115136,0.41,42,-20808,-20274,2.63
2007,Greece,26558,0.19,61,84853,0.59,35,111411,0.39,43,58295,45763,27.38
2007,Viet Nam,48561,0.35,50,62682,0.44,41,111243,0.39,44,14121,5189,172.13
2007,Romania,40488,0.29,54,70314,0.49,40,110802,0.39,45,29826,18702,59.48
2007,Israel,54092,0.39,46,56105,0.39,45,110197,0.39,46,2013,529,280.53
2007,Ukraine,49296,0.35,49,60618,0.42,43,109914,0.39,47,11322,6671,69.72
2007,Philippines,50466,0.36,48,57996,0.41,44,108462,0.38,48,7530,6668,12.93
2007,Nigeria,66606,0.47,41,34830,0.24,51,101436,0.36,49,-31776,-32203,-1.33
2007,Argentina,55779,0.4,45,44706,0.31,49,100485,0.35,50,-11073,-12394,-10.66
2007,Algeria,60163,0.43,43,27631,0.19,61,87794,0.31,51,-32532,-33157,-1.88
2007,"Kuwait, the State of",62691,0.45,42,21362,0.15,65,84053,0.3,52,-41329,-38773,6.59
2007,Kazakhstan,47755,0.34,51,32756,0.23,53,80511,0.28,53,-14999,-14573,2.92
2007,Qatar,42020,0.3,53,23429,0.16,64,65449,0.23,54,-18591,-17611,5.56
2007,Colombia,29991,0.21,58,32897,0.23,52,62888,0.22,55,2906,1771,64.09
2007,Slovenia,30102,0.21,57,31559,0.22,56,61661,0.22,56,1457,911,59.93
2007,Iraq,39587,0.28,55,19556,0.14,67,59143,0.21,57,-20031,-8520,135.11
2007,Angola,44396,0.32,52,13661,0.1,77,58057,0.2,58,-30735,-23084,33.14
2007,New Zealand,26943,0.19,60,30882,0.22,57,57825,0.2,59,3939,4015,-1.89
2007,Egypt,19224,0.14,66,37100,0.26,50,56324,0.2,60,17876,10572,69.09
2007,Belarus,24275,0.17,63,28693,0.2,59,52968,0.19,61,4418,2617,68.82
2007,Luxembourg,22933,0.16,64,28029,0.2,60,50962,0.18,62,5096,4165,22.35
2007,Pakistan,17838,0.13,68,32590,0.23,54,50428,0.18,63,14752,12895,14.4
2007,Peru,28218,0.2,59,20368,0.14,66,48586,0.17,64,-7850,-8552,-8.21
2007,Bulgaria,18518,0.13,67,29961,0.21,58,48479,0.17,65,11443,8206,39.45
2007,Morocco,15340,0.11,70,32010,0.22,55,47350,0.17,66,16670,11236,48.36
2007,Libya,34778,0.25,56,7197,0.05,95,41975,0.15,67,-27581,-23758,16.09
2007,Lithuania,17144,0.12,69,24412,0.17,63,41556,0.15,68,7268,5231,38.94
2007,Oman,24692,0.18,62,16025,0.11,71,40717,0.14,69,-8667,-10546,-17.82
2007,Croatia,12340,0.09,76,25617,0.18,62,37957,0.13,70,13277,11116,19.44
2007,Tunisia,15165,0.11,71,19099,0.13,69,34264,0.12,71,3934,3313,18.74
2007,Bangladesh,12453,0.09,75,18596,0.13,70,31049,0.11,72,6143,4232,45.16
2007,Ecuador,14321,0.1,72,13893,0.1,75,28214,0.1,73,-428,-614,-30.29
2007,Serbia,8825,0.06,83,19164,0.13,68,27989,0.1,74,10339,6744,53.31
2007,Azerbaijan,21269,0.15,65,6045,0.04,100,27314,0.1,75,-15224,-7746,96.54
2007,Estonia,11010,0.08,78,15677,0.11,72,26687,0.09,76,4667,3757,24.22
2007,Syrian Arab Republic,11546,0.08,77,14655,0.1,74,26201,0.09,77,3109,569,446.4
2007,"Bahrain, Kingdom of",13634,0.1,73,11488,0.08,83,25122,0.09,78,-2146,-1685,27.36
2007,Latvia,8308,0.06,86,15322,0.11,73,23630,0.08,79,7014,5386,30.23
2007,Costa Rica,9337,0.07,80,12952,0.09,81,22289,0.08,80,3615,3348,7.97
2007,Panama,8821,0.06,84,13269,0.09,80,22090,0.08,81,4448,2741,62.28
2007,Trinidad and Tobago,13396,0.1,74,7663,0.05,94,21059,0.07,82,-5733,-7671,-25.26
2007,Dominican Republic,7160,0.05,90,13597,0.1,78,20757,0.07,83,6437,5564,15.69
2007,Guatemala,6898,0.05,91,13576,0.09,79,20474,0.07,84,6678,5890,13.38
2007,Jordan,5725,0.04,97,13681,0.1,76,19406,0.07,85,7956,6344,25.41
2007,Sri Lanka,7740,0.06,88,11301,0.08,84,19041,0.07,86,3561,3372,5.6
2007,Sudan,8879,0.06,82,8775,0.06,90,17654,0.06,87,-104,2417,-104.3
2007,Lebanese Republic,3574,0.03,114,12251,0.09,82,15825,0.06,88,8677,6833,26.99
2007,Côte d'Ivoire,8669,0.06,85,6683,0.05,98,15352,0.05,89,-1986,-2657,-25.25
2007,Cuba,3981,0.03,112,10886,0.08,85,14867,0.05,90,6905,7099,-2.73
2007,Yemen,6299,0.04,93,8511,0.06,92,14810,0.05,91,2212,-580,-481.38
2007,Honduras,5784,0.04,96,8888,0.06,88,14672,0.05,92,3104,2026,53.21
2007,Uzbekistan,8029,0.06,87,6340,0.04,99,14369,0.05,93,-1689,-1237,36.54
2007,Bosnia and Herzegovina,4152,0.03,108,9720,0.07,86,13872,0.05,94,5568,4022,38.44
2007,Kenya,4081,0.03,110,8989,0.06,87,13070,0.05,95,4908,3731,31.55
2007,Equatorial Guinea,10210,0.07,79,2767,0.02,136,12977,0.05,96,-7443,-6187,20.3
2007,El Salvador,4015,0.03,111,8821,0.06,89,12836,0.05,97,4806,3957,21.46
2007,Turkmenistan,8932,0.06,81,3619,0.03,120,12551,0.04,98,-5313,-4596,15.6
2007,Ghana,4195,0.03,107,8061,0.06,93,12256,0.04,99,3866,3027,27.72
2007,Iceland,4783,0.03,100,6738,0.05,97,11521,0.04,100,1955,2684,-27.16
2007,Paraguay,4724,0.03,101,5859,0.04,102,10583,0.04,101,1135,1272,-10.77
2007,"Aruba, Netherlands with respect to",5206,0.04,98,5126,0.04,109,10332,0.04,102,-80,7,-1242.86
2007,Congo,6293,0.04,94,3929,0.03,117,10222,0.04,103,-2364,-4065,-41.85
2007,Uruguay,4518,0.03,104,5628,0.04,104,10146,0.04,104,1110,817,35.86
2007,Cyprus,1394,0.01,134,8615,0.06,91,10009,0.04,105,7221,5595,29.06
2007,Brunei Darussalam,7668,0.05,89,2101,0.01,144,9769,0.03,106,-5567,-5960,-6.59
2007,Cambodia,4088,0.03,109,5439,0.04,105,9527,0.03,107,1351,1079,25.21
2007,Myanmar,6253,0.04,95,3247,0.02,126,9500,0.03,108,-3006,-2001,50.22
2007,Botswana,5174,0.04,99,4067,0.03,114,9241,0.03,109,-1107,-1443,-23.28
2007,Jamaica,2254,0.02,122,6893,0.05,96,9147,0.03,110,4639,3702,25.31
2007,Cameroon,4230,0.03,106,4657,0.03,112,8887,0.03,111,427,-426,-200.23
2007,North Macedonia,3398,0.02,116,5281,0.04,107,8679,0.03,112,1883,1362,38.25
2007,Zambia,4617,0.03,103,4007,0.03,115,8624,0.03,113,-610,-696,-12.36
2007,"Macao, China",2543,0.02,119,6045,0.04,100,8588,0.03,114,3502,2679,30.72
2007,Gabon,6309,0.04,92,2157,0.02,142,8466,0.03,115,-4152,-3725,11.46
2007,Malta,3437,0.02,115,4801,0.03,111,8238,0.03,116,1364,1511,-9.73
2007,"Bolivia, Plurinational State of",4504,0.03,105,3586,0.03,121,8090,0.03,117,-918,-1036,-11.39
2007,Tanzania,2139,0.02,125,5337,0.04,106,7476,0.03,118,3198,2381,34.31
2007,Papua New Guinea,4681,0.03,102,2622,0.02,138,7303,0.03,119,-2059,-2182,-5.64
2007,Ethiopia,1277,0.01,139,5809,0.04,103,7086,0.03,120,4532,4164,8.84
2007,Senegal,1674,0.01,130,4871,0.03,110,6545,0.02,121,3197,2077,53.92
2007,Democratic Republic of the Congo,3100,0.02,117,3400,0.02,124,6500,0.02,122,300,187,60.43
2007,Georgia,1232,0.01,141,5215,0.04,108,6447,0.02,123,3983,2742,45.26
2007,Namibia,2922,0.02,118,3520,0.02,122,6442,0.02,124,598,237,152.32
2007,Nicaragua,2186,0.02,124,3989,0.03,116,6175,0.02,125,1803,1472,22.49
2007,Mauritius,2238,0.02,123,3894,0.03,118,6132,0.02,126,1656,1298,27.58
2007,Zimbabwe,2400,0.02,121,3183,0.02,127,5583,0.02,127,783,127,516.54
2007,Chad,3666,0.03,113,1800,0.01,148,5466,0.02,128,-1866,-2002,-6.79
2007,Mozambique,2412,0.02,120,3050,0.02,131,5462,0.02,129,638,488,30.74
2007,Albania,1079,0.01,144,4191,0.03,113,5270,0.02,130,3112,2270,37.09
2007,"Moldova, Republic of",1342,0.01,136,3690,0.03,119,5032,0.02,131,2348,1641,43.08
2007,New Caledonia,2104,0.01,126,2809,0.02,134,4913,0.02,132,705,765,-7.84
2007,Uganda,1337,0.01,137,3493,0.02,123,4830,0.02,133,2156,1595,35.17
2007,"Korea, Democratic People's Republic of",1685,0.01,129,3055,0.02,130,4740,0.02,134,1370,1415,-3.18
2007,Armenia,1152,0.01,143,3268,0.02,125,4420,0.02,135,2116,1207,75.31
2007,Kyrgyz Republic,1321,0.01,138,2789,0.02,135,4110,0.01,136,1468,1040,41.15
2007,Mongolia,1889,0.01,127,2117,0.01,143,4006,0.01,137,228,-57,-500.0
2007,Nepal,868,0.01,148,3122,0.02,128,3990,0.01,138,2254,1654,36.28
2007,Tajikistan,1468,0.01,132,2455,0.02,140,3923,0.01,139,987,324,204.63
2007,Madagascar,1238,0.01,140,2635,0.02,137,3873,0.01,140,1397,819,70.57
2007,Bahamas,670,0.0,155,3104,0.02,129,3774,0.01,141,2434,2437,-0.12
2007,Mali,1556,0.01,131,2185,0.02,141,3741,0.01,142,629,270,132.96
2007,Eswatini,1740,0.01,128,1840,0.01,147,3580,0.01,143,100,250,-60.0
2007,Montenegro,626,0.0,157,2867,0.02,133,3493,0.01,144,2241,1286,74.26
2007,Afghanistan,454,0.0,161,3022,0.02,132,3476,0.01,145,2568,2328,10.31
2007,Netherlands Antilles,676,0.0,153,2549,0.02,139,3225,0.01,146,1873,1514,23.71
2007,Benin,1047,0.01,145,2037,0.01,145,3084,0.01,147,990,492,101.22
2007,Mauritania,1454,0.01,133,1432,0.01,154,2886,0.01,148,-22,-200,-89.0
2007,Lesotho,830,0.01,149,1738,0.01,151,2568,0.01,149,908,782,16.11
2007,Fiji,755,0.01,150,1800,0.01,148,2555,0.01,150,1045,1110,-5.86
2007,Guinea,1203,0.01,142,1218,0.01,157,2421,0.01,151,15,-77,-119.48
2007,Suriname,1359,0.01,135,1044,0.01,164,2403,0.01,152,-315,-162,94.44
2007,Burkina Faso,623,0.0,158,1678,0.01,153,2301,0.01,153,1055,731,44.32
2007,Barbados,524,0.0,159,1746,0.01,150,2270,0.01,154,1222,1187,2.95
2007,Malawi,877,0.01,147,1382,0.01,155,2259,0.01,155,505,597,-15.41
2007,Haiti,522,0.0,160,1682,0.01,152,2204,0.01,156,1160,1110,4.5
2007,French Polynesia,197,0.0,170,1863,0.01,146,2060,0.01,157,1666,1421,17.24
2007,Lao People's Democratic Republic,923,0.01,146,1067,0.01,161,1990,0.01,158,144,178,-19.1
2007,Togo,677,0.0,152,1237,0.01,156,1914,0.01,159,560,455,23.08
2007,Niger,663,0.0,156,1218,0.01,157,1881,0.01,160,555,489,13.5
2007,Guyana,679,0.0,151,1059,0.01,162,1738,0.01,161,380,301,26.25
2007,Maldives,228,0.0,168,1096,0.01,160,1324,0.0,162,868,702,23.65
2007,Seychelles,360,0.0,164,859,0.01,165,1219,0.0,163,499,377,32.36
2007,Bhutan,675,0.0,154,526,0.0,172,1201,0.0,164,-149,6,-2583.33
2007,Bermuda,27,0.0,187,1167,0.01,159,1194,0.0,165,1140,1067,6.84
2007,Greenland,431,0.0,162,757,0.01,167,1188,0.0,166,326,264,23.48
2007,Belize,416,0.0,163,684,0.0,170,1100,0.0,167,268,241,11.2
2007,Cayman Islands,22,0.0,188,1054,0.01,163,1076,0.0,168,1032,1031,0.1
2007,Rwanda,177,0.0,173,771,0.01,166,948,0.0,169,594,444,33.78
2007,American Samoa,331,0.0,165,460,0.0,177,791,0.0,170,129,127,1.57
2007,Antigua and Barbuda,59,0.0,179,728,0.01,169,787,0.0,171,669,550,21.64
2007,Cabo Verde,19,0.0,190,750,0.01,168,769,0.0,172,731,521,40.31
2007,Northern Mariana Islands,329,0.0,166,439,0.0,179,768,0.0,173,110,31,254.84
2007,Saint Lucia,98,0.0,176,614,0.0,171,712,0.0,174,516,498,3.61
2007,Somalia,182,0.0,171,523,0.0,173,705,0.0,175,341,177,92.66
2007,Liberia,200,0.0,169,499,0.0,175,699,0.0,176,299,309,-3.24
2007,Sierra Leone,245,0.0,167,445,0.0,178,690,0.0,177,200,158,26.58
2007,Djibouti,58,0.0,181,473,0.0,176,531,0.0,178,415,281,47.69
2007,Eritrea,13,0.0,193,510,0.0,174,523,0.0,179,497,483,2.9
2007,Guinea-Bissau,107,0.0,175,407,0.0,180,514,0.0,180,300,208,44.23
2007,Solomon Islands,165,0.0,174,294,0.0,185,459,0.0,181,129,96,34.38
2007,Central African Republic,178,0.0,172,249,0.0,188,427,0.0,182,71,45,57.78
2007,Grenada,33,0.0,186,365,0.0,181,398,0.0,183,332,274,21.17
2007,Burundi,59,0.0,179,319,0.0,184,378,0.0,184,260,373,-30.29
2007,Saint Vincent and the Grenadines,48,0.0,183,327,0.0,182,375,0.0,185,279,233,19.74
2007,Samoa,97,0.0,177,266,0.0,187,363,0.0,186,169,210,-19.52
2007,The Gambia,13,0.0,193,321,0.0,183,334,0.0,187,308,248,24.19
2007,Saint Kitts and Nevis,34,0.0,185,272,0.0,186,306,0.0,188,238,210,13.33
2007,Vanuatu,50,0.0,182,229,0.0,189,279,0.0,189,179,168,6.55
2007,Dominica,37,0.0,184,196,0.0,190,233,0.0,190,159,126,26.19
2007,Timor-Leste,8,0.0,197,183,0.0,191,191,0.0,191,175,93,88.17
2007,"Micronesia, Federated States of",22,0.0,188,142,0.0,193,164,0.0,192,120,119,0.84
2007,Comoros,14,0.0,192,138,0.0,194,152,0.0,193,124,105,18.1
2007,Tonga,8,0.0,197,143,0.0,192,151,0.0,194,135,106,27.36
2007,Palau,11,0.0,195,116,0.0,195,127,0.0,195,105,101,3.96
2007,Marshall Islands,18,0.0,191,100,0.0,197,118,0.0,196,82,73,12.33
2007,Cook Islands,5,0.0,201,107,0.0,196,112,0.0,197,102,97,5.15
2007,Saint Pierre and Miquelon,8,0.0,197,84,0.0,198,92,0.0,198,76,64,18.75
2007,Guam,91,0.0,178,0,0.0,204,91,0.0,199,-91,-53,71.7
2007,Sao Tomé and Principe,7,0.0,200,79,0.0,199,86,0.0,200,72,63,14.29
2007,Kiribati,10,0.0,196,70,0.0,200,80,0.0,201,60,56,7.14
2007,Montserrat,3,0.0,202,30,0.0,201,33,0.0,202,27,29,-6.9
2007,Tuvalu,0,0.0,204,16,0.0,202,16,0.0,203,16,13,23.08
2007,Niue,3,0.0,202,7,0.0,203,10,0.0,204,4,3,33.33
2006,United States of America,1025967,8.45,2,1918077,15.48,1,2944044,12.0,1,892110,831624,7.27
2006,Germany,1108107,9.13,1,906684,7.32,2,2014791,8.21,2,-201423,-193841,3.91
2006,China,968978,7.98,3,791461,6.39,3,1760439,7.18,3,-177517,-102000,74.04
2006,Japan,646725,5.33,4,579064,4.67,5,1225789,5.0,4,-67661,-79075,-14.43
2006,United Kingdom,453735,3.74,7,615683,4.97,4,1069418,4.36,5,161948,128461,26.07
2006,France,495868,4.08,5,541919,4.37,6,1037787,4.23,6,46051,40696,13.16
2006,Netherlands,463629,3.82,6,416832,3.36,8,880461,3.59,7,-46797,-42550,9.98
2006,Italy,416875,3.43,8,442555,3.57,7,859430,3.5,8,25680,11655,120.33
2006,Canada,388178,3.2,9,359000,2.9,9,747178,3.05,9,-29178,-38064,-23.34
2006,Belgium,366745,3.02,10,351635,2.84,10,718380,2.93,10,-15110,-15700,-3.76
2006,"Hong Kong, China",322669,2.66,12,335754,2.71,11,658423,2.68,11,13085,8041,62.73
2006,"Korea, Republic of",325465,2.68,11,309383,2.5,13,634848,2.59,12,-16082,-23181,-30.62
2006,Spain,213717,1.76,17,328696,2.65,12,542413,2.21,13,114979,96142,19.59
2006,Mexico,249961,2.06,15,263476,2.13,14,513437,2.09,14,13515,14033,-3.69
2006,Singapore,271807,2.24,14,238710,1.93,15,510517,2.08,15,-33097,-29602,11.81
2006,Russian Federation,303551,2.5,13,164281,1.33,18,467832,1.91,16,-139270,-118364,17.66
2006,Chinese Taipei,224017,1.85,16,202698,1.64,16,426715,1.74,17,-21319,-15818,34.78
2006,Switzerland,166455,1.37,19,164052,1.32,19,330507,1.35,18,-2403,-2761,-12.97
2006,India,121808,1.0,28,178410,1.44,17,300218,1.22,19,56602,43254,30.86
2006,Malaysia,160749,1.32,20,130441,1.05,23,291190,1.19,20,-30308,-27302,11.01
2006,"Saudi Arabia, Kingdom of",211305,1.74,18,69800,0.56,36,281105,1.15,21,-141505,-121252,16.7
2006,Sweden,147793,1.22,21,127547,1.03,25,275340,1.12,22,-20246,-19265,5.09
2006,Austria,136751,1.13,24,137212,1.11,22,273963,1.12,23,461,2145,-78.51
2006,Australia,123437,1.02,26,139253,1.12,21,262690,1.07,24,15816,19184,-17.56
2006,Thailand,129722,1.07,25,128773,1.04,24,258495,1.05,25,-949,7242,-113.1
2006,United Arab Emirates,145587,1.2,22,100057,0.81,27,245644,1.0,26,-45530,-32633,39.52
2006,Poland,110780,0.91,29,126989,1.02,26,237769,0.97,27,16209,12202,32.84
2006,Brazil,137581,1.13,23,97049,0.78,28,234630,0.96,28,-40532,-40901,-0.9
2006,Türkiye,85535,0.7,34,139576,1.13,20,225111,0.92,29,54041,43298,24.81
2006,Czech Republic,94929,0.78,32,93191,0.75,29,188120,0.77,30,-1738,-1598,8.76
2006,Norway,122208,1.01,27,64261,0.52,39,186469,0.76,31,-57947,-48271,20.05
2006,Indonesia,103527,0.85,31,80650,0.65,31,184177,0.75,32,-22877,-11271,102.97
2006,Ireland,108726,0.9,30,73118,0.59,34,181844,0.74,33,-35608,-41092,-13.35
2006,Denmark,92558,0.76,33,85507,0.69,30,178065,0.73,34,-7051,-9540,-26.09
2006,Hungary,75255,0.62,37,78262,0.63,33,153517,0.63,35,3007,3616,-16.84
2006,Finland,77206,0.64,35,69375,0.56,37,146581,0.6,36,-7831,-6732,16.33
2006,South Africa,58175,0.48,41,78715,0.64,32,136890,0.56,37,20540,10678,92.36
2006,Iran,77012,0.63,36,40772,0.33,46,117784,0.48,38,-36240,-16211,123.55
2006,Portugal,44750,0.37,47,70684,0.57,35,115434,0.47,39,25934,25183,2.98
2006,Philippines,47410,0.39,44,54078,0.44,40,101488,0.41,40,6668,8232,-19.0
2006,"Venezuela, Bolivarian Republic of",65578,0.54,38,33616,0.27,49,99194,0.4,41,-31962,-31689,0.86
2006,Chile,58680,0.48,40,38406,0.31,47,97086,0.4,42,-20274,-8532,137.62
2006,Israel,46789,0.39,45,47318,0.38,42,94107,0.38,43,529,2174,-75.67
2006,Greece,21533,0.18,63,67296,0.54,38,88829,0.36,44,45763,39293,16.47
2006,Slovak Republic,41967,0.35,48,45102,0.36,43,87069,0.35,45,3135,2736,14.58
2006,Nigeria,58726,0.48,39,26523,0.21,53,85249,0.35,46,-32203,-29713,8.38
2006,Viet Nam,39826,0.33,49,45015,0.36,45,84841,0.35,47,5189,4319,20.14
2006,Romania,32458,0.27,53,51160,0.41,41,83618,0.34,48,18702,12830,45.77
2006,Ukraine,38368,0.32,50,45039,0.36,44,83407,0.34,49,6671,1908,249.63
2006,Argentina,46546,0.38,46,34152,0.28,48,80698,0.33,50,-12394,-11662,6.28
2006,Algeria,54613,0.45,43,21456,0.17,63,76069,0.31,51,-33157,-25645,29.29
2006,"Kuwait, the State of",56016,0.46,42,17243,0.14,65,73259,0.3,52,-38773,-29068,33.39
2006,Kazakhstan,38250,0.32,51,23677,0.19,58,61927,0.25,53,-14573,-10496,38.84
2006,Iraq,30529,0.25,55,22009,0.18,61,52538,0.21,54,-8520,-165,5063.64
2006,Colombia,24391,0.2,57,26162,0.21,55,50553,0.21,55,1771,14,12550.0
2006,Qatar,34051,0.28,52,16440,0.13,66,50491,0.21,56,-17611,-15701,12.16
2006,Luxembourg,22980,0.19,60,27145,0.22,52,50125,0.2,57,4165,3487,19.44
2006,New Zealand,22409,0.18,61,26424,0.21,54,48833,0.2,58,4015,4489,-10.56
2006,Slovenia,23230,0.19,59,24141,0.19,56,47371,0.19,59,911,1089,-16.35
2006,Pakistan,16930,0.14,65,29825,0.24,50,46755,0.19,60,12895,9306,38.57
2006,Egypt,16728,0.14,66,27300,0.22,51,44028,0.18,61,10572,9537,10.85
2006,Belarus,19734,0.16,64,22351,0.18,60,42085,0.17,62,2617,729,258.98
2006,Angola,31862,0.26,54,8778,0.07,85,40640,0.17,63,-23084,-15756,46.51
2006,Peru,23864,0.2,58,15312,0.12,68,39176,0.16,64,-8552,-4866,75.75
2006,Bulgaria,15064,0.12,67,23270,0.19,59,38334,0.16,65,8206,6424,27.74
2006,Morocco,12744,0.1,71,23980,0.19,57,36724,0.15,66,11236,9600,17.04
2006,Libya,28692,0.24,56,4934,0.04,101,33626,0.14,67,-23758,-17506,35.71
2006,Lithuania,14142,0.12,69,19373,0.16,64,33515,0.14,68,5231,3741,39.83
2006,Oman,21585,0.18,62,11039,0.09,79,32624,0.13,69,-10546,-9721,8.49
2006,Croatia,10361,0.09,77,21477,0.17,62,31838,0.13,70,11116,9804,13.38
2006,Bangladesh,11802,0.1,74,16034,0.13,67,27836,0.11,71,4232,4592,-7.84
2006,Tunisia,11694,0.1,75,15007,0.12,69,26701,0.11,72,3313,2683,23.48
2006,Ecuador,12728,0.1,72,12114,0.1,73,24842,0.1,73,-614,187,-428.34
2006,Estonia,9692,0.08,78,13449,0.11,70,23141,0.09,74,3757,2522,48.97
2006,"Bahrain, Kingdom of",12200,0.1,73,10515,0.08,81,22715,0.09,75,-1685,-849,98.47
2006,Syrian Arab Republic,10919,0.09,76,11488,0.09,78,22407,0.09,76,569,2154,-73.58
2006,Trinidad and Tobago,14155,0.12,68,6484,0.05,93,20639,0.08,77,-7671,-4248,80.58
2006,Costa Rica,8200,0.07,81,11548,0.09,75,19748,0.08,78,3348,2798,19.66
2006,Serbia,6428,0.05,88,13172,0.11,71,19600,0.08,79,6744,,
2006,Panama,8034,0.07,82,10775,0.09,80,18809,0.08,80,2741,2550,7.49
2006,Dominican Republic,6610,0.05,87,12174,0.1,72,18784,0.08,81,5564,3724,49.41
2006,Azerbaijan,13015,0.11,70,5269,0.04,98,18284,0.07,82,-7746,-3299,134.8
2006,Guatemala,6025,0.05,91,11915,0.1,74,17940,0.07,83,5890,5118,15.08
2006,Latvia,6155,0.05,89,11541,0.09,77,17696,0.07,84,5386,3536,52.32
2006,Sri Lanka,6886,0.06,85,10258,0.08,82,17144,0.07,85,3372,2487,35.59
2006,Jordan,5204,0.04,96,11548,0.09,75,16752,0.07,86,6344,6196,2.39
2006,Côte d'Ivoire,8477,0.07,79,5820,0.05,96,14297,0.06,87,-2657,-1832,45.03
2006,Sudan,5657,0.05,92,8074,0.07,86,13731,0.06,88,2417,1933,25.04
2006,Cuba,3159,0.03,113,10258,0.08,82,13417,0.05,89,7099,5765,23.14
2006,Yemen,6654,0.05,86,6074,0.05,95,12728,0.05,90,-580,-230,152.17
2006,Honduras,5277,0.04,95,7303,0.06,89,12580,0.05,91,2026,1497,35.34
2006,Lebanese Republic,2814,0.02,114,9647,0.08,84,12461,0.05,92,6833,7296,-6.35
2006,El Salvador,3706,0.03,105,7663,0.06,87,11369,0.05,93,3957,3272,20.94
2006,Kenya,3502,0.03,108,7233,0.06,90,10735,0.04,94,3731,2426,53.79
2006,Bosnia and Herzegovina,3323,0.03,112,7345,0.06,88,10668,0.04,95,4022,4670,-13.88
2006,Ghana,3727,0.03,104,6754,0.05,92,10481,0.04,96,3027,2545,18.94
2006,Equatorial Guinea,8207,0.07,80,2020,0.02,134,10227,0.04,97,-6187,-5754,7.53
2006,Uzbekistan,5617,0.05,93,4380,0.04,106,9997,0.04,98,-1237,-1083,14.22
2006,Turkmenistan,7156,0.06,84,2560,0.02,126,9716,0.04,99,-4596,-1997,130.15
2006,Iceland,3453,0.03,110,6137,0.05,94,9590,0.04,100,2684,1888,42.16
2006,"Aruba, Netherlands with respect to",4716,0.04,97,4723,0.04,105,9439,0.04,101,7,-128,-105.47
2006,Brunei Darussalam,7636,0.06,83,1676,0.01,146,9312,0.04,102,-5960,-4758,25.26
2006,Uruguay,3989,0.03,101,4806,0.04,102,8795,0.04,103,817,457,78.77
2006,Cambodia,3692,0.03,106,4771,0.04,103,8463,0.03,104,1079,835,29.22
2006,Cyprus,1333,0.01,134,6928,0.06,91,8261,0.03,105,5595,4851,15.34
2006,Paraguay,3472,0.03,109,4744,0.04,104,8216,0.03,106,1272,562,126.33
2006,Congo,6078,0.05,90,2013,0.02,135,8091,0.03,107,-4065,-3441,18.13
2006,"Macao, China",2557,0.02,118,5236,0.04,99,7793,0.03,108,2679,2038,31.45
2006,Botswana,4529,0.04,99,3086,0.02,115,7615,0.03,109,-1443,-1264,14.16
2006,Jamaica,1948,0.02,123,5650,0.05,97,7598,0.03,110,3702,3207,15.43
2006,Gabon,5450,0.04,94,1725,0.01,143,7175,0.03,111,-3725,-3594,3.64
2006,Malta,2796,0.02,115,4307,0.03,107,7103,0.03,112,1511,1282,17.86
2006,Myanmar,4539,0.04,98,2538,0.02,128,7077,0.03,113,-2001,-1868,7.12
2006,"Bolivia, Plurinational State of",3952,0.03,102,2916,0.02,119,6868,0.03,114,-1036,-396,161.62
2006,Zambia,3770,0.03,103,3074,0.02,116,6844,0.03,115,-696,748,-193.05
2006,Cameroon,3576,0.03,107,3150,0.03,114,6726,0.03,116,-426,-126,238.1
2006,Ethiopia,1043,0.01,137,5207,0.04,100,6250,0.03,117,4164,3192,30.45
2006,North Macedonia,2401,0.02,119,3763,0.03,109,6164,0.03,118,1362,1187,14.74
2006,Papua New Guinea,4166,0.03,100,1984,0.02,136,6150,0.03,119,-2182,-1544,41.32
2006,Tanzania,1865,0.02,125,4246,0.03,108,6111,0.02,120,2381,1608,48.07
2006,Mauritius,2329,0.02,121,3627,0.03,112,5956,0.02,121,1298,1014,28.01
2006,Democratic Republic of the Congo,2705,0.02,116,2892,0.02,120,5597,0.02,122,187,287,-34.84
2006,Namibia,2647,0.02,117,2884,0.02,121,5531,0.02,123,237,507,-53.25
2006,Nicaragua,1932,0.02,124,3404,0.03,113,5336,0.02,124,1472,1302,13.06
2006,Senegal,1594,0.01,127,3671,0.03,111,5265,0.02,125,2077,1920,8.18
2006,Mozambique,2381,0.02,120,2869,0.02,123,5250,0.02,126,488,625,-21.92
2006,Chad,3352,0.03,111,1350,0.01,151,4702,0.02,127,-2002,-2131,-6.05
2006,Georgia,936,0.01,142,3678,0.03,110,4614,0.02,128,2742,1625,68.74
2006,"Korea, Democratic People's Republic of",1465,0.01,130,2880,0.02,122,4345,0.02,129,1415,1380,2.54
2006,Zimbabwe,2000,0.02,122,2127,0.02,132,4127,0.02,130,127,496,-74.4
2006,Albania,790,0.01,146,3060,0.02,117,3850,0.02,131,2270,1960,15.82
2006,"Moldova, Republic of",1052,0.01,136,2693,0.02,125,3745,0.02,132,1641,1201,36.64
2006,Eswatini,1660,0.01,126,1910,0.02,138,3570,0.01,133,250,250,0.0
2006,Bahamas,547,0.0,156,2984,0.02,118,3531,0.01,134,2437,2138,13.99
2006,Uganda,962,0.01,141,2557,0.02,127,3519,0.01,135,1595,1241,28.53
2006,New Caledonia,1352,0.01,133,2117,0.02,133,3469,0.01,136,765,681,12.33
2006,Mali,1550,0.01,128,1820,0.01,140,3370,0.01,137,270,443,-39.05
2006,Nepal,838,0.01,145,2492,0.02,129,3330,0.01,138,1654,1420,16.48
2006,Armenia,985,0.01,139,2192,0.02,131,3177,0.01,139,1207,828,45.77
2006,Afghanistan,416,0.0,163,2744,0.02,124,3160,0.01,140,2328,2087,11.55
2006,Tajikistan,1399,0.01,131,1723,0.01,144,3122,0.01,141,324,421,-23.04
2006,Mongolia,1543,0.01,129,1486,0.01,150,3029,0.01,142,-57,119,-147.9
2006,Netherlands Antilles,695,0.01,149,2209,0.02,130,2904,0.01,143,1514,1342,12.82
2006,Kyrgyz Republic,891,0.01,143,1931,0.02,137,2822,0.01,144,1040,430,141.86
2006,Madagascar,985,0.01,139,1804,0.01,141,2789,0.01,145,819,851,-3.76
2006,Mauritania,1367,0.01,132,1167,0.01,155,2534,0.01,146,-200,803,-124.91
2006,Fiji,694,0.01,150,1804,0.01,141,2498,0.01,147,1110,906,22.52
2006,Montenegro,556,0.0,155,1842,0.01,139,2398,0.01,148,1286,,
2006,Lesotho,718,0.01,148,1500,0.01,149,2218,0.01,149,782,759,3.03
2006,Barbados,510,0.0,157,1697,0.01,145,2207,0.01,150,1187,1245,-4.66
2006,Suriname,1175,0.01,135,1013,0.01,160,2188,0.01,151,-162,53,-405.66
2006,Haiti,509,0.0,158,1619,0.01,148,2128,0.01,152,1110,984,12.8
2006,Guinea,1033,0.01,138,956,0.01,162,1989,0.01,153,-77,-33,133.33
2006,Malawi,691,0.01,151,1288,0.01,153,1979,0.01,154,597,673,-11.29
2006,Benin,736,0.01,147,1228,0.01,154,1964,0.01,155,492,440,11.82
2006,Lao People's Democratic Republic,882,0.01,144,1060,0.01,158,1942,0.01,156,178,329,-45.9
2006,Burkina Faso,588,0.0,153,1319,0.01,152,1907,0.01,157,731,792,-7.7
2006,French Polynesia,235,0.0,168,1656,0.01,147,1891,0.01,158,1421,1506,-5.64
2006,Togo,630,0.01,152,1085,0.01,157,1715,0.01,159,455,400,13.75
2006,Niger,508,0.0,160,997,0.01,161,1505,0.01,160,489,537,-8.94
2006,Guyana,588,0.0,153,889,0.01,164,1477,0.01,161,301,235,28.09
2006,Maldives,225,0.0,170,927,0.01,163,1152,0.0,162,702,583,20.41
2006,Seychelles,380,0.0,166,757,0.01,165,1137,0.0,163,377,335,12.54
2006,Bermuda,27,0.0,186,1094,0.01,156,1121,0.0,164,1067,936,14.0
2006,Belize,419,0.0,162,660,0.01,166,1079,0.0,165,241,274,-12.04
2006,Cayman Islands,17,0.0,191,1048,0.01,159,1065,0.0,166,1031,1121,-8.03
2006,Greenland,396,0.0,165,660,0.01,166,1056,0.0,167,264,191,38.22
2006,Northern Mariana Islands,509,0.0,158,540,0.0,173,1049,0.0,168,31,-85,-136.47
2006,American Samoa,439,0.0,161,566,0.0,171,1005,0.0,169,127,132,-3.79
2006,Somalia,332,0.0,167,509,0.0,174,841,0.0,170,177,146,21.23
2006,Bhutan,414,0.0,164,420,0.0,178,834,0.0,171,6,128,-95.31
2006,Rwanda,147,0.0,173,591,0.0,170,738,0.0,172,444,346,28.32
2006,Antigua and Barbuda,74,0.0,176,624,0.01,168,698,0.0,173,550,423,30.02
2006,Saint Lucia,94,0.0,175,592,0.0,169,686,0.0,174,498,422,18.01
2006,Liberia,158,0.0,171,467,0.0,176,625,0.0,175,309,179,72.63
2006,Sierra Leone,231,0.0,169,389,0.0,179,620,0.0,176,158,187,-15.51
2006,Cabo Verde,21,0.0,188,542,0.0,172,563,0.0,177,521,420,24.05
2006,Eritrea,12,0.0,193,495,0.0,175,507,0.0,178,483,479,0.84
2006,Burundi,58,0.0,179,431,0.0,177,489,0.0,179,373,211,76.78
2006,Djibouti,55,0.0,180,336,0.0,180,391,0.0,180,281,237,18.57
2006,Central African Republic,158,0.0,171,203,0.0,189,361,0.0,181,45,47,-4.26
2006,Guinea-Bissau,74,0.0,176,282,0.0,182,356,0.0,182,208,144,44.44
2006,Samoa,65,0.0,178,275,0.0,183,340,0.0,183,210,152,38.16
2006,Solomon Islands,121,0.0,174,217,0.0,187,338,0.0,184,96,82,17.07
2006,Grenada,25,0.0,187,299,0.0,181,324,0.0,185,274,300,-8.67
2006,Saint Vincent and the Grenadines,38,0.0,185,271,0.0,184,309,0.0,186,233,200,16.5
2006,Saint Kitts and Nevis,40,0.0,184,250,0.0,186,290,0.0,187,210,176,19.32
2006,The Gambia,11,0.0,194,259,0.0,185,270,0.0,188,248,253,-1.98
2006,Vanuatu,49,0.0,182,217,0.0,187,266,0.0,189,168,111,51.35
2006,Dominica,41,0.0,183,167,0.0,190,208,0.0,190,126,123,2.44
2006,"Micronesia, Federated States of",18,0.0,189,137,0.0,191,155,0.0,191,119,111,7.21
2006,Palau,14,0.0,192,115,0.0,193,129,0.0,192,101,92,9.78
2006,Tonga,10,0.0,195,116,0.0,192,126,0.0,193,106,111,-4.5
2006,Comoros,10,0.0,195,115,0.0,193,125,0.0,194,105,87,20.69
2006,Marshall Islands,18,0.0,189,91,0.0,197,109,0.0,195,73,69,5.8
2006,Timor-Leste,8,0.0,198,101,0.0,195,109,0.0,195,93,101,-7.92
2006,Cook Islands,3,0.0,201,100,0.0,196,103,0.0,197,97,76,27.63
2006,Saint Pierre and Miquelon,9,0.0,197,73,0.0,198,82,0.0,198,64,78,-17.95
2006,Sao Tomé and Principe,8,0.0,198,71,0.0,199,79,0.0,199,63,43,46.51
2006,Kiribati,6,0.0,200,62,0.0,200,68,0.0,200,56,70,-20.0
2006,Guam,53,0.0,181,0,0.0,204,53,0.0,201,-53,-52,1.92
2006,Montserrat,1,0.0,202,30,0.0,201,31,0.0,202,29,29,0.0
2006,Tuvalu,0,0.0,204,13,0.0,202,13,0.0,203,13,13,0.0
2006,Niue,1,0.0,202,4,0.0,203,5,0.0,204,3,10,-70.0
2005,United States of America,901082,8.56,2,1732706,16.04,1,2633788,12.35,1,831624,710805,17.0
2005,Germany,970914,9.23,1,777073,7.19,2,1747987,8.2,2,-193841,-194145,-0.16
2005,China,761953,7.24,3,659953,6.11,3,1421906,6.67,3,-102000,-32097,217.79
2005,Japan,594941,5.65,4,515866,4.78,5,1110807,5.21,4,-79075,-111133,-28.85
2005,France,463428,4.4,5,504124,4.67,6,967552,4.54,5,40696,18839,116.02
2005,United Kingdom,393458,3.74,7,521919,4.83,4,915377,4.29,6,128461,119998,7.05
2005,Netherlands,406372,3.86,6,363822,3.37,8,770194,3.61,7,-42550,-37748,12.72
2005,Italy,373135,3.55,8,384790,3.56,7,757925,3.55,8,11655,1519,667.28
2005,Canada,360475,3.43,9,322411,2.98,9,682886,3.2,9,-38064,-36831,3.35
2005,Belgium,334400,3.18,10,318700,2.95,10,653100,3.06,10,-15700,-21245,-26.1
2005,"Hong Kong, China",292119,2.78,11,300160,2.78,11,592279,2.78,11,8041,7350,9.4
2005,"Korea, Republic of",284419,2.7,12,261238,2.42,13,545657,2.56,12,-23181,-29382,-21.1
2005,Spain,192644,1.83,17,288786,2.67,12,481430,2.26,13,96142,75708,26.99
2005,Mexico,214207,2.04,15,228240,2.11,14,442447,2.07,14,14033,14280,-1.73
2005,Singapore,229649,2.18,14,200047,1.85,15,429696,2.02,15,-29602,-25038,18.23
2005,Chinese Taipei,198432,1.89,16,182614,1.69,16,381046,1.79,16,-15818,-13182,20.0
2005,Russian Federation,243798,2.32,13,125434,1.16,20,369232,1.73,17,-118364,-85825,37.91
2005,Switzerland,149888,1.42,19,147127,1.36,17,297015,1.39,18,-2761,-7045,-60.81
2005,Malaysia,141626,1.35,20,114324,1.06,24,255950,1.2,19,-27302,-21480,27.1
2005,Austria,125182,1.19,22,127327,1.18,19,252509,1.18,20,2145,1529,40.29
2005,Sweden,130962,1.24,21,111697,1.03,25,242659,1.14,21,-19265,-22834,-15.63
2005,India,99616,0.95,29,142870,1.32,18,242486,1.14,22,43254,23126,87.04
2005,"Saudi Arabia, Kingdom of",180711,1.72,18,59459,0.55,36,240170,1.13,23,-121252,-78621,54.22
2005,Australia,106097,1.01,27,125281,1.16,21,231378,1.09,24,19184,22819,-15.93
2005,Thailand,110936,1.05,25,118178,1.09,22,229114,1.07,25,7242,-1838,-494.02
2005,United Arab Emirates,117287,1.11,24,84654,0.78,27,201941,0.95,26,-32633,-18915,72.52
2005,Brazil,118529,1.13,23,77628,0.72,28,196157,0.92,27,-40901,-30245,35.23
2005,Poland,89437,0.85,30,101639,0.94,26,191076,0.9,28,12202,14649,-16.7
2005,Türkiye,73476,0.7,34,116774,1.08,23,190250,0.89,29,43298,34373,25.97
2005,Ireland,109657,1.04,26,68565,0.63,32,178222,0.84,30,-41092,-42974,-4.38
2005,Indonesia,86996,0.83,31,75725,0.7,30,162721,0.76,31,-11271,-15890,-29.07
2005,Denmark,85121,0.81,32,75581,0.7,31,160702,0.75,32,-9540,-8922,6.93
2005,Norway,103759,0.99,28,55488,0.51,39,159247,0.75,33,-48271,-33993,42.0
2005,Czech Republic,78110,0.74,33,76512,0.71,29,154622,0.73,34,-1598,981,-262.9
2005,Hungary,62936,0.6,36,66552,0.62,33,129488,0.61,35,3616,4971,-27.26
2005,Finland,65498,0.62,35,58766,0.54,37,124264,0.58,36,-6732,-10077,-33.19
2005,South Africa,51626,0.49,39,62304,0.58,35,113930,0.53,37,10678,7320,45.87
2005,Portugal,38738,0.37,47,63921,0.59,34,102659,0.48,38,25183,19161,31.43
2005,Iran,56252,0.53,37,40041,0.37,43,96293,0.45,39,-16211,-9721,66.76
2005,Philippines,41255,0.39,45,49487,0.46,40,90742,0.43,40,8232,6421,28.2
2005,Israel,42770,0.41,43,44944,0.42,41,87714,0.41,41,2174,4246,-48.8
2005,"Venezuela, Bolivarian Republic of",55716,0.53,38,24027,0.22,51,79743,0.37,42,-31689,-22989,37.84
2005,Greece,18436,0.18,62,57729,0.53,38,76165,0.36,43,39293,37452,4.92
2005,Chile,41267,0.39,44,32735,0.3,47,74002,0.35,44,-8532,-7726,10.43
2005,Nigeria,50467,0.48,40,20754,0.19,57,71221,0.33,45,-29713,-24467,21.44
2005,Ukraine,34228,0.33,48,36136,0.33,45,70364,0.33,46,1908,-3669,-152.0
2005,Viet Nam,32442,0.31,49,36761,0.34,44,69203,0.32,47,4319,5484,-21.24
2005,Argentina,40351,0.38,46,28689,0.27,48,69040,0.32,48,-11662,-12131,-3.87
2005,Romania,27688,0.26,52,40518,0.38,42,68206,0.32,49,12830,9138,40.4
2005,Algeria,46002,0.44,41,20357,0.19,58,66359,0.31,50,-25645,-13135,95.24
2005,Slovak Republic,31795,0.3,50,34531,0.32,46,66326,0.31,51,2736,2117,29.24
2005,"Kuwait, the State of",44869,0.43,42,15801,0.15,64,60670,0.28,52,-29068,-15968,82.04
2005,New Zealand,21730,0.21,57,26219,0.24,49,47949,0.22,53,4489,2851,57.45
2005,Iraq,23697,0.23,55,23532,0.22,52,47229,0.22,54,-165,3492,-104.73
2005,Kazakhstan,27849,0.26,51,17353,0.16,62,45202,0.21,55,-10496,-7312,43.54
2005,Colombia,21190,0.2,58,21204,0.2,55,42394,0.2,56,14,522,-97.32
2005,Luxembourg,19120,0.18,60,22607,0.21,53,41727,0.2,57,3487,3796,-8.14
2005,Pakistan,16051,0.15,64,25357,0.23,50,41408,0.19,58,9306,4570,103.63
2005,Slovenia,19248,0.18,59,20337,0.19,59,39585,0.19,59,1089,1398,-22.1
2005,Qatar,25762,0.24,53,10061,0.09,75,35823,0.17,60,-15701,-12679,23.83
2005,Egypt,12912,0.12,66,22449,0.21,54,35361,0.17,61,9537,6289,51.65
2005,Belarus,15979,0.15,65,16708,0.15,63,32687,0.15,62,729,2717,-73.17
2005,Angola,24109,0.23,54,8353,0.08,84,32462,0.15,63,-15756,-7643,106.15
2005,Morocco,11190,0.11,69,20790,0.19,56,31980,0.15,64,9600,7897,21.57
2005,Bulgaria,11739,0.11,68,18163,0.17,61,29902,0.14,65,6424,4521,42.09
2005,Peru,17368,0.17,63,12502,0.12,68,29870,0.14,66,-4866,-2708,79.69
2005,Oman,18692,0.18,61,8971,0.08,81,27663,0.13,67,-9721,-4546,113.84
2005,Croatia,8795,0.08,75,18599,0.17,60,27394,0.13,68,9804,8584,14.21
2005,Lithuania,11807,0.11,67,15548,0.14,65,27355,0.13,69,3741,3085,21.26
2005,Libya,21867,0.21,56,4361,0.04,99,26228,0.12,70,-17506,-10549,65.95
2005,Tunisia,10494,0.1,70,13177,0.12,67,23671,0.11,71,2683,3133,-14.36
2005,Bangladesh,9297,0.09,74,13889,0.13,66,23186,0.11,72,4592,3731,23.08
2005,Ecuador,10100,0.1,72,10287,0.1,73,20387,0.1,73,187,473,-60.47
2005,"Bahrain, Kingdom of",10242,0.1,71,9393,0.09,80,19635,0.09,74,-849,-173,390.75
2005,Syrian Arab Republic,8708,0.08,76,10862,0.1,70,19570,0.09,75,2154,1033,108.52
2005,Estonia,7716,0.07,77,10238,0.09,74,17954,0.08,76,2522,2404,4.91
2005,Costa Rica,7026,0.07,82,9824,0.09,77,16850,0.08,77,2798,1967,42.25
2005,Serbia and Montenegro,5065,0.05,89,11635,0.11,69,16700,0.08,78,6570,7773,-15.48
2005,Panama,7050,0.07,81,9600,0.09,79,16650,0.08,79,2550,2650,-3.77
2005,Dominican Republic,6145,0.06,85,9869,0.09,76,16014,0.08,80,3724,1952,90.78
2005,Guatemala,5381,0.05,87,10499,0.1,71,15880,0.07,81,5118,4439,15.3
2005,Trinidad and Tobago,9942,0.09,73,5694,0.05,93,15636,0.07,82,-4248,-1659,156.06
2005,Sri Lanka,6347,0.06,83,8834,0.08,82,15181,0.07,83,2487,2216,12.23
2005,Jordan,4302,0.04,98,10498,0.1,72,14800,0.07,84,6196,4296,44.23
2005,Latvia,5161,0.05,88,8697,0.08,83,13858,0.06,85,3536,3087,14.54
2005,Côte d'Ivoire,7697,0.07,78,5865,0.05,91,13562,0.06,86,-1832,-2204,-16.88
2005,Azerbaijan,7649,0.07,79,4350,0.04,100,11999,0.06,87,-3299,-99,3232.32
2005,Lebanese Republic,2337,0.02,115,9633,0.09,78,11970,0.06,88,7296,7410,-1.54
2005,Honduras,5048,0.05,91,6545,0.06,89,11593,0.05,89,1497,1293,15.78
2005,Sudan,4824,0.05,93,6757,0.06,87,11581,0.05,90,1933,297,550.84
2005,Yemen,5608,0.05,86,5378,0.05,94,10986,0.05,91,-230,-86,167.44
2005,Cuba,2319,0.02,116,8084,0.07,85,10403,0.05,92,5765,3283,75.6
2005,El Salvador,3418,0.03,102,6690,0.06,88,10108,0.05,93,3272,3024,8.2
2005,Bosnia and Herzegovina,2400,0.02,113,7070,0.07,86,9470,0.04,94,4670,4122,13.29
2005,Kenya,3420,0.03,101,5846,0.05,92,9266,0.04,95,2426,1869,29.8
2005,"Aruba, Netherlands with respect to",4416,0.04,97,4288,0.04,101,8704,0.04,96,-128,154,-183.12
2005,Uzbekistan,4749,0.05,94,3666,0.03,107,8415,0.04,97,-1083,-888,21.96
2005,Equatorial Guinea,7064,0.07,80,1310,0.01,147,8374,0.04,98,-5754,-3507,64.07
2005,Ghana,2802,0.03,110,5347,0.05,95,8149,0.04,99,2545,1624,56.71
2005,Iceland,3091,0.03,106,4979,0.05,96,8070,0.04,100,1888,804,134.83
2005,Turkmenistan,4944,0.05,92,2947,0.03,114,7891,0.04,101,-1997,-550,263.09
2005,Cyprus,1465,0.01,128,6316,0.06,90,7781,0.04,102,4851,4554,6.52
2005,Brunei Darussalam,6249,0.06,84,1491,0.01,141,7740,0.04,103,-4758,-3635,30.89
2005,Botswana,4425,0.04,96,3161,0.03,111,7586,0.04,104,-1264,-282,348.23
2005,Uruguay,3422,0.03,100,3879,0.04,104,7301,0.03,105,457,183,149.73
2005,Cambodia,3092,0.03,105,3927,0.04,103,7019,0.03,106,835,395,111.39
2005,"Macao, China",2476,0.02,111,4514,0.04,98,6990,0.03,107,2038,1282,58.97
2005,Paraguay,3153,0.03,104,3715,0.03,105,6868,0.03,108,562,223,152.02
2005,Gabon,5065,0.05,89,1471,0.01,142,6536,0.03,109,-3594,-2381,50.94
2005,Jamaica,1532,0.01,127,4739,0.04,97,6271,0.03,110,3207,2538,26.36
2005,Malta,2399,0.02,114,3681,0.03,106,6080,0.03,111,1282,1124,14.06
2005,Congo,4745,0.05,95,1304,0.01,148,6049,0.03,112,-3441,-2464,39.65
2005,Myanmar,3776,0.04,99,1908,0.02,131,5684,0.03,113,-1868,-181,932.04
2005,Cameroon,2861,0.03,108,2735,0.03,115,5596,0.03,114,-126,-71,77.46
2005,Mauritius,2143,0.02,117,3157,0.03,112,5300,0.02,115,1014,778,30.33
2005,North Macedonia,2041,0.02,119,3228,0.03,110,5269,0.02,116,1187,1256,-5.49
2005,"Bolivia, Plurinational State of",2827,0.03,109,2431,0.02,124,5258,0.02,117,-396,-289,37.02
2005,Democratic Republic of the Congo,2403,0.02,112,2690,0.02,117,5093,0.02,118,287,134,114.18
2005,Senegal,1578,0.01,126,3498,0.03,108,5076,0.02,119,1920,1330,44.36
2005,Papua New Guinea,3273,0.03,103,1729,0.02,135,5002,0.02,120,-1544,-872,77.06
2005,Ethiopia,903,0.01,137,4095,0.04,102,4998,0.02,121,3192,2196,45.36
2005,Tanzania,1679,0.02,123,3287,0.03,109,4966,0.02,122,1608,1247,28.95
2005,Namibia,2070,0.02,118,2577,0.02,119,4647,0.02,123,507,569,-10.9
2005,Nicaragua,1654,0.02,124,2956,0.03,113,4610,0.02,124,1302,1088,19.67
2005,Zambia,1810,0.02,121,2558,0.02,121,4368,0.02,125,748,576,29.86
2005,Zimbabwe,1850,0.02,120,2346,0.02,126,4196,0.02,126,496,317,56.47
2005,Mozambique,1783,0.02,122,2408,0.02,125,4191,0.02,127,625,531,17.7
2005,"Korea, Democratic People's Republic of",1338,0.01,129,2718,0.03,116,4056,0.02,128,1380,1001,37.86
2005,Chad,3081,0.03,107,950,0.01,159,4031,0.02,129,-2131,-1238,72.13
2005,Eswatini,1640,0.02,125,1890,0.02,132,3530,0.02,130,250,-24,-1141.67
2005,"Moldova, Republic of",1091,0.01,132,2292,0.02,127,3383,0.02,131,1201,784,53.19
2005,Georgia,865,0.01,138,2490,0.02,122,3355,0.02,132,1625,1199,35.53
2005,Albania,659,0.01,147,2619,0.02,118,3278,0.02,133,1960,1704,15.02
2005,Nepal,863,0.01,139,2283,0.02,128,3146,0.01,134,1420,1166,21.78
2005,Bahamas,429,0.0,158,2567,0.02,120,2996,0.01,135,2138,1576,35.66
2005,New Caledonia,1093,0.01,131,1774,0.02,134,2867,0.01,136,681,603,12.94
2005,Uganda,813,0.01,142,2054,0.02,129,2867,0.01,136,1241,1072,15.76
2005,Afghanistan,384,0.0,160,2471,0.02,123,2855,0.01,138,2087,1872,11.49
2005,Armenia,974,0.01,135,1802,0.02,133,2776,0.01,139,828,628,31.85
2005,Mali,1101,0.01,130,1544,0.01,140,2645,0.01,140,443,388,14.18
2005,Madagascar,855,0.01,140,1706,0.02,137,2561,0.01,141,851,688,23.69
2005,Netherlands Antilles,608,0.01,150,1950,0.02,130,2558,0.01,142,1342,1202,11.65
2005,Fiji,701,0.01,143,1607,0.01,138,2308,0.01,143,906,753,20.32
2005,Mongolia,1065,0.01,133,1184,0.01,150,2249,0.01,144,119,151,-21.19
2005,Tajikistan,909,0.01,136,1330,0.01,146,2239,0.01,145,421,276,52.54
2005,Lesotho,651,0.01,148,1410,0.01,145,2061,0.01,146,759,732,3.69
2005,Mauritania,625,0.01,149,1428,0.01,144,2053,0.01,147,803,483,66.25
2005,Suriname,997,0.01,134,1050,0.01,155,2047,0.01,148,53,-132,-140.15
2005,Barbados,359,0.0,162,1604,0.01,139,1963,0.01,149,1245,1135,9.69
2005,French Polynesia,217,0.0,166,1723,0.02,136,1940,0.01,150,1506,1301,15.76
2005,Haiti,470,0.0,156,1454,0.01,143,1924,0.01,151,984,915,7.54
2005,Kyrgyz Republic,672,0.01,145,1102,0.01,153,1774,0.01,152,430,222,93.69
2005,Burkina Faso,468,0.0,157,1260,0.01,149,1728,0.01,153,792,791,0.13
2005,Togo,660,0.01,146,1060,0.01,154,1720,0.01,154,400,279,43.37
2005,Malawi,508,0.0,154,1181,0.01,151,1689,0.01,155,673,444,51.58
2005,Guinea,853,0.01,141,820,0.01,161,1673,0.01,156,-33,36,-191.67
2005,Benin,578,0.01,151,1018,0.01,157,1596,0.01,157,440,325,35.38
2005,Niger,489,0.0,155,1026,0.01,156,1515,0.01,158,537,274,95.99
2005,Lao People's Democratic Republic,553,0.01,152,882,0.01,160,1435,0.01,159,329,350,-6.0
2005,Guyana,553,0.01,152,788,0.01,162,1341,0.01,160,235,58,305.17
2005,Northern Mariana Islands,691,0.01,144,606,0.01,165,1297,0.01,161,-85,-162,-47.53
2005,Cayman Islands,51,0.0,180,1172,0.01,152,1223,0.01,162,1121,,
2005,Bermuda,49,0.0,181,985,0.01,158,1034,0.0,163,936,915,2.3
2005,Seychelles,340,0.0,163,675,0.01,164,1015,0.0,164,335,206,62.62
2005,Greenland,402,0.0,159,593,0.01,166,995,0.0,165,191,165,15.76
2005,Belize,319,0.0,164,593,0.01,166,912,0.0,166,274,215,27.44
2005,Maldives,162,0.0,168,745,0.01,163,907,0.0,167,583,461,26.46
2005,American Samoa,374,0.0,161,506,0.0,168,880,0.0,168,132,143,-7.69
2005,Bhutan,258,0.0,165,386,0.0,174,644,0.0,169,128,228,-43.86
2005,Rwanda,125,0.0,172,471,0.0,172,596,0.0,170,346,186,86.02
2005,Antigua and Barbuda,83,0.0,176,506,0.0,168,589,0.0,171,423,397,6.55
2005,Somalia,215,0.0,167,361,0.0,175,576,0.0,172,146,118,23.73
2005,Saint Lucia,64,0.0,177,486,0.0,171,550,0.0,173,422,342,23.39
2005,Sierra Leone,158,0.0,169,345,0.0,176,503,0.0,174,187,147,27.21
2005,Eritrea,11,0.0,193,490,0.0,170,501,0.0,175,479,469,2.13
2005,Cabo Verde,18,0.0,190,438,0.0,173,456,0.0,176,420,416,0.96
2005,Liberia,131,0.0,170,310,0.0,178,441,0.0,177,179,233,-23.18
2005,Grenada,28,0.0,187,328,0.0,177,356,0.0,178,300,201,49.25
2005,Burundi,58,0.0,178,269,0.0,180,327,0.0,179,211,129,63.57
2005,Samoa,87,0.0,175,239,0.0,183,326,0.0,180,152,125,21.6
2005,Guinea-Bissau,89,0.0,174,233,0.0,184,322,0.0,181,144,7,1957.14
2005,Djibouti,40,0.0,183,277,0.0,179,317,0.0,182,237,223,6.28
2005,Central African Republic,128,0.0,171,175,0.0,187,303,0.0,183,47,17,176.47
2005,Solomon Islands,103,0.0,173,185,0.0,186,288,0.0,184,82,24,241.67
2005,Saint Vincent and the Grenadines,40,0.0,183,240,0.0,182,280,0.0,185,200,189,5.82
2005,The Gambia,7,0.0,196,260,0.0,181,267,0.0,186,253,211,19.91
2005,Saint Kitts and Nevis,34,0.0,186,210,0.0,185,244,0.0,187,176,143,23.08
2005,Dominica,42,0.0,182,165,0.0,188,207,0.0,188,123,102,20.59
2005,Vanuatu,38,0.0,185,149,0.0,189,187,0.0,189,111,91,21.98
2005,"Micronesia, Federated States of",19,0.0,189,130,0.0,190,149,0.0,190,111,116,-4.31
2005,Tonga,10,0.0,194,121,0.0,191,131,0.0,191,111,90,23.33
2005,Marshall Islands,25,0.0,188,94,0.0,195,119,0.0,192,69,64,7.81
2005,Palau,13,0.0,191,105,0.0,193,118,0.0,193,92,101,-8.91
2005,Timor-Leste,8,0.0,195,109,0.0,192,117,0.0,194,101,139,-27.34
2005,Comoros,12,0.0,192,99,0.0,194,111,0.0,195,87,67,29.85
2005,Saint Pierre and Miquelon,7,0.0,196,85,0.0,196,92,0.0,196,78,66,18.18
2005,Cook Islands,5,0.0,199,81,0.0,197,86,0.0,197,76,69,10.14
2005,Kiribati,4,0.0,200,74,0.0,198,78,0.0,198,70,57,22.81
2005,Sao Tomé and Principe,7,0.0,196,50,0.0,199,57,0.0,199,43,36,19.44
2005,Guam,52,0.0,179,0,0.0,203,52,0.0,200,-52,-53,-1.89
2005,Montserrat,1,0.0,201,30,0.0,200,31,0.0,201,29,25,16.0
2005,Tuvalu,0,0.0,202,13,0.0,201,13,0.0,202,13,11,18.18
2005,Niue,0,0.0,202,10,0.0,202,10,0.0,203,10,8,25.0
2004,United States of America,814875,8.84,2,1525680,16.11,1,2340555,12.53,1,710805,578279,22.92
2004,Germany,909887,9.87,1,715742,7.56,2,1625629,8.7,2,-194145,-146948,32.12
2004,China,593326,6.44,3,561229,5.93,3,1154555,6.18,3,-32097,-25468,26.03
2004,Japan,565675,6.14,4,454542,4.8,6,1020217,5.46,4,-111133,-88887,25.03
2004,France,452106,4.9,5,470945,4.97,4,923051,4.94,5,18839,6801,177.0
2004,United Kingdom,349734,3.79,8,469732,4.96,5,819466,4.39,6,119998,85922,39.66
2004,Italy,353782,3.84,7,355301,3.75,7,709083,3.79,7,1519,-1814,-183.74
2004,Netherlands,357417,3.88,6,319669,3.38,8,677086,3.62,8,-37748,-31308,20.57
2004,Canada,316762,3.44,9,279931,2.96,10,596693,3.19,9,-36831,-27718,32.88
2004,Belgium,306866,3.33,10,285621,3.02,9,592487,3.17,10,-21245,-20672,2.77
2004,"Hong Kong, China",265543,2.88,11,272893,2.88,11,538436,2.88,11,7350,4541,61.86
2004,"Korea, Republic of",253845,2.75,12,224463,2.37,13,478308,2.56,12,-29382,-14990,96.01
2004,Spain,182623,1.98,16,258331,2.73,12,440954,2.36,13,75708,52455,44.33
2004,Mexico,187980,2.04,14,202260,2.14,14,390240,2.09,14,14280,9643,48.09
2004,Singapore,198637,2.15,13,173599,1.83,15,372236,1.99,15,-25038,-23684,5.72
2004,Chinese Taipei,182432,1.98,17,169250,1.79,16,351682,1.88,16,-13182,-22168,-40.54
2004,Russian Federation,183207,1.99,15,97382,1.03,24,280589,1.5,17,-85825,-59859,43.38
2004,Switzerland,122844,1.33,21,115799,1.22,18,238643,1.28,18,-7045,-4583,53.72
2004,Austria,118376,1.28,22,119905,1.27,17,238281,1.28,19,1529,2386,-35.92
2004,Malaysia,126646,1.37,18,105166,1.11,20,231812,1.24,20,-21480,-21407,0.34
2004,Sweden,123267,1.34,20,100433,1.06,21,223700,1.2,21,-22834,-18564,23.0
2004,Australia,86565,0.94,27,109384,1.16,19,195949,1.05,22,22819,18707,21.98
2004,Thailand,96248,1.04,25,94410,1.0,25,190658,1.02,23,-1838,-4500,-59.16
2004,India,76649,0.83,30,99775,1.05,22,176424,0.94,24,23126,13595,70.11
2004,"Saudi Arabia, Kingdom of",125997,1.37,19,47376,0.5,39,173373,0.93,25,-78621,-51541,52.54
2004,Ireland,104788,1.14,23,61814,0.65,31,166602,0.89,26,-42974,-38869,10.56
2004,Poland,75047,0.81,31,89696,0.95,26,164743,0.88,27,14649,14510,0.96
2004,Brazil,96678,1.05,24,66433,0.7,30,163111,0.87,28,-30245,-22322,35.49
2004,United Arab Emirates,90997,0.99,26,72082,0.76,27,163079,0.87,29,-18915,-15061,25.59
2004,Türkiye,63167,0.69,34,97540,1.03,23,160707,0.86,30,34373,22087,55.63
2004,Denmark,77079,0.84,29,68157,0.72,29,145236,0.78,31,-8922,-9083,-1.77
2004,Czech Republic,68986,0.75,33,69967,0.74,28,138953,0.74,32,981,3026,-67.58
2004,Norway,82527,0.9,28,48534,0.51,38,131061,0.7,33,-33993,-28266,20.26
2004,Indonesia,70767,0.77,32,54877,0.58,34,125644,0.67,34,-15890,-21912,-27.48
2004,Hungary,55567,0.6,36,60538,0.64,32,116105,0.62,35,4971,4714,5.45
2004,Finland,61520,0.67,35,51443,0.54,37,112963,0.6,36,-10077,-10658,-5.45
2004,South Africa,46146,0.5,37,53466,0.56,35,99612,0.53,37,7320,3266,124.13
2004,Portugal,35787,0.39,43,54948,0.58,33,90735,0.49,38,19161,15443,24.08
2004,Philippines,39681,0.43,39,46102,0.49,40,85783,0.46,39,6421,6345,1.2
2004,Israel,38618,0.42,42,42864,0.45,41,81482,0.44,40,4246,4519,-6.04
2004,Iran,41697,0.45,38,31976,0.34,43,73673,0.39,41,-9721,-8952,8.59
2004,Greece,15308,0.17,59,52760,0.56,36,68068,0.36,42,37452,31470,19.01
2004,Ukraine,32666,0.35,45,28997,0.31,46,61663,0.33,43,-3669,-47,7706.38
2004,Viet Nam,26485,0.29,50,31969,0.34,44,58454,0.31,44,5484,5107,7.38
2004,Slovak Republic,27745,0.3,49,29862,0.32,45,57607,0.31,45,2117,686,208.6
2004,Chile,32520,0.35,46,24794,0.26,47,57314,0.31,46,-7726,-2342,229.89
2004,Argentina,34576,0.38,44,22445,0.24,49,57021,0.31,47,-12131,-15732,-22.89
2004,"Venezuela, Bolivarian Republic of",39668,0.43,40,16679,0.18,57,56347,0.3,48,-22989,-17974,27.9
2004,Romania,23553,0.26,51,32691,0.35,42,56244,0.3,49,9138,6321,44.57
2004,Nigeria,38631,0.42,41,14164,0.15,62,52795,0.28,50,-24467,-13178,85.67
2004,Algeria,31304,0.34,47,18169,0.19,52,49473,0.26,51,-13135,-10783,21.81
2004,New Zealand,20344,0.22,52,23195,0.24,48,43539,0.23,52,2851,2032,40.31
2004,"Kuwait, the State of",28599,0.31,48,12631,0.13,65,41230,0.22,53,-15968,-9691,64.77
2004,Iraq,17810,0.19,55,21302,0.22,50,39112,0.21,54,3492,223,1465.92
2004,Luxembourg,16250,0.18,57,20046,0.21,51,36296,0.19,55,3796,2868,32.36
2004,Slovenia,16361,0.18,56,17759,0.19,55,34120,0.18,56,1398,1079,29.56
2004,Colombia,16224,0.18,58,16746,0.18,56,32970,0.18,57,522,809,-35.48
2004,Kazakhstan,20093,0.22,53,12781,0.13,64,32874,0.18,58,-7312,-4518,61.84
2004,Pakistan,13379,0.15,63,17949,0.19,53,31328,0.17,59,4570,1108,312.45
2004,Belarus,13774,0.15,61,16491,0.17,59,30265,0.16,60,2717,1612,68.55
2004,Morocco,9925,0.11,67,17822,0.19,54,27747,0.15,61,7897,5472,44.32
2004,Egypt,9661,0.1,69,15950,0.17,60,25611,0.14,62,6289,5542,13.48
2004,Qatar,18684,0.2,54,6005,0.06,83,24689,0.13,63,-12679,-8485,49.43
2004,Croatia,8028,0.09,72,16612,0.18,58,24640,0.13,64,8584,8022,7.01
2004,Bulgaria,9932,0.11,66,14453,0.15,61,24385,0.13,65,4521,3328,35.85
2004,Peru,12809,0.14,65,10101,0.11,69,22910,0.12,66,-2708,-677,300.0
2004,Tunisia,9685,0.11,68,12818,0.14,63,22503,0.12,67,3133,2883,8.67
2004,Oman,13342,0.14,64,8796,0.09,72,22138,0.12,68,-4546,-4868,-6.61
2004,Lithuania,9302,0.1,70,12387,0.13,66,21689,0.12,69,3085,2641,16.81
2004,Bangladesh,8305,0.09,71,12036,0.13,67,20341,0.11,70,3731,3444,8.33
2004,Angola,13475,0.15,62,5832,0.06,85,19307,0.1,71,-7643,-4028,89.75
2004,Libya,14766,0.16,60,4217,0.04,92,18983,0.1,72,-10549,-7212,46.27
2004,Ecuador,7753,0.08,73,8226,0.09,76,15979,0.09,73,473,480,-1.46
2004,Syrian Arab Republic,7378,0.08,75,8411,0.09,73,15789,0.08,74,1033,-620,-266.61
2004,Serbia and Montenegro,3979,0.04,89,11752,0.12,68,15731,0.08,75,7773,5302,46.61
2004,"Bahrain, Kingdom of",7558,0.08,74,7385,0.08,80,14943,0.08,76,-173,-975,-82.26
2004,Costa Rica,6301,0.07,78,8268,0.09,75,14569,0.08,77,1967,1561,26.01
2004,Guatemala,5036,0.05,83,9475,0.1,71,14511,0.08,78,4439,3668,21.02
2004,Estonia,5932,0.06,80,8336,0.09,74,14268,0.08,79,2404,2345,2.52
2004,Dominican Republic,5936,0.06,79,7888,0.08,79,13824,0.07,80,1952,2156,-9.46
2004,Sri Lanka,5757,0.06,81,7973,0.08,78,13730,0.07,81,2216,1547,43.24
2004,Jordan,3883,0.04,90,8179,0.09,77,12062,0.06,82,4296,2661,61.44
2004,Lebanese Republic,2199,0.02,111,9609,0.1,70,11808,0.06,83,7410,5502,34.68
2004,Côte d'Ivoire,6919,0.08,76,4715,0.05,90,11634,0.06,84,-2204,-2509,-12.16
2004,Trinidad and Tobago,6517,0.07,77,4858,0.05,89,11375,0.06,85,-1659,-1286,29.0
2004,Latvia,4009,0.04,88,7096,0.07,81,11105,0.06,86,3087,2341,31.87
2004,Honduras,4534,0.05,85,5827,0.06,86,10361,0.06,87,1293,1020,26.76
2004,El Salvador,3305,0.04,98,6329,0.07,82,9634,0.05,88,3024,2626,15.16
2004,Yemen,4072,0.04,87,3986,0.04,96,8058,0.04,89,-86,-58,48.28
2004,Cuba,2332,0.03,110,5615,0.06,87,7947,0.04,90,3283,2985,9.98
2004,Sudan,3778,0.04,92,4075,0.04,94,7853,0.04,91,297,340,-12.65
2004,Bosnia and Herzegovina,1793,0.02,119,5915,0.06,84,7708,0.04,92,4122,3461,19.1
2004,Uzbekistan,4280,0.05,86,3392,0.04,103,7672,0.04,93,-888,-527,68.5
2004,Kenya,2684,0.03,104,4553,0.05,91,7237,0.04,94,1869,1314,42.24
2004,Turkmenistan,3870,0.04,91,3320,0.04,104,7190,0.04,95,-550,-1120,-50.89
2004,Azerbaijan,3615,0.04,94,3516,0.04,102,7131,0.04,96,-99,34,-391.18
2004,"Aruba, Netherlands with respect to",3435,0.04,96,3589,0.04,101,7024,0.04,97,154,345,-55.36
2004,"Macao, China",2812,0.03,102,4094,0.04,93,6906,0.04,98,1282,651,96.93
2004,Botswana,3513,0.04,95,3231,0.03,105,6744,0.04,99,-282,-362,-22.1
2004,Ghana,2450,0.03,108,4074,0.04,95,6524,0.03,100,1624,886,83.3
2004,Iceland,2839,0.03,101,3643,0.04,98,6482,0.03,101,804,446,80.27
2004,Brunei Darussalam,5057,0.05,82,1422,0.02,139,6479,0.03,102,-3635,-3094,17.49
2004,Cyprus,948,0.01,132,5502,0.06,88,6450,0.03,103,4554,3543,28.54
2004,Malta,2517,0.03,106,3641,0.04,99,6158,0.03,104,1124,975,15.28
2004,Uruguay,2931,0.03,99,3114,0.03,107,6045,0.03,105,183,-16,-1243.75
2004,Cambodia,2798,0.03,103,3193,0.03,106,5991,0.03,106,395,442,-10.63
2004,Paraguay,2874,0.03,100,3097,0.03,108,5971,0.03,107,223,-357,-162.46
2004,Equatorial Guinea,4599,0.05,84,1092,0.01,147,5691,0.03,108,-3507,-1893,85.26
2004,Jamaica,1402,0.02,125,3940,0.04,97,5342,0.03,109,2538,2459,3.21
2004,Gabon,3728,0.04,93,1347,0.01,143,5075,0.03,110,-2381,-1856,28.29
2004,Cameroon,2477,0.03,107,2406,0.03,115,4883,0.03,111,-71,-120,-40.83
2004,Mauritius,1993,0.02,114,2771,0.03,112,4764,0.03,112,778,465,67.31
2004,North Macedonia,1676,0.02,120,2932,0.03,109,4608,0.02,113,1256,939,33.76
2004,Panama,944,0.01,133,3594,0.04,100,4538,0.02,114,2650,2222,19.26
2004,Myanmar,2355,0.03,109,2174,0.02,121,4529,0.02,115,-181,-388,-53.35
2004,Congo,3433,0.04,97,969,0.01,150,4402,0.02,116,-2464,-1846,33.48
2004,Senegal,1509,0.02,122,2839,0.03,111,4348,0.02,117,1330,1134,17.28
2004,Papua New Guinea,2552,0.03,105,1680,0.02,133,4232,0.02,118,-872,-840,3.81
2004,Namibia,1827,0.02,118,2396,0.03,116,4223,0.02,119,569,718,-20.75
2004,Tanzania,1479,0.02,124,2726,0.03,113,4205,0.02,120,1247,909,37.18
2004,Zimbabwe,1887,0.02,117,2204,0.02,119,4091,0.02,121,317,40,692.5
2004,"Bolivia, Plurinational State of",2166,0.02,113,1877,0.02,128,4043,0.02,122,-289,19,-1621.05
2004,Democratic Republic of the Congo,1917,0.02,116,2051,0.02,123,3968,0.02,123,134,117,14.53
2004,Eswatini,1949,0.02,115,1925,0.02,127,3874,0.02,124,-24,-119,-79.83
2004,Nicaragua,1369,0.01,126,2457,0.03,114,3826,0.02,125,1088,971,12.05
2004,Zambia,1576,0.02,121,2152,0.02,122,3728,0.02,126,576,594,-3.03
2004,"Korea, Democratic People's Republic of",1278,0.01,127,2279,0.02,118,3557,0.02,127,1001,983,1.83
2004,Ethiopia,678,0.01,144,2874,0.03,110,3552,0.02,128,2196,2190,0.27
2004,Mozambique,1504,0.02,123,2035,0.02,124,3539,0.02,129,531,708,-25.0
2004,Chad,2191,0.02,112,953,0.01,151,3144,0.02,130,-1238,189,-755.03
2004,Albania,605,0.01,147,2309,0.02,117,2914,0.02,131,1704,1416,20.34
2004,"Moldova, Republic of",985,0.01,130,1769,0.02,130,2754,0.01,132,784,609,28.74
2004,Nepal,772,0.01,138,1938,0.02,126,2710,0.01,133,1166,1092,6.78
2004,Madagascar,992,0.01,129,1680,0.02,133,2672,0.01,134,688,448,53.57
2004,New Caledonia,1033,0.01,128,1636,0.02,135,2669,0.01,135,603,756,-20.24
2004,Georgia,647,0.01,146,1846,0.02,129,2493,0.01,136,1199,680,76.32
2004,Afghanistan,305,0.0,161,2177,0.02,120,2482,0.01,137,1872,1957,-4.34
2004,Uganda,654,0.01,145,1726,0.02,131,2380,0.01,138,1072,843,27.16
2004,Bahamas,401,0.0,157,1977,0.02,125,2378,0.01,139,1576,1509,4.44
2004,Mali,976,0.01,131,1364,0.01,141,2340,0.01,140,388,343,13.12
2004,Netherlands Antilles,521,0.01,151,1723,0.02,132,2244,0.01,141,1202,1445,-16.82
2004,Lesotho,708,0.01,142,1440,0.02,138,2148,0.01,142,732,645,13.49
2004,Fiji,693,0.01,143,1446,0.02,137,2139,0.01,143,753,537,40.22
2004,Tajikistan,915,0.01,134,1191,0.01,146,2106,0.01,144,276,84,228.57
2004,Armenia,723,0.01,140,1351,0.01,142,2074,0.01,145,628,594,5.72
2004,Mongolia,870,0.01,136,1021,0.01,148,1891,0.01,146,151,185,-18.38
2004,Burkina Faso,479,0.01,153,1270,0.01,145,1749,0.01,147,791,604,30.96
2004,French Polynesia,199,0.0,165,1500,0.02,136,1699,0.01,148,1301,1429,-8.96
2004,Haiti,391,0.0,158,1306,0.01,144,1697,0.01,149,915,841,8.8
2004,Barbados,278,0.0,164,1413,0.01,140,1691,0.01,150,1135,945,20.11
2004,Kyrgyz Republic,719,0.01,141,941,0.01,152,1660,0.01,151,222,135,64.44
2004,Suriname,874,0.01,135,742,0.01,158,1616,0.01,152,-132,66,-300.0
2004,Guinea,744,0.01,139,780,0.01,157,1524,0.01,153,36,31,16.13
2004,Northern Mariana Islands,826,0.01,137,664,0.01,161,1490,0.01,154,-162,-178,-8.99
2004,Togo,601,0.01,148,880,0.01,156,1481,0.01,155,279,177,57.63
2004,Benin,569,0.01,150,894,0.01,155,1463,0.01,156,325,351,-7.41
2004,Malawi,485,0.01,152,929,0.01,153,1414,0.01,157,444,259,71.43
2004,Mauritania,440,0.0,155,923,0.01,154,1363,0.01,158,483,224,115.63
2004,Guyana,593,0.01,149,651,0.01,162,1244,0.01,159,58,63,-7.94
2004,Niger,437,0.0,156,711,0.01,160,1148,0.01,160,274,270,1.48
2004,Lao People's Democratic Republic,363,0.0,160,713,0.01,159,1076,0.01,161,350,127,175.59
2004,Bermuda,73,0.0,177,988,0.01,149,1061,0.01,162,915,781,17.16
2004,American Samoa,446,0.0,154,589,0.01,164,1035,0.01,163,143,151,-5.3
2004,Greenland,381,0.0,159,546,0.01,165,927,0.0,164,165,113,46.02
2004,Belize,305,0.0,161,520,0.01,166,825,0.0,165,215,249,-13.65
2004,Maldives,181,0.0,167,642,0.01,163,823,0.0,166,461,319,44.51
2004,Seychelles,291,0.0,163,497,0.01,167,788,0.0,167,206,138,49.28
2004,Bhutan,183,0.0,166,411,0.0,172,594,0.0,168,228,116,96.55
2004,Antigua and Barbuda,57,0.0,178,454,0.0,169,511,0.0,169,397,377,5.31
2004,Saint Lucia,80,0.0,175,422,0.0,171,502,0.0,170,342,341,0.29
2004,Eritrea,11,0.0,193,480,0.01,168,491,0.0,171,469,426,10.09
2004,Somalia,180,0.0,168,298,0.0,174,478,0.0,172,118,88,34.09
2004,Cabo Verde,15,0.0,191,431,0.0,170,446,0.0,173,416,338,23.08
2004,Liberia,104,0.0,171,337,0.0,173,441,0.0,174,233,61,281.97
2004,Sierra Leone,139,0.0,169,286,0.0,175,425,0.0,175,147,211,-30.33
2004,Rwanda,98,0.0,172,284,0.0,176,382,0.0,176,186,196,-5.1
2004,Djibouti,38,0.0,183,261,0.0,177,299,0.0,177,223,201,10.95
2004,Samoa,85,0.0,174,210,0.0,181,295,0.0,178,125,63,98.41
2004,Central African Republic,134,0.0,170,151,0.0,184,285,0.0,179,17,-10,-270.0
2004,Grenada,32,0.0,186,233,0.0,178,265,0.0,180,201,212,-5.19
2004,Saint Vincent and the Grenadines,37,0.0,184,226,0.0,180,263,0.0,181,189,163,15.95
2004,The Gambia,18,0.0,189,229,0.0,179,247,0.0,182,211,151,39.74
2004,Burundi,47,0.0,180,176,0.0,183,223,0.0,183,129,119,8.4
2004,Saint Kitts and Nevis,40,0.0,182,183,0.0,182,223,0.0,183,143,158,-9.49
2004,Solomon Islands,97,0.0,173,121,0.0,189,218,0.0,185,24,20,20.0
2004,Dominica,42,0.0,181,144,0.0,186,186,0.0,186,102,88,15.91
2004,Vanuatu,37,0.0,184,128,0.0,188,165,0.0,187,91,78,16.67
2004,Guinea-Bissau,76,0.0,176,83,0.0,194,159,0.0,188,7,0,
2004,Timor-Leste,7,0.0,195,146,0.0,185,153,0.0,189,139,122,13.93
2004,"Micronesia, Federated States of",17,0.0,190,133,0.0,187,150,0.0,190,116,90,28.89
2004,Tonga,15,0.0,191,105,0.0,191,120,0.0,191,90,76,18.42
2004,Palau,6,0.0,197,107,0.0,190,113,0.0,192,101,80,26.25
2004,Comoros,19,0.0,188,86,0.0,192,105,0.0,193,67,43,55.81
2004,Marshall Islands,20,0.0,187,84,0.0,193,104,0.0,194,64,60,6.67
2004,Cook Islands,7,0.0,195,76,0.0,195,83,0.0,195,69,62,11.29
2004,Saint Pierre and Miquelon,8,0.0,194,74,0.0,196,82,0.0,196,66,67,-1.49
2004,Kiribati,2,0.0,200,59,0.0,197,61,0.0,197,57,49,16.33
2004,Guam,53,0.0,179,0,0.0,202,53,0.0,198,-53,-43,23.26
2004,Sao Tomé and Principe,5,0.0,198,41,0.0,198,46,0.0,199,36,34,5.88
2004,Montserrat,4,0.0,199,29,0.0,199,33,0.0,200,25,26,-3.85
2004,Tuvalu,0,0.0,201,11,0.0,200,11,0.0,201,11,8,37.5
2004,Niue,0,0.0,201,8,0.0,201,8,0.0,202,8,2,300.0
2003,United States of America,724771,9.55,2,1303050,16.78,1,2027821,13.21,1,578279,507127,14.03
2003,Germany,751560,9.91,1,604612,7.78,2,1356172,8.83,2,-146948,-125548,17.05
2003,Japan,471817,6.22,3,382930,4.93,6,854747,5.57,3,-88887,-79532,11.76
2003,China,438228,5.78,4,412760,5.31,3,850988,5.54,4,-25468,-30426,-16.3
2003,France,392039,5.17,5,398840,5.13,4,790879,5.15,5,6801,-2457,-376.8
2003,United Kingdom,308651,4.07,6,394573,5.08,5,703224,4.58,6,85922,78924,8.87
2003,Italy,299333,3.95,7,297519,3.83,7,596852,3.89,7,-1814,-7412,-75.53
2003,Netherlands,296012,3.9,8,264704,3.41,8,560716,3.65,8,-31308,-24793,26.28
2003,Canada,272739,3.59,9,245021,3.15,9,517760,3.37,9,-27718,-24895,11.34
2003,Belgium,255617,3.37,10,234945,3.02,10,490562,3.19,10,-20672,-17816,16.03
2003,"Hong Kong, China",228708,3.01,11,233249,3.0,11,461957,3.01,11,4541,6041,-24.83
2003,"Korea, Republic of",193817,2.55,12,178827,2.3,13,372644,2.43,12,-14990,-10345,44.9
2003,Spain,156147,2.06,15,208602,2.69,12,364749,2.38,13,52455,39418,33.07
2003,Mexico,165396,2.18,13,175039,2.25,14,340435,2.22,14,9643,12405,-22.27
2003,Singapore,159902,2.11,14,136218,1.75,15,296120,1.93,15,-23684,-8736,171.11
2003,Chinese Taipei,150298,1.98,16,128130,1.65,16,278428,1.81,16,-22168,-21749,1.93
2003,Russian Federation,135929,1.79,17,76070,0.98,22,211999,1.38,17,-59859,-46335,29.19
2003,Switzerland,104822,1.38,18,100239,1.29,17,205061,1.34,18,-4583,-4510,1.62
2003,Austria,97146,1.28,21,99532,1.28,18,196678,1.28,19,2386,-374,-737.97
2003,Malaysia,104706,1.38,19,83299,1.07,21,188005,1.22,20,-21407,-14300,49.7
2003,Sweden,102104,1.35,20,83540,1.08,20,185644,1.21,21,-18564,-14544,27.64
2003,Australia,70377,0.93,26,89084,1.15,19,159461,1.04,22,18707,7657,144.31
2003,Thailand,80324,1.06,24,75824,0.98,23,156148,1.02,23,-4500,-3463,29.95
2003,Ireland,92755,1.22,23,53886,0.69,28,146641,0.96,24,-38869,-35866,8.37
2003,"Saudi Arabia, Kingdom of",93245,1.23,22,41704,0.54,38,134949,0.88,25,-51541,-40160,28.34
2003,India,58963,0.78,31,72558,0.93,24,131521,0.86,26,13595,7267,87.08
2003,Brazil,73203,0.96,25,50881,0.66,31,124084,0.81,27,-22322,-10716,108.31
2003,Denmark,66512,0.88,29,57429,0.74,27,123941,0.81,28,-9083,-7175,26.59
2003,Poland,53762,0.71,32,68272,0.88,26,122034,0.79,29,14510,14166,2.43
2003,United Arab Emirates,67135,0.88,28,52074,0.67,29,119209,0.78,30,-15061,-9511,58.35
2003,Türkiye,47253,0.62,35,69340,0.89,25,116593,0.76,31,22087,15495,42.54
2003,Norway,68321,0.9,27,40055,0.52,39,108376,0.71,32,-28266,-24789,14.03
2003,Indonesia,64108,0.84,30,42196,0.54,37,106304,0.69,33,-21912,-20826,5.21
2003,Czech Republic,48702,0.64,34,51728,0.67,30,100430,0.65,34,3026,2164,39.83
2003,Finland,53171,0.7,33,42513,0.55,36,95684,0.62,35,-10658,-10927,-2.46
2003,Hungary,43094,0.57,36,47808,0.62,32,90902,0.59,36,4714,3238,45.58
2003,Portugal,31757,0.42,41,47200,0.61,33,78957,0.51,37,15443,14248,8.39
2003,Philippines,36231,0.48,38,42576,0.55,35,78807,0.51,38,6345,5884,7.83
2003,South Africa,36482,0.48,37,39748,0.51,40,76230,0.5,39,3266,-456,-816.23
2003,Israel,31784,0.42,40,36303,0.47,41,68087,0.44,40,4519,6170,-26.76
2003,Iran,33750,0.44,39,24798,0.32,43,58548,0.38,41,-8952,-7620,17.48
2003,Greece,13382,0.18,53,44852,0.58,34,58234,0.38,42,31470,21156,48.75
2003,Ukraine,23067,0.3,46,23020,0.3,45,46087,0.3,43,-47,-980,-95.2
2003,Viet Nam,20149,0.27,50,25256,0.33,42,45405,0.3,44,5107,3040,67.99
2003,Slovak Republic,21837,0.29,47,22523,0.29,46,44360,0.29,45,686,2159,-68.23
2003,Argentina,29566,0.39,42,13834,0.18,54,43400,0.28,46,-15732,-16660,-5.57
2003,Romania,17662,0.23,51,23983,0.31,44,41645,0.27,47,6321,3977,58.94
2003,Chile,21664,0.29,48,19322,0.25,47,40986,0.27,48,-2342,-1089,115.06
2003,"Venezuela, Bolivarian Republic of",27230,0.36,43,9256,0.12,66,36486,0.24,49,-17974,-13818,30.08
2003,Algeria,23163,0.31,45,12380,0.16,57,35543,0.23,50,-10783,-6830,57.88
2003,New Zealand,16527,0.22,52,18559,0.24,48,35086,0.23,51,2032,664,206.02
2003,Nigeria,24031,0.32,44,10853,0.14,62,34884,0.23,52,-13178,-10428,26.37
2003,"Kuwait, the State of",20678,0.27,49,10987,0.14,59,31665,0.21,53,-9691,-6368,52.18
2003,Luxembourg,13297,0.18,55,16165,0.21,49,29462,0.19,54,2868,2437,17.69
2003,Colombia,13080,0.17,56,13889,0.18,52,26969,0.18,55,809,800,1.13
2003,Slovenia,12766,0.17,58,13845,0.18,53,26611,0.17,56,1079,578,86.68
2003,Pakistan,11930,0.16,59,13038,0.17,55,24968,0.16,57,1108,1320,-16.06
2003,Morocco,8778,0.12,66,14250,0.18,50,23028,0.15,58,5472,4015,36.29
2003,Belarus,9946,0.13,62,11558,0.15,58,21504,0.14,59,1612,1071,50.51
2003,Kazakhstan,12927,0.17,57,8409,0.11,68,21336,0.14,60,-4518,-3086,46.4
2003,Croatia,6187,0.08,74,14209,0.18,51,20396,0.13,61,8022,5805,38.19
2003,Egypt,7408,0.1,69,12950,0.17,56,20358,0.13,62,5542,7224,-23.28
2003,Iraq,9711,0.13,63,9934,0.13,64,19645,0.13,63,223,-2402,-109.28
2003,Tunisia,8027,0.11,67,10910,0.14,60,18937,0.12,64,2883,2652,8.71
2003,Oman,11669,0.15,60,6801,0.09,75,18470,0.12,65,-4868,-4876,-0.16
2003,Bulgaria,7543,0.1,68,10871,0.14,61,18414,0.12,66,3328,2221,49.84
2003,Qatar,13382,0.18,53,4897,0.06,84,18279,0.12,67,-8485,-6926,22.51
2003,Peru,9091,0.12,65,8414,0.11,67,17505,0.11,68,-677,-221,206.33
2003,Bangladesh,6990,0.09,71,10434,0.13,63,17424,0.11,69,3444,2443,40.97
2003,Lithuania,7162,0.09,70,9803,0.13,65,16965,0.11,70,2641,2234,18.22
2003,Angola,9508,0.13,64,5480,0.07,81,14988,0.1,71,-4028,-4568,-11.82
2003,Libya,10540,0.14,61,3328,0.04,93,13868,0.09,72,-7212,-4661,54.73
2003,Costa Rica,6102,0.08,75,7663,0.1,72,13765,0.09,73,1561,1924,-18.87
2003,Estonia,5622,0.07,78,7967,0.1,70,13589,0.09,74,2345,1527,53.57
2003,Dominican Republic,5471,0.07,79,7627,0.1,73,13098,0.09,75,2156,3673,-41.3
2003,Ecuador,6223,0.08,73,6703,0.09,76,12926,0.08,76,480,1389,-65.44
2003,Guatemala,4459,0.06,82,8127,0.1,69,12586,0.08,77,3668,3497,4.89
2003,"Bahrain, Kingdom of",6632,0.09,72,5657,0.07,80,12289,0.08,78,-975,-781,24.84
2003,Sri Lanka,5125,0.07,81,6672,0.09,77,11797,0.08,79,1547,1406,10.03
2003,Syrian Arab Republic,5731,0.08,77,5111,0.07,83,10842,0.07,80,-620,-2048,-69.73
2003,Serbia and Montenegro,2650,0.03,95,7952,0.1,71,10602,0.07,81,5302,4045,31.08
2003,Lebanese Republic,1813,0.02,111,7315,0.09,74,9128,0.06,82,5502,5322,3.38
2003,Trinidad and Tobago,5178,0.07,80,3892,0.05,89,9070,0.06,83,-1286,-237,442.62
2003,Côte d'Ivoire,5788,0.08,76,3279,0.04,94,9067,0.06,84,-2509,-2676,-6.24
2003,El Salvador,3128,0.04,88,5754,0.07,78,8882,0.06,85,2626,2188,20.02
2003,Jordan,3082,0.04,89,5743,0.07,79,8825,0.06,86,2661,2306,15.39
2003,Honduras,3754,0.05,84,4774,0.06,86,8528,0.06,87,1020,637,60.13
2003,Latvia,2893,0.04,91,5234,0.07,82,8127,0.05,88,2341,1761,32.94
2003,Yemen,3733,0.05,85,3675,0.05,91,7408,0.05,89,-58,-415,-86.02
2003,Cuba,1688,0.02,112,4673,0.06,87,6361,0.04,90,2985,2755,8.35
2003,Turkmenistan,3632,0.05,86,2512,0.03,106,6144,0.04,91,-1120,-730,53.42
2003,Bosnia and Herzegovina,1340,0.02,118,4801,0.06,85,6141,0.04,92,3461,2867,20.72
2003,Kenya,2411,0.03,101,3725,0.05,90,6136,0.04,93,1314,1129,16.39
2003,Uzbekistan,3189,0.04,87,2662,0.03,102,5851,0.04,94,-527,-88,498.86
2003,"Macao, China",2581,0.03,98,3232,0.04,95,5813,0.04,95,651,653,-0.31
2003,Brunei Darussalam,4421,0.06,83,1327,0.02,135,5748,0.04,96,-3094,-2146,44.18
2003,Ghana,2324,0.03,103,3210,0.04,97,5534,0.04,97,886,870,1.84
2003,Malta,2252,0.03,105,3227,0.04,96,5479,0.04,98,975,618,57.77
2003,Sudan,2542,0.03,99,2882,0.04,99,5424,0.04,99,340,497,-31.59
2003,Cyprus,923,0.01,129,4466,0.06,88,5389,0.04,100,3543,3243,9.25
2003,Botswana,2810,0.04,92,2448,0.03,107,5258,0.03,101,-362,-580,-37.59
2003,Azerbaijan,2592,0.03,96,2626,0.03,103,5218,0.03,102,34,-501,-106.79
2003,Iceland,2381,0.03,102,2827,0.04,100,5208,0.03,103,446,46,869.57
2003,Jamaica,1180,0.02,122,3639,0.05,92,4819,0.03,104,2459,2419,1.65
2003,Paraguay,2585,0.03,97,2228,0.03,112,4813,0.03,105,-357,-657,-45.66
2003,Cambodia,2118,0.03,108,2560,0.03,105,4678,0.03,106,442,395,11.9
2003,Myanmar,2458,0.03,100,2070,0.03,117,4528,0.03,107,-388,-691,-43.85
2003,"Aruba, Netherlands with respect to",2052,0.03,109,2397,0.03,108,4449,0.03,108,345,529,-34.78
2003,Cameroon,2283,0.03,104,2163,0.03,114,4446,0.03,109,-120,64,-287.5
2003,Uruguay,2206,0.03,107,2190,0.03,113,4396,0.03,110,-16,103,-115.53
2003,Gabon,3062,0.04,90,1206,0.02,139,4268,0.03,111,-1856,-1274,45.68
2003,Mauritius,1898,0.03,110,2363,0.03,110,4261,0.03,112,465,358,29.89
2003,Panama,864,0.01,130,3086,0.04,98,3950,0.03,113,2222,2136,4.03
2003,Netherlands Antilles,1161,0.02,123,2606,0.03,104,3767,0.02,114,1445,659,119.27
2003,Equatorial Guinea,2801,0.04,93,908,0.01,146,3709,0.02,115,-1893,-1610,17.58
2003,North Macedonia,1367,0.02,117,2306,0.03,111,3673,0.02,116,939,879,6.83
2003,Senegal,1257,0.02,120,2391,0.03,109,3648,0.02,117,1134,891,27.27
2003,Papua New Guinea,2207,0.03,106,1367,0.02,134,3574,0.02,118,-840,-504,66.67
2003,Congo,2677,0.04,94,831,0.01,150,3508,0.02,119,-1846,-1605,15.02
2003,Zimbabwe,1670,0.02,113,1710,0.02,125,3380,0.02,120,40,-261,-115.33
2003,Tanzania,1216,0.02,121,2125,0.03,115,3341,0.02,121,909,680,33.68
2003,Namibia,1262,0.02,119,1980,0.03,120,3242,0.02,122,718,398,80.4
2003,"Bolivia, Plurinational State of",1597,0.02,115,1616,0.02,126,3213,0.02,123,19,476,-96.01
2003,Ethiopia,496,0.01,149,2686,0.03,101,3182,0.02,124,2190,1114,96.59
2003,Eswatini,1638,0.02,114,1519,0.02,130,3157,0.02,125,-119,-74,60.81
2003,"Korea, Democratic People's Republic of",1066,0.01,124,2049,0.03,118,3115,0.02,126,983,886,10.95
2003,Nicaragua,1056,0.01,125,2027,0.03,119,3083,0.02,127,971,939,3.41
2003,Democratic Republic of the Congo,1378,0.02,116,1495,0.02,131,2873,0.02,128,117,-51,-329.41
2003,Mozambique,1045,0.01,126,1753,0.02,124,2798,0.02,129,708,733,-3.41
2003,Zambia,980,0.01,127,1574,0.02,128,2554,0.02,130,594,146,306.85
2003,Nepal,662,0.01,138,1754,0.02,123,2416,0.02,131,1092,851,28.32
2003,New Caledonia,785,0.01,135,1541,0.02,129,2326,0.02,132,756,516,46.51
2003,Albania,448,0.01,153,1864,0.02,122,2312,0.02,133,1416,1164,21.65
2003,Afghanistan,144,0.0,167,2101,0.03,116,2245,0.01,134,1957,2352,-16.79
2003,Bahamas,365,0.0,154,1874,0.02,121,2239,0.01,135,1509,1450,4.07
2003,Mali,928,0.01,128,1271,0.02,138,2199,0.01,136,343,54,535.19
2003,"Moldova, Republic of",790,0.01,134,1399,0.02,132,2189,0.01,137,609,394,54.57
2003,Madagascar,856,0.01,131,1304,0.02,136,2160,0.01,138,448,141,217.73
2003,Armenia,686,0.01,136,1280,0.02,137,1966,0.01,139,594,482,23.24
2003,Uganda,532,0.01,147,1375,0.02,133,1907,0.01,140,843,586,43.86
2003,Fiji,668,0.01,137,1205,0.02,140,1873,0.01,141,537,386,39.12
2003,French Polynesia,156,0.0,164,1585,0.02,127,1741,0.01,142,1429,1109,28.85
2003,Tajikistan,797,0.01,133,881,0.01,148,1678,0.01,143,84,-17,-594.12
2003,Georgia,461,0.01,151,1141,0.01,143,1602,0.01,144,680,450,51.11
2003,Lesotho,476,0.01,150,1121,0.01,144,1597,0.01,145,645,457,41.14
2003,Haiti,347,0.0,156,1188,0.02,142,1535,0.01,146,841,850,-1.06
2003,Northern Mariana Islands,838,0.01,132,660,0.01,157,1498,0.01,147,-178,-179,-0.56
2003,Barbados,250,0.0,163,1195,0.02,141,1445,0.01,148,945,797,18.57
2003,Benin,541,0.01,145,892,0.01,147,1433,0.01,149,351,277,26.71
2003,Mongolia,616,0.01,140,801,0.01,151,1417,0.01,150,185,167,10.78
2003,Chad,601,0.01,142,790,0.01,153,1391,0.01,151,189,1461,-87.06
2003,Togo,598,0.01,143,775,0.01,154,1373,0.01,152,177,164,7.93
2003,Suriname,638,0.01,139,704,0.01,156,1342,0.01,153,66,23,186.96
2003,Malawi,534,0.01,146,793,0.01,152,1327,0.01,154,259,291,-11.0
2003,Kyrgyz Republic,582,0.01,144,717,0.01,155,1299,0.01,155,135,101,33.66
2003,Guinea,609,0.01,141,640,0.01,158,1249,0.01,156,31,-42,-173.81
2003,Burkina Faso,321,0.0,159,925,0.01,145,1246,0.01,157,604,492,22.76
2003,Guyana,513,0.01,148,576,0.01,161,1089,0.01,158,63,76,-17.11
2003,American Samoa,460,0.01,152,611,0.01,160,1071,0.01,159,151,98,54.08
2003,Niger,352,0.0,155,622,0.01,159,974,0.01,160,270,189,42.86
2003,Bermuda,52,0.0,177,833,0.01,149,885,0.01,161,781,691,13.02
2003,Mauritania,318,0.0,160,542,0.01,163,860,0.01,162,224,99,126.26
2003,Belize,303,0.0,161,552,0.01,162,855,0.01,163,249,250,-0.4
2003,Greenland,347,0.0,156,460,0.01,166,807,0.01,164,113,84,34.52
2003,Lao People's Democratic Republic,335,0.0,158,462,0.01,165,797,0.01,165,127,146,-13.01
2003,Seychelles,274,0.0,162,412,0.01,169,686,0.0,166,138,192,-28.13
2003,Maldives,152,0.0,166,471,0.01,164,623,0.0,167,319,260,22.69
2003,Antigua and Barbuda,45,0.0,178,422,0.01,168,467,0.0,168,377,361,4.43
2003,Saint Lucia,62,0.0,176,403,0.01,170,465,0.0,169,341,265,28.68
2003,Eritrea,7,0.0,196,433,0.01,167,440,0.0,170,426,486,-12.35
2003,Sierra Leone,92,0.0,171,303,0.0,172,395,0.0,171,211,215,-1.86
2003,Somalia,153,0.0,165,241,0.0,176,394,0.0,172,88,114,-22.81
2003,Bhutan,133,0.0,168,249,0.0,175,382,0.0,173,116,84,38.1
2003,Cabo Verde,13,0.0,191,351,0.0,171,364,0.0,174,338,265,27.55
2003,Rwanda,63,0.0,175,259,0.0,173,322,0.0,175,196,183,7.1
2003,Grenada,42,0.0,180,254,0.0,174,296,0.0,176,212,161,31.68
2003,Liberia,109,0.0,170,170,0.0,180,279,0.0,177,61,2,2950.0
2003,Djibouti,37,0.0,185,238,0.0,177,275,0.0,178,201,161,24.84
2003,Central African Republic,128,0.0,169,118,0.0,186,246,0.0,179,-10,-27,-62.96
2003,Saint Kitts and Nevis,41,0.0,181,199,0.0,179,240,0.0,180,158,162,-2.47
2003,Saint Vincent and the Grenadines,38,0.0,183,201,0.0,178,239,0.0,181,163,136,19.85
2003,Samoa,87,0.0,172,150,0.0,183,237,0.0,182,63,61,3.28
2003,Burundi,38,0.0,183,157,0.0,181,195,0.0,183,119,99,20.2
2003,Solomon Islands,74,0.0,173,94,0.0,189,168,0.0,184,20,9,122.22
2003,Dominica,40,0.0,182,128,0.0,185,168,0.0,184,88,73,20.55
2003,The Gambia,5,0.0,198,156,0.0,182,161,0.0,186,151,144,4.86
2003,"Micronesia, Federated States of",28,0.0,186,118,0.0,186,146,0.0,187,90,77,16.88
2003,Timor-Leste,8,0.0,193,130,0.0,184,138,0.0,188,122,,
2003,Vanuatu,27,0.0,187,105,0.0,188,132,0.0,189,78,70,11.43
2003,Guinea-Bissau,65,0.0,174,65,0.0,196,130,0.0,190,0,5,-100.0
2003,Tonga,18,0.0,189,94,0.0,189,112,0.0,191,76,74,2.7
2003,Comoros,27,0.0,187,70,0.0,195,97,0.0,192,43,34,26.47
2003,Palau,8,0.0,193,88,0.0,191,96,0.0,193,80,77,3.9
2003,Marshall Islands,15,0.0,190,75,0.0,192,90,0.0,194,60,54,11.11
2003,Saint Pierre and Miquelon,8,0.0,193,75,0.0,192,83,0.0,195,67,57,17.54
2003,Cook Islands,9,0.0,192,71,0.0,194,80,0.0,196,62,42,47.62
2003,Kiribati,3,0.0,199,52,0.0,197,55,0.0,197,49,47,4.26
2003,Sao Tomé and Principe,7,0.0,196,41,0.0,198,48,0.0,198,34,26,30.77
2003,Guam,43,0.0,179,0,0.0,202,43,0.0,199,-43,-50,-14.0
2003,Montserrat,2,0.0,200,28,0.0,199,30,0.0,200,26,24,8.33
2003,Tuvalu,0,0.0,201,8,0.0,200,8,0.0,201,8,11,-27.27
2003,Niue,0,0.0,201,2,0.0,201,2,0.0,202,2,2,0.0
2002,United States of America,693103,10.67,1,1200230,18.04,1,1893333,14.4,1,507127,450080,12.67
2002,Germany,615831,9.48,2,490283,7.37,2,1106114,8.41,2,-125548,-85526,46.8
2002,Japan,416726,6.41,3,337194,5.07,4,753920,5.73,3,-79532,-54407,46.18
2002,France,331719,5.11,4,329262,4.95,5,660981,5.03,4,-2457,5229,-146.99
2002,United Kingdom,281409,4.33,6,360333,5.42,3,641742,4.88,5,78924,66287,19.06
2002,China,325596,5.01,5,295170,4.44,6,620766,4.72,6,-30426,-22545,34.96
2002,Italy,254427,3.92,7,247015,3.71,7,501442,3.81,7,-7412,-8270,-10.37
2002,Canada,252394,3.88,8,227499,3.42,8,479893,3.65,8,-24895,-32567,-23.56
2002,Netherlands,244058,3.76,9,219265,3.3,9,463323,3.52,9,-24793,-22217,11.59
2002,Belgium,216127,3.33,10,198311,2.98,11,414438,3.15,10,-17816,-11685,52.47
2002,"Hong Kong, China",201928,3.11,11,207969,3.13,10,409897,3.12,11,6041,10942,-44.79
2002,Mexico,160682,2.47,13,173087,2.6,12,333769,2.54,12,12405,14492,-14.4
2002,"Korea, Republic of",162471,2.5,12,152126,2.29,14,314597,2.39,13,-10345,-9341,10.75
2002,Spain,125687,1.93,15,165105,2.48,13,290792,2.21,14,39418,37990,3.76
2002,Chinese Taipei,135080,2.08,14,113331,1.7,16,248411,1.89,15,-21749,-17956,21.12
2002,Singapore,125177,1.93,16,116441,1.75,15,241618,1.84,16,-8736,-5751,51.9
2002,Switzerland,91699,1.41,19,87189,1.31,17,178888,1.36,17,-4510,1958,-330.34
2002,Malaysia,94061,1.45,18,79761,1.2,18,173822,1.32,18,-14300,-14225,0.53
2002,Russian Federation,107301,1.65,17,60966,0.92,23,168267,1.28,19,-46335,-48120,-3.71
2002,Austria,78673,1.21,22,78299,1.18,19,156972,1.19,20,-374,3882,-109.63
2002,Sweden,81499,1.25,21,66955,1.01,21,148454,1.13,21,-14544,-12445,16.87
2002,Ireland,88265,1.36,20,52399,0.79,26,140664,1.07,22,-35866,-32279,11.11
2002,Australia,65033,1.0,25,72690,1.09,20,137723,1.05,23,7657,501,1428.34
2002,Thailand,68108,1.05,24,64645,0.97,22,132753,1.01,24,-3463,-3006,15.2
2002,Brazil,60439,0.93,26,49723,0.75,29,110162,0.84,25,-10716,95,-11380.0
2002,Denmark,57495,0.88,29,50320,0.76,28,107815,0.82,26,-7175,-6383,12.41
2002,India,49250,0.76,31,56517,0.85,24,105767,0.8,27,7267,7031,3.36
2002,"Saudi Arabia, Kingdom of",72453,1.12,23,32293,0.49,39,104746,0.8,28,-40160,-36841,9.01
2002,Indonesia,59166,0.91,28,38340,0.58,34,97506,0.74,29,-20826,-19827,5.04
2002,Poland,41133,0.63,33,55299,0.83,25,96432,0.73,30,14166,14186,-0.14
2002,United Arab Emirates,52163,0.8,30,42652,0.64,30,94815,0.72,31,-9511,-11121,-14.48
2002,Norway,59662,0.92,27,34873,0.52,37,94535,0.72,32,-24789,-26236,-5.52
2002,Türkiye,36059,0.55,35,51554,0.77,27,87613,0.67,33,15495,10065,53.95
2002,Finland,45145,0.69,32,34218,0.51,38,79363,0.6,34,-10927,-10598,3.1
2002,Czech Republic,38492,0.59,34,40656,0.61,32,79148,0.6,35,2164,2973,-27.21
2002,Philippines,35208,0.54,36,41092,0.62,31,76300,0.58,36,5884,2771,112.34
2002,Hungary,34517,0.53,37,37755,0.57,35,72272,0.55,37,3238,3181,1.79
2002,Portugal,25908,0.4,42,40156,0.6,33,66064,0.5,38,14248,15382,-7.37
2002,Israel,29347,0.45,39,35517,0.53,36,64864,0.49,39,6170,6401,-3.61
2002,South Africa,29723,0.46,38,29267,0.44,41,58990,0.45,40,-456,-1010,-54.85
2002,Iran,28237,0.43,40,20617,0.31,42,48854,0.37,41,-7620,-8980,-15.14
2002,Greece,10414,0.16,57,31570,0.47,40,41984,0.32,42,21156,21512,-1.65
2002,"Venezuela, Bolivarian Republic of",26781,0.41,41,12963,0.19,49,39744,0.3,43,-13818,-8344,65.6
2002,Viet Nam,16706,0.26,48,19746,0.3,43,36452,0.28,44,3040,1189,155.68
2002,Chile,18180,0.28,45,17091,0.26,45,35271,0.27,45,-1089,-843,29.18
2002,Ukraine,17957,0.28,47,16977,0.26,46,34934,0.27,46,-980,-490,100.0
2002,Argentina,25650,0.39,43,8990,0.14,62,34640,0.26,47,-16660,-6223,167.72
2002,Romania,13877,0.21,52,17854,0.27,44,31731,0.24,48,3977,4174,-4.72
2002,Slovak Republic,14405,0.22,50,16564,0.25,47,30969,0.24,49,2159,2165,-0.28
2002,Algeria,18799,0.29,44,11969,0.18,53,30768,0.23,50,-6830,-9193,-25.7
2002,New Zealand,14383,0.22,51,15047,0.23,48,29430,0.22,51,664,-422,-257.35
2002,Nigeria,17975,0.28,46,7547,0.11,68,25522,0.19,52,-10428,-6459,61.45
2002,Colombia,11911,0.18,54,12711,0.19,51,24622,0.19,53,800,544,47.06
2002,"Kuwait, the State of",15369,0.24,49,9001,0.14,61,24370,0.19,54,-6368,-8334,-23.59
2002,Luxembourg,10214,0.16,59,12651,0.19,52,22865,0.17,55,2437,2572,-5.25
2002,Iraq,12219,0.19,53,9817,0.15,58,22036,0.17,56,-2402,248,-1068.55
2002,Slovenia,10366,0.16,58,10944,0.16,56,21310,0.16,57,578,893,-35.27
2002,Pakistan,9913,0.15,60,11233,0.17,55,21146,0.16,58,1320,953,38.51
2002,Morocco,7849,0.12,64,11864,0.18,54,19713,0.15,59,4015,3894,3.11
2002,Egypt,5546,0.09,72,12770,0.19,50,18316,0.14,60,7224,8551,-15.52
2002,Oman,11172,0.17,55,6296,0.09,75,17468,0.13,61,-4876,-5141,-5.15
2002,Belarus,8021,0.12,63,9092,0.14,60,17113,0.13,62,1071,835,28.26
2002,Tunisia,6874,0.11,67,9526,0.14,59,16400,0.12,63,2652,2898,-8.49
2002,Kazakhstan,9670,0.15,61,6584,0.1,71,16254,0.12,64,-3086,-2193,40.72
2002,Croatia,4906,0.08,78,10711,0.16,57,15617,0.12,65,5805,4481,29.55
2002,Peru,7714,0.12,65,7493,0.11,69,15207,0.12,66,-221,290,-176.21
2002,Qatar,10978,0.17,56,4052,0.06,85,15030,0.11,67,-6926,-7113,-2.63
2002,Bangladesh,6149,0.09,69,8592,0.13,64,14741,0.11,68,2443,2938,-16.85
2002,Dominican Republic,5165,0.08,76,8838,0.13,63,14003,0.11,69,3673,3503,4.85
2002,Bulgaria,5733,0.09,71,7954,0.12,65,13687,0.1,70,2221,2161,2.78
2002,Lithuania,5475,0.08,73,7709,0.12,66,13184,0.1,71,2234,1770,26.21
2002,Costa Rica,5264,0.08,75,7188,0.11,70,12452,0.09,72,1924,1548,24.29
2002,Angola,8328,0.13,62,3760,0.06,88,12088,0.09,73,-4568,-3355,36.15
2002,Guatemala,4162,0.06,81,7659,0.12,67,11821,0.09,74,3497,3141,11.33
2002,Ecuador,5042,0.08,77,6431,0.1,73,11473,0.09,75,1389,685,102.77
2002,Syrian Arab Republic,6536,0.1,68,4488,0.07,81,11024,0.08,76,-2048,-496,312.9
2002,"Bahrain, Kingdom of",5794,0.09,70,5013,0.08,80,10807,0.08,77,-781,-1271,-38.55
2002,Sri Lanka,4699,0.07,79,6105,0.09,76,10804,0.08,78,1406,1157,21.52
2002,Libya,7586,0.12,66,2925,0.04,94,10511,0.08,79,-4661,-6467,-27.93
2002,Estonia,4336,0.07,80,5863,0.09,77,10199,0.08,80,1527,1215,25.68
2002,Serbia and Montenegro,2275,0.04,97,6320,0.09,74,8595,0.07,81,4045,2934,37.87
2002,El Salvador,2996,0.05,87,5184,0.08,78,8180,0.06,82,2188,2163,1.16
2002,Honduras,3745,0.06,83,4382,0.07,82,8127,0.06,83,637,729,-12.62
2002,Côte d'Ivoire,5275,0.08,74,2599,0.04,98,7874,0.06,84,-2676,-1398,91.42
2002,Jordan,2770,0.04,89,5076,0.08,79,7846,0.06,85,2306,2578,-10.55
2002,Lebanese Republic,1238,0.02,115,6560,0.1,72,7798,0.06,86,5322,6287,-15.35
2002,Trinidad and Tobago,3880,0.06,82,3643,0.05,89,7523,0.06,87,-237,-711,-66.67
2002,Latvia,2285,0.04,95,4046,0.06,86,6331,0.05,88,1761,1505,17.01
2002,Yemen,3336,0.05,85,2921,0.04,95,6257,0.05,89,-415,-908,-54.3
2002,Cuba,1421,0.02,113,4176,0.06,83,5597,0.04,90,2755,3178,-13.31
2002,"Macao, China",2356,0.04,93,3009,0.05,92,5365,0.04,91,653,524,24.62
2002,Kenya,2116,0.03,101,3245,0.05,91,5361,0.04,92,1129,1248,-9.54
2002,Myanmar,3015,0.05,86,2324,0.03,102,5339,0.04,93,-691,491,-240.73
2002,Brunei Darussalam,3702,0.06,84,1556,0.02,124,5258,0.04,94,-2146,-2481,-13.5
2002,Turkmenistan,2850,0.04,88,2120,0.03,107,4970,0.04,95,-730,-450,62.22
2002,Uzbekistan,2513,0.04,90,2425,0.04,101,4938,0.04,96,-88,106,-183.02
2002,Cyprus,843,0.01,129,4086,0.06,84,4929,0.04,97,3243,2947,10.04
2002,Bosnia and Herzegovina,1005,0.02,123,3872,0.06,87,4877,0.04,98,2867,2322,23.47
2002,Malta,2028,0.03,102,2646,0.04,97,4674,0.04,99,618,709,-12.83
2002,Jamaica,1114,0.02,118,3533,0.05,90,4647,0.04,100,2419,2140,13.04
2002,Ghana,1850,0.03,107,2720,0.04,96,4570,0.03,101,870,1438,-39.5
2002,Iceland,2229,0.03,98,2275,0.03,104,4504,0.03,102,46,250,-81.6
2002,Sudan,1949,0.03,104,2446,0.04,100,4395,0.03,103,497,259,91.89
2002,Botswana,2425,0.04,91,1845,0.03,115,4270,0.03,104,-580,-701,-17.26
2002,Cambodia,1923,0.03,105,2318,0.03,103,4241,0.03,105,395,594,-33.5
2002,Paraguay,2329,0.04,94,1672,0.03,119,4001,0.03,106,-657,-175,275.43
2002,Mauritius,1801,0.03,109,2159,0.03,106,3960,0.03,107,358,359,-0.28
2002,Netherlands Antilles,1609,0.02,111,2268,0.03,105,3877,0.03,108,659,428,53.97
2002,Azerbaijan,2167,0.03,99,1666,0.03,120,3833,0.03,109,-501,-883,-43.26
2002,Panama,846,0.01,128,2982,0.04,93,3828,0.03,110,2136,2053,4.04
2002,Uruguay,1861,0.03,106,1964,0.03,110,3825,0.03,111,103,1001,-89.71
2002,Zimbabwe,2012,0.03,103,1751,0.03,118,3763,0.03,112,-261,508,-151.38
2002,Cameroon,1802,0.03,108,1866,0.03,113,3668,0.03,113,64,103,-37.86
2002,Gabon,2409,0.04,92,1135,0.02,131,3544,0.03,114,-1274,-1522,-16.29
2002,"Aruba, Netherlands with respect to",1488,0.02,112,2017,0.03,108,3505,0.03,115,529,-51,-1137.25
2002,North Macedonia,1116,0.02,117,1995,0.03,109,3111,0.02,116,879,536,63.99
2002,"Bolivia, Plurinational State of",1299,0.02,114,1775,0.03,117,3074,0.02,117,476,423,12.53
2002,Senegal,1067,0.02,120,1958,0.03,111,3025,0.02,118,891,727,22.56
2002,Congo,2280,0.04,96,675,0.01,151,2955,0.02,119,-1605,-1373,16.9
2002,"Korea, Democratic People's Republic of",1008,0.02,122,1894,0.03,112,2902,0.02,120,886,1021,-13.22
2002,Papua New Guinea,1641,0.03,110,1137,0.02,130,2778,0.02,121,-504,-734,-31.34
2002,Nicaragua,914,0.01,126,1853,0.03,114,2767,0.02,122,939,910,3.19
2002,Tanzania,980,0.02,124,1660,0.02,121,2640,0.02,123,680,861,-21.02
2002,Equatorial Guinea,2117,0.03,100,507,0.01,160,2624,0.02,124,-1610,-922,74.62
2002,Afghanistan,100,0.0,170,2452,0.04,99,2552,0.02,125,2352,1628,44.47
2002,Namibia,1072,0.02,119,1470,0.02,127,2542,0.02,126,398,368,8.15
2002,Mozambique,810,0.01,131,1543,0.02,125,2353,0.02,127,733,360,103.61
2002,Bahamas,389,0.01,149,1839,0.03,116,2228,0.02,128,1450,1553,-6.63
2002,Democratic Republic of the Congo,1132,0.02,116,1081,0.02,134,2213,0.02,129,-51,-90,-43.33
2002,Ethiopia,480,0.01,143,1594,0.02,123,2074,0.02,130,1114,1356,-17.85
2002,Zambia,956,0.01,125,1102,0.02,133,2058,0.02,131,146,95,53.68
2002,Nepal,568,0.01,135,1419,0.02,128,1987,0.02,132,851,736,15.63
2002,Eswatini,1029,0.02,121,955,0.01,140,1984,0.02,133,-74,75,-198.67
2002,Albania,340,0.01,153,1504,0.02,126,1844,0.01,134,1164,1020,14.12
2002,Chad,185,0.0,163,1646,0.02,122,1831,0.01,135,1461,490,198.16
2002,Mali,874,0.01,127,928,0.01,141,1802,0.01,136,54,265,-79.62
2002,"Moldova, Republic of",644,0.01,134,1038,0.02,137,1682,0.01,137,394,324,21.6
2002,Uganda,467,0.01,145,1053,0.02,135,1520,0.01,138,586,1143,-48.73
2002,New Caledonia,492,0.01,139,1008,0.02,138,1500,0.01,139,516,488,5.74
2002,Armenia,505,0.01,138,987,0.01,139,1492,0.01,140,482,531,-9.23
2002,French Polynesia,183,0.0,164,1292,0.02,129,1475,0.01,141,1109,862,28.65
2002,Northern Mariana Islands,825,0.01,130,646,0.01,153,1471,0.01,142,-179,-405,-55.8
2002,Tajikistan,738,0.01,132,721,0.01,148,1459,0.01,143,-17,38,-144.74
2002,Fiji,515,0.01,137,901,0.01,142,1416,0.01,144,386,349,10.6
2002,Haiti,280,0.0,157,1130,0.02,132,1410,0.01,145,850,739,15.02
2002,Guinea,709,0.01,133,667,0.01,152,1376,0.01,146,-42,-130,-67.69
2002,Barbados,242,0.0,161,1039,0.02,136,1281,0.01,147,797,828,-3.74
2002,Mongolia,524,0.01,136,691,0.01,150,1215,0.01,148,167,117,42.74
2002,Lesotho,358,0.01,151,815,0.01,143,1173,0.01,149,457,463,-1.3
2002,Benin,448,0.01,146,725,0.01,147,1173,0.01,149,277,249,11.24
2002,Georgia,346,0.01,152,796,0.01,144,1142,0.01,151,450,435,3.45
2002,Malawi,411,0.01,148,702,0.01,149,1113,0.01,152,291,105,177.14
2002,Madagascar,486,0.01,141,627,0.01,154,1113,0.01,152,141,190,-25.79
2002,Kyrgyz Republic,486,0.01,141,587,0.01,156,1073,0.01,154,101,-9,-1222.22
2002,Guyana,487,0.01,140,563,0.01,157,1050,0.01,155,76,106,-28.3
2002,Togo,427,0.01,147,591,0.01,155,1018,0.01,156,164,196,-16.33
2002,Burkina Faso,247,0.0,160,739,0.01,146,986,0.01,157,492,433,13.63
2002,Suriname,469,0.01,144,492,0.01,161,961,0.01,158,23,58,-60.34
2002,American Samoa,388,0.01,150,486,0.01,162,874,0.01,159,98,189,-48.15
2002,Bermuda,56,0.0,174,747,0.01,145,803,0.01,160,691,684,1.02
2002,Belize,275,0.0,159,525,0.01,159,800,0.01,161,250,348,-28.16
2002,Mauritania,332,0.01,154,431,0.01,165,763,0.01,162,99,110,-10.0
2002,Lao People's Democratic Republic,301,0.0,156,447,0.01,164,748,0.01,163,146,190,-23.16
2002,Niger,279,0.0,158,468,0.01,163,747,0.01,164,189,140,35.0
2002,Greenland,303,0.0,155,387,0.01,169,690,0.01,165,84,56,50.0
2002,Seychelles,228,0.0,162,420,0.01,166,648,0.0,166,192,260,-26.15
2002,Eritrea,52,0.0,176,538,0.01,158,590,0.0,167,486,404,20.3
2002,Maldives,132,0.0,167,392,0.01,168,524,0.0,168,260,283,-8.13
2002,Antigua and Barbuda,39,0.0,181,400,0.01,167,439,0.0,169,361,345,4.64
2002,Somalia,126,0.0,168,240,0.0,174,366,0.0,170,114,120,-5.0
2002,Liberia,176,0.0,165,178,0.0,179,354,0.0,171,2,101,-98.02
2002,Saint Lucia,44,0.0,179,309,0.0,170,353,0.0,172,265,311,-14.79
2002,Sierra Leone,49,0.0,178,264,0.0,172,313,0.0,173,215,153,40.52
2002,Rwanda,65,0.0,172,248,0.0,173,313,0.0,173,183,195,-6.15
2002,Bhutan,113,0.0,169,197,0.0,177,310,0.0,175,84,85,-1.18
2002,Cabo Verde,11,0.0,194,276,0.0,171,287,0.0,176,265,224,18.3
2002,Central African Republic,147,0.0,166,120,0.0,184,267,0.0,177,-27,-35,-22.86
2002,Saint Kitts and Nevis,39,0.0,181,201,0.0,175,240,0.0,178,162,158,2.53
2002,Grenada,38,0.0,183,199,0.0,176,237,0.0,179,161,169,-4.73
2002,Djibouti,36,0.0,185,197,0.0,177,233,0.0,180,161,164,-1.83
2002,Saint Vincent and the Grenadines,38,0.0,183,174,0.0,180,212,0.0,181,136,145,-6.21
2002,Samoa,71,0.0,171,132,0.0,182,203,0.0,182,61,73,-16.44
2002,The Gambia,17,0.0,191,161,0.0,181,178,0.0,183,144,125,15.2
2002,Burundi,30,0.0,186,129,0.0,183,159,0.0,184,99,100,-1.0
2002,Dominica,43,0.0,180,116,0.0,185,159,0.0,184,73,87,-16.09
2002,"Micronesia, Federated States of",27,0.0,187,104,0.0,186,131,0.0,186,77,88,-12.5
2002,Solomon Islands,58,0.0,173,67,0.0,191,125,0.0,187,9,43,-79.07
2002,Palau,20,0.0,188,97,0.0,187,117,0.0,188,77,83,-7.23
2002,Guinea-Bissau,54,0.0,175,59,0.0,193,113,0.0,189,5,-1,-600.0
2002,Vanuatu,20,0.0,188,90,0.0,188,110,0.0,190,70,70,0.0
2002,Tonga,15,0.0,192,89,0.0,189,104,0.0,191,74,66,12.12
2002,Marshall Islands,14,0.0,193,68,0.0,190,82,0.0,192,54,43,25.58
2002,Comoros,19,0.0,190,53,0.0,194,72,0.0,193,34,34,0.0
2002,Saint Pierre and Miquelon,5,0.0,195,62,0.0,192,67,0.0,194,57,60,-5.0
2002,Kiribati,3,0.0,198,50,0.0,195,53,0.0,195,47,36,30.56
2002,Cook Islands,5,0.0,195,47,0.0,196,52,0.0,196,42,40,5.0
2002,Guam,50,0.0,177,0,0.0,201,50,0.0,197,-50,-61,-18.03
2002,Sao Tomé and Principe,5,0.0,195,31,0.0,197,36,0.0,198,26,25,4.0
2002,Montserrat,1,0.0,199,25,0.0,198,26,0.0,199,24,18,33.33
2002,Tuvalu,0,0.0,200,11,0.0,199,11,0.0,200,11,4,175.0
2002,Niue,0,0.0,200,2,0.0,200,2,0.0,201,2,1,100.0
2001,United States of America,729100,11.77,1,1179180,18.42,1,1908280,15.15,1,450080,477382,-5.72
2001,Germany,571645,9.23,2,486119,7.59,2,1057764,8.4,2,-85526,-54613,56.6
2001,Japan,403496,6.51,3,349089,5.45,3,752585,5.97,3,-54407,-99738,-45.45
2001,France,323379,5.22,4,328608,5.13,5,651987,5.18,4,5229,11329,-53.84
2001,United Kingdom,274676,4.43,5,340963,5.33,4,615639,4.89,5,66287,56470,17.38
2001,China,266098,4.3,6,243553,3.8,6,509651,4.05,6,-22545,-24109,-6.49
2001,Canada,259858,4.2,7,227291,3.55,8,487149,3.87,7,-32567,-31849,2.25
2001,Italy,244490,3.95,8,236220,3.69,7,480710,3.82,8,-8270,-1761,369.62
2001,Netherlands,230855,3.73,9,208638,3.26,9,439493,3.49,9,-22217,-14863,49.48
2001,"Hong Kong, China",191066,3.08,10,202008,3.16,10,393074,3.12,10,10942,11359,-3.67
2001,Belgium,190349,3.07,11,178664,2.79,11,369013,2.93,11,-11685,-10860,7.6
2001,Mexico,158547,2.56,12,173039,2.7,12,331586,2.63,12,14492,13097,10.65
2001,"Korea, Republic of",150439,2.43,13,141098,2.2,14,291537,2.31,13,-9341,-11787,-20.75
2001,Spain,116660,1.88,16,154650,2.42,13,271310,2.15,14,37990,40892,-7.1
2001,Singapore,121751,1.97,15,116000,1.81,15,237751,1.89,15,-5751,-3259,76.47
2001,Chinese Taipei,125900,2.03,14,107944,1.69,16,233844,1.86,16,-17956,-10715,67.58
2001,Switzerland,82144,1.33,20,84102,1.31,17,166246,1.32,17,1958,2021,-3.12
2001,Malaysia,87969,1.42,18,73744,1.15,19,161713,1.28,18,-14225,-16266,-12.55
2001,Russian Federation,101884,1.64,17,53764,0.84,24,155648,1.24,19,-48120,-60171,-20.03
2001,Austria,70751,1.14,22,74633,1.17,18,145384,1.15,20,3882,4684,-17.12
2001,Sweden,75645,1.22,21,63200,0.99,21,138845,1.1,21,-12445,-14252,-12.68
2001,Ireland,82835,1.34,19,50556,0.79,25,133391,1.06,22,-32279,-26372,22.4
2001,Australia,63387,1.02,25,63888,1.0,20,127275,1.01,23,501,7659,-93.46
2001,Thailand,64968,1.05,24,61962,0.97,22,126930,1.01,24,-3006,-7040,-57.3
2001,Brazil,58287,0.94,27,58382,0.91,23,116669,0.93,25,95,3524,-97.3
2001,"Saudi Arabia, Kingdom of",68064,1.1,23,31223,0.49,40,99287,0.79,26,-36841,-47345,-22.19
2001,Denmark,51705,0.83,29,45322,0.71,28,97027,0.77,27,-6383,-5735,11.3
2001,Indonesia,57361,0.93,28,37534,0.59,31,94895,0.75,28,-19827,-21808,-9.08
2001,India,43361,0.7,31,50392,0.79,26,93753,0.74,29,7031,9144,-23.11
2001,Norway,59191,0.96,26,32955,0.51,38,92146,0.73,30,-26236,-25667,2.22
2001,Poland,35998,0.58,33,50184,0.78,27,86182,0.68,31,14186,17282,-17.91
2001,United Arab Emirates,48414,0.78,30,37293,0.58,32,85707,0.68,32,-11121,-14826,-24.99
2001,Finland,43237,0.7,32,32639,0.51,39,75876,0.6,33,-10598,-11659,-9.1
2001,Türkiye,31334,0.51,36,41399,0.65,29,72733,0.58,34,10065,26728,-62.34
2001,Czech Republic,33324,0.54,34,36297,0.57,33,69621,0.55,35,2973,2880,3.23
2001,Philippines,32150,0.52,35,34921,0.55,35,67071,0.53,36,2771,-1051,-363.65
2001,Israel,29048,0.47,39,35449,0.55,34,64497,0.51,37,6401,6282,1.89
2001,Hungary,30436,0.49,37,33617,0.53,36,64053,0.51,38,3181,3980,-20.08
2001,Portugal,24108,0.39,43,39490,0.62,30,63598,0.5,39,15382,15589,-1.33
2001,South Africa,29258,0.47,38,28248,0.44,41,57506,0.46,40,-1010,-288,250.69
2001,Argentina,26543,0.43,41,20320,0.32,42,46863,0.37,41,-6223,-1187,424.26
2001,"Venezuela, Bolivarian Republic of",26667,0.43,40,18323,0.29,43,44990,0.36,42,-8344,-17316,-51.81
2001,Greece,11507,0.19,54,33019,0.52,37,44526,0.35,43,21512,21729,-1.0
2001,Iran,25689,0.41,42,16709,0.26,45,42398,0.34,44,-8980,-14841,-39.49
2001,Chile,18272,0.3,45,17429,0.27,44,35701,0.28,45,-843,-703,19.91
2001,Ukraine,16265,0.26,47,15775,0.25,47,32040,0.25,46,-490,-617,-20.58
2001,Viet Nam,15029,0.24,49,16218,0.25,46,31247,0.25,47,1189,1155,2.94
2001,Nigeria,18045,0.29,46,11586,0.18,55,29631,0.24,48,-6459,-12254,-47.29
2001,Algeria,19133,0.31,44,9940,0.16,59,29073,0.23,49,-9193,-12860,-28.51
2001,Slovak Republic,12595,0.2,52,14760,0.23,49,27355,0.22,50,2165,928,133.3
2001,New Zealand,13730,0.22,50,13308,0.21,51,27038,0.21,51,-422,607,-169.52
2001,Romania,11394,0.18,55,15568,0.24,48,26962,0.21,52,4174,2736,52.56
2001,Iraq,12872,0.21,51,13120,0.2,52,25992,0.21,53,248,-7170,-103.46
2001,Colombia,12290,0.2,53,12834,0.2,53,25124,0.2,54,544,-1504,-136.17
2001,"Kuwait, the State of",16203,0.26,48,7869,0.12,65,24072,0.19,55,-8334,-12279,-32.13
2001,Luxembourg,9759,0.16,58,12331,0.19,54,22090,0.18,56,2572,2900,-11.31
2001,Pakistan,9238,0.15,60,10191,0.16,57,19429,0.15,57,953,1836,-48.09
2001,Slovenia,9267,0.15,59,10160,0.16,58,19427,0.15,58,893,1377,-35.15
2001,Egypt,4825,0.08,74,13376,0.21,50,18201,0.14,59,8551,9302,-8.07
2001,Morocco,7144,0.12,64,11038,0.17,56,18182,0.14,60,3894,4102,-5.07
2001,Oman,11074,0.18,56,5933,0.09,73,17007,0.14,61,-5141,-6188,-16.92
2001,Tunisia,6631,0.11,66,9529,0.15,60,16160,0.13,62,2898,2717,6.66
2001,Belarus,7451,0.12,63,8286,0.13,64,15737,0.12,63,835,1320,-36.74
2001,Bangladesh,6080,0.1,68,9018,0.14,62,15098,0.12,64,2938,2494,17.8
2001,Kazakhstan,8639,0.14,62,6446,0.1,70,15085,0.12,65,-2193,-3772,-41.86
2001,Qatar,10871,0.18,57,3758,0.06,85,14629,0.12,66,-7113,-8342,-14.73
2001,Peru,7026,0.11,65,7316,0.11,67,14342,0.11,67,290,460,-36.96
2001,Dominican Republic,5276,0.09,70,8779,0.14,63,14055,0.11,68,3503,3742,-6.39
2001,Croatia,4666,0.08,77,9147,0.14,61,13813,0.11,69,4481,3455,29.7
2001,Bulgaria,5118,0.08,72,7279,0.11,68,12397,0.1,70,2161,1692,27.72
2001,Costa Rica,5021,0.08,73,6569,0.1,69,11590,0.09,71,1548,539,187.2
2001,Libya,8798,0.14,61,2331,0.04,103,11129,0.09,72,-6467,-8000,-19.16
2001,Lithuania,4583,0.07,78,6353,0.1,71,10936,0.09,73,1770,1647,7.47
2001,Sri Lanka,4816,0.08,75,5973,0.09,72,10789,0.09,74,1157,851,35.96
2001,Ecuador,4678,0.08,76,5363,0.08,75,10041,0.08,75,685,-1206,-156.8
2001,Syrian Arab Republic,5248,0.08,71,4752,0.07,81,10000,0.08,76,-496,-819,-39.44
2001,"Bahrain, Kingdom of",5577,0.09,69,4306,0.07,82,9883,0.08,77,-1271,-1561,-18.58
2001,Angola,6534,0.11,67,3179,0.05,91,9713,0.08,78,-3355,-4881,-31.26
2001,Estonia,4015,0.06,80,5230,0.08,76,9245,0.07,79,1215,1222,-0.57
2001,Lebanese Republic,1093,0.02,118,7380,0.12,66,8473,0.07,80,6287,5515,14.0
2001,Guatemala,2466,0.04,90,5607,0.09,74,8073,0.06,81,3141,2460,27.68
2001,El Salvador,2864,0.05,85,5027,0.08,77,7891,0.06,82,2163,2006,7.83
2001,Trinidad and Tobago,4280,0.07,79,3569,0.06,86,7849,0.06,83,-711,-966,-26.4
2001,Honduras,3423,0.06,83,4152,0.06,83,7575,0.06,84,729,645,13.02
2001,Jordan,2293,0.04,97,4871,0.08,78,7164,0.06,85,2578,2698,-4.45
2001,Serbia and Montenegro,1903,0.03,103,4837,0.08,80,6740,0.05,86,2934,1988,47.59
2001,Cuba,1661,0.03,110,4839,0.08,79,6500,0.05,87,3178,3167,0.35
2001,Côte d'Ivoire,3946,0.06,81,2548,0.04,99,6494,0.05,88,-1398,-1406,-0.57
2001,Yemen,3374,0.05,84,2466,0.04,101,5840,0.05,89,-908,-1755,-48.26
2001,Uzbekistan,2708,0.04,86,2814,0.04,98,5522,0.04,90,106,-120,-188.33
2001,Latvia,2001,0.03,101,3506,0.05,87,5507,0.04,91,1505,1334,12.82
2001,Netherlands Antilles,2398,0.04,92,2826,0.04,96,5224,0.04,92,428,853,-49.82
2001,Myanmar,2358,0.04,93,2849,0.04,95,5207,0.04,93,491,751,-34.62
2001,Kenya,1944,0.03,102,3192,0.05,90,5136,0.04,94,1248,1371,-8.97
2001,"Macao, China",2300,0.04,96,2824,0.04,97,5124,0.04,95,524,86,509.3
2001,Uruguay,2060,0.03,98,3061,0.05,93,5121,0.04,96,1001,1171,-14.52
2001,Turkmenistan,2700,0.04,87,2250,0.04,105,4950,0.04,97,-450,-720,-37.5
2001,Cyprus,976,0.02,123,3923,0.06,84,4899,0.04,98,2947,2895,1.8
2001,Ghana,1716,0.03,108,3154,0.05,92,4870,0.04,99,1438,1302,10.45
2001,Brunei Darussalam,3640,0.06,82,1159,0.02,127,4799,0.04,100,-2481,-2796,-11.27
2001,"Aruba, Netherlands with respect to",2423,0.04,91,2372,0.04,102,4795,0.04,101,-51,58,-187.93
2001,Jamaica,1220,0.02,114,3360,0.05,88,4580,0.04,102,2140,2006,6.68
2001,Paraguay,2357,0.04,94,2182,0.03,106,4539,0.04,103,-175,60,-391.67
2001,Bosnia and Herzegovina,1032,0.02,120,3354,0.05,89,4386,0.03,104,2322,2038,13.94
2001,Malta,1822,0.03,104,2531,0.04,100,4353,0.03,105,709,960,-26.15
2001,Botswana,2510,0.04,89,1809,0.03,114,4319,0.03,106,-701,-594,18.01
2001,Iceland,2019,0.03,100,2269,0.04,104,4288,0.03,107,250,688,-63.66
2001,Panama,911,0.01,126,2964,0.05,94,3875,0.03,108,2053,2520,-18.53
2001,Azerbaijan,2314,0.04,95,1431,0.02,125,3745,0.03,109,-883,-573,54.1
2001,Sudan,1699,0.03,109,1958,0.03,109,3657,0.03,110,259,-254,-201.97
2001,Mauritius,1628,0.03,111,1987,0.03,108,3615,0.03,111,359,536,-33.02
2001,Cameroon,1749,0.03,106,1852,0.03,111,3601,0.03,112,103,-344,-129.94
2001,Cambodia,1500,0.02,112,2094,0.03,107,3594,0.03,113,594,550,8.0
2001,Gabon,2524,0.04,88,1002,0.02,136,3526,0.03,114,-1522,-1648,-7.65
2001,"Bolivia, Plurinational State of",1285,0.02,113,1708,0.03,119,2993,0.02,115,423,600,-29.5
2001,Zimbabwe,1207,0.02,115,1715,0.03,117,2922,0.02,116,508,-62,-919.35
2001,Papua New Guinea,1805,0.03,105,1071,0.02,132,2876,0.02,117,-734,-945,-22.33
2001,North Macedonia,1158,0.02,117,1694,0.03,121,2852,0.02,118,536,771,-30.48
2001,Congo,2055,0.03,99,682,0.01,148,2737,0.02,119,-1373,-2024,-32.16
2001,Senegal,1003,0.02,121,1730,0.03,116,2733,0.02,120,727,599,21.37
2001,Namibia,1179,0.02,116,1547,0.02,123,2726,0.02,121,368,230,60.0
2001,Nicaragua,895,0.01,127,1805,0.03,115,2700,0.02,122,910,921,-1.19
2001,"Korea, Democratic People's Republic of",826,0.01,130,1847,0.03,112,2673,0.02,123,1021,978,4.4
2001,Tanzania,851,0.01,129,1712,0.03,118,2563,0.02,124,861,790,8.99
2001,Equatorial Guinea,1735,0.03,107,813,0.01,142,2548,0.02,125,-922,-646,42.72
2001,Bahamas,376,0.01,146,1929,0.03,110,2305,0.02,126,1553,1447,7.33
2001,Ethiopia,455,0.01,141,1811,0.03,113,2266,0.02,127,1356,774,75.19
2001,Nepal,737,0.01,131,1473,0.02,124,2210,0.02,128,736,769,-4.29
2001,Eswatini,1054,0.02,119,1129,0.02,128,2183,0.02,129,75,136,-44.85
2001,Zambia,987,0.02,122,1082,0.02,131,2069,0.02,130,95,-4,-2475.0
2001,Madagascar,928,0.01,125,1118,0.02,129,2046,0.02,131,190,273,-30.4
2001,Uganda,451,0.01,142,1594,0.02,122,2045,0.02,132,1143,1133,0.88
2001,Mozambique,703,0.01,134,1063,0.02,133,1766,0.01,133,360,794,-54.66
2001,Afghanistan,68,0.0,171,1696,0.03,120,1764,0.01,134,1628,1039,56.69
2001,Mali,725,0.01,133,990,0.02,137,1715,0.01,135,265,261,1.53
2001,Democratic Republic of the Congo,880,0.01,128,790,0.01,143,1670,0.01,136,-90,-124,-27.42
2001,Albania,307,0.0,154,1327,0.02,126,1634,0.01,137,1020,830,22.89
2001,Northern Mariana Islands,959,0.02,124,554,0.01,155,1513,0.01,138,-405,-410,-1.22
2001,"Moldova, Republic of",568,0.01,136,892,0.01,139,1460,0.01,139,324,305,6.23
2001,Fiji,537,0.01,137,886,0.01,140,1423,0.01,140,349,245,42.45
2001,New Caledonia,443,0.01,144,931,0.01,138,1374,0.01,141,488,320,52.5
2001,Barbados,259,0.0,159,1087,0.02,130,1346,0.01,142,828,884,-6.33
2001,Tajikistan,650,0.01,135,688,0.01,147,1338,0.01,143,38,-110,-134.55
2001,Guinea,731,0.01,132,601,0.01,153,1332,0.01,144,-130,-54,140.74
2001,Haiti,274,0.0,156,1013,0.02,135,1287,0.01,145,739,718,2.92
2001,French Polynesia,195,0.0,162,1057,0.02,134,1252,0.01,146,862,750,14.93
2001,Armenia,343,0.01,150,874,0.01,141,1217,0.01,147,531,588,-9.69
2001,Mongolia,521,0.01,138,638,0.01,151,1159,0.01,148,117,79,48.1
2001,Georgia,318,0.01,152,753,0.01,144,1071,0.01,149,435,386,12.69
2001,Guyana,478,0.01,139,584,0.01,154,1062,0.01,150,106,75,41.33
2001,Lesotho,280,0.0,155,743,0.01,145,1023,0.01,151,463,589,-21.39
2001,Benin,374,0.01,147,623,0.01,152,997,0.01,152,249,221,12.67
2001,Malawi,445,0.01,143,550,0.01,157,995,0.01,153,105,153,-31.37
2001,Kyrgyz Republic,476,0.01,140,467,0.01,162,943,0.01,154,-9,47,-119.15
2001,Togo,357,0.01,148,553,0.01,156,910,0.01,155,196,199,-1.51
2001,Burkina Faso,223,0.0,160,656,0.01,150,879,0.01,156,433,402,7.71
2001,Chad,189,0.0,163,679,0.01,149,868,0.01,157,490,134,265.67
2001,Suriname,403,0.01,145,461,0.01,164,864,0.01,158,58,130,-55.38
2001,Lao People's Democratic Republic,320,0.01,151,510,0.01,159,830,0.01,159,190,205,-7.32
2001,American Samoa,318,0.01,152,507,0.01,160,825,0.01,160,189,160,18.13
2001,Mauritania,355,0.01,149,465,0.01,163,820,0.01,161,110,99,11.11
2001,Bermuda,36,0.0,182,720,0.01,146,756,0.01,162,684,669,2.24
2001,Seychelles,216,0.0,161,476,0.01,161,692,0.01,163,260,148,75.68
2001,Belize,169,0.0,164,517,0.01,158,686,0.01,164,348,328,6.1
2001,Niger,272,0.0,157,412,0.01,166,684,0.01,165,140,112,25.0
2001,Greenland,268,0.0,158,324,0.01,170,592,0.0,166,56,92,-39.13
2001,Maldives,110,0.0,167,393,0.01,167,503,0.0,167,283,280,1.07
2001,Eritrea,19,0.0,188,423,0.01,165,442,0.0,168,404,434,-6.91
2001,Antigua and Barbuda,41,0.0,179,386,0.01,168,427,0.0,169,345,355,-2.82
2001,Saint Lucia,44,0.0,176,355,0.01,169,399,0.0,170,311,312,-0.32
2001,Rwanda,86,0.0,169,281,0.0,171,367,0.0,171,195,159,22.64
2001,Liberia,128,0.0,166,229,0.0,173,357,0.0,172,101,339,-70.21
2001,Bhutan,106,0.0,168,191,0.0,177,297,0.0,173,85,72,18.06
2001,Somalia,84,0.0,170,204,0.0,175,288,0.0,174,120,94,27.66
2001,Grenada,43,0.0,178,212,0.0,174,255,0.0,175,169,191,-11.52
2001,Central African Republic,142,0.0,165,107,0.0,186,249,0.0,176,-35,-44,-20.45
2001,Cabo Verde,10,0.0,192,234,0.0,172,244,0.0,177,224,219,2.28
2001,Djibouti,32,0.0,183,196,0.0,176,228,0.0,178,164,175,-6.29
2001,Saint Vincent and the Grenadines,41,0.0,179,186,0.0,179,227,0.0,179,145,116,25.0
2001,Saint Kitts and Nevis,31,0.0,184,189,0.0,178,220,0.0,180,158,163,-3.07
2001,Sierra Leone,29,0.0,185,182,0.0,180,211,0.0,181,153,136,12.5
2001,Samoa,63,0.0,172,136,0.0,182,199,0.0,182,73,41,78.05
2001,Burundi,39,0.0,181,139,0.0,181,178,0.0,183,100,98,2.04
2001,Dominica,44,0.0,176,131,0.0,184,175,0.0,184,87,94,-7.45
2001,The Gambia,9,0.0,193,134,0.0,183,143,0.0,185,125,171,-26.9
2001,"Micronesia, Federated States of",26,0.0,186,114,0.0,185,140,0.0,186,88,85,3.53
2001,Solomon Islands,47,0.0,175,90,0.0,188,137,0.0,187,43,23,86.96
2001,Guinea-Bissau,63,0.0,172,62,0.0,192,125,0.0,188,-1,-3,-66.67
2001,Palau,17,0.0,189,100,0.0,187,117,0.0,189,83,115,-27.83
2001,Vanuatu,20,0.0,187,90,0.0,188,110,0.0,190,70,61,14.75
2001,Tonga,7,0.0,194,73,0.0,190,80,0.0,191,66,60,10.0
2001,Saint Pierre and Miquelon,5,0.0,196,65,0.0,191,70,0.0,192,60,64,-6.25
2001,Marshall Islands,13,0.0,191,56,0.0,193,69,0.0,193,43,46,-6.52
2001,Comoros,17,0.0,189,51,0.0,194,68,0.0,194,34,29,17.24
2001,Guam,61,0.0,174,0,0.0,201,61,0.0,195,-61,-74,-17.57
2001,Cook Islands,7,0.0,194,47,0.0,195,54,0.0,196,40,42,-4.76
2001,Kiribati,5,0.0,196,41,0.0,196,46,0.0,197,36,36,0.0
2001,Sao Tomé and Principe,3,0.0,198,28,0.0,197,31,0.0,198,25,27,-7.41
2001,Montserrat,1,0.0,199,19,0.0,198,20,0.0,199,18,21,-14.29
2001,Tuvalu,0,0.0,200,4,0.0,199,4,0.0,200,4,5,-20.0
2001,Niue,0,0.0,200,1,0.0,200,1,0.0,201,1,2,-50.0
2000,United States of America,781918,12.12,1,1259300,18.96,1,2041218,15.59,1,477382,363643,31.28
2000,Germany,551810,8.55,2,497197,7.48,2,1049007,8.01,2,-54613,-69492,-21.41
2000,Japan,479249,7.43,3,379511,5.71,3,858760,6.56,3,-99738,-107615,-7.32
2000,France,327611,5.08,4,338940,5.1,5,666551,5.09,4,11329,-9778,-215.86
2000,United Kingdom,283173,4.39,5,339643,5.11,4,622816,4.76,5,56470,52732,7.09
2000,Canada,276635,4.29,6,244786,3.68,6,521421,3.98,6,-31849,-18263,74.39
2000,Italy,240518,3.73,8,238757,3.59,7,479275,3.66,7,-1761,-14927,-88.2
2000,China,249203,3.86,7,225094,3.39,8,474297,3.62,8,-24109,-29232,-17.53
2000,Netherlands,233130,3.61,9,218267,3.29,9,451397,3.45,9,-14863,-12417,19.7
2000,"Hong Kong, China",202683,3.14,10,214042,3.22,10,416725,3.18,10,11359,6308,80.07
2000,Belgium,188371,2.92,11,177511,2.67,12,365882,2.79,11,-10860,-14342,-24.28
2000,Mexico,166367,2.58,13,179464,2.7,11,345831,2.64,12,13097,9693,35.12
2000,"Korea, Republic of",172268,2.67,12,160481,2.42,13,332749,2.54,13,-11787,-23933,-50.75
2000,Chinese Taipei,151357,2.35,14,140642,2.12,15,291999,2.23,14,-10715,-12177,-12.01
2000,Singapore,137804,2.14,15,134545,2.03,16,272349,2.08,15,-3259,-3620,-9.97
2000,Spain,115251,1.79,16,156143,2.35,14,271394,2.07,16,40892,30913,32.28
2000,Malaysia,98229,1.52,18,81963,1.23,18,180192,1.38,17,-16266,-19232,-15.42
2000,Switzerland,80500,1.25,20,82521,1.24,17,163021,1.24,18,2021,-443,-556.21
2000,Sweden,87132,1.35,19,72880,1.1,19,160012,1.22,19,-14252,-16309,-12.61
2000,Russian Federation,105033,1.63,17,44862,0.68,29,149895,1.14,20,-60171,-36014,67.08
2000,Austria,67710,1.05,24,72394,1.09,20,140104,1.07,21,4684,5260,-10.95
2000,Australia,63870,0.99,26,71529,1.08,21,135399,1.03,22,7659,13078,-41.44
2000,Thailand,68963,1.07,23,61923,0.93,22,130886,1.0,23,-7040,-8123,-13.33
2000,Ireland,77413,1.2,22,51041,0.77,26,128454,0.98,24,-26372,-24470,7.77
2000,Brazil,55119,0.85,28,58643,0.88,23,113762,0.87,25,3524,3754,-6.13
2000,Indonesia,65403,1.01,25,43595,0.66,30,108998,0.83,26,-21808,-17922,21.68
2000,"Saudi Arabia, Kingdom of",77583,1.2,21,30238,0.46,40,107821,0.82,27,-47345,-22750,108.11
2000,Denmark,51292,0.8,29,45557,0.69,28,96849,0.74,28,-5735,-4543,26.24
2000,Norway,60058,0.93,27,34391,0.52,36,94449,0.72,29,-25667,-11289,127.36
2000,India,42379,0.66,32,51523,0.78,25,93902,0.72,30,9144,11312,-19.17
2000,United Arab Emirates,49835,0.77,30,35009,0.53,34,84844,0.65,31,-14826,-4753,211.93
2000,Türkiye,27775,0.43,41,54503,0.82,24,82278,0.63,32,26728,13639,95.97
2000,Poland,31747,0.49,35,49029,0.74,27,80776,0.62,33,17282,18524,-6.7
2000,Finland,46102,0.71,31,34443,0.52,35,80545,0.62,34,-11659,-10129,15.11
2000,Philippines,38078,0.59,33,37027,0.56,33,75105,0.57,35,-1051,-4008,-73.78
2000,Israel,31404,0.49,36,37686,0.57,32,69090,0.53,36,6282,7372,-14.79
2000,Portugal,24363,0.38,43,39952,0.6,31,64315,0.49,37,15589,15433,1.01
2000,Czech Republic,29094,0.45,38,31974,0.48,39,61068,0.47,38,2880,1907,51.02
2000,Hungary,28192,0.44,40,32172,0.48,38,60364,0.46,39,3980,2983,33.42
2000,South Africa,29983,0.46,37,29695,0.45,41,59678,0.46,40,-288,-11,2518.18
2000,Argentina,26341,0.41,42,25154,0.38,42,51495,0.39,41,-1187,2175,-154.57
2000,"Venezuela, Bolivarian Republic of",33529,0.52,34,16213,0.24,44,49742,0.38,42,-17316,-6899,150.99
2000,Greece,11751,0.18,54,33480,0.5,37,45231,0.35,43,21729,19459,11.67
2000,Iran,28739,0.45,39,13898,0.21,49,42637,0.33,44,-14841,-7706,92.59
2000,Chile,19210,0.3,48,18507,0.28,43,37717,0.29,45,-703,-1175,-40.17
2000,Iraq,20380,0.32,46,13210,0.2,50,33590,0.26,46,-7170,-2150,233.49
2000,Algeria,22031,0.34,44,9171,0.14,59,31202,0.24,47,-12860,-3363,282.4
2000,Viet Nam,14483,0.22,50,15638,0.24,45,30121,0.23,48,1155,201,474.63
2000,Nigeria,20975,0.33,45,8721,0.13,61,29696,0.23,49,-12254,-5268,132.61
2000,Ukraine,14573,0.23,49,13956,0.21,47,28529,0.22,50,-617,264,-333.71
2000,New Zealand,13297,0.21,51,13904,0.21,48,27201,0.21,51,607,1844,-67.08
2000,"Kuwait, the State of",19436,0.3,47,7157,0.11,66,26593,0.2,52,-12279,-4547,170.05
2000,Slovak Republic,11832,0.18,53,12760,0.19,52,24592,0.19,53,928,1107,-16.17
2000,Colombia,13043,0.2,52,11539,0.17,53,24582,0.19,54,-1504,-916,64.19
2000,Romania,10412,0.16,57,13148,0.2,51,23560,0.18,55,2736,1899,44.08
2000,Pakistan,9028,0.14,59,10864,0.16,56,19892,0.15,56,1836,1783,2.97
2000,Egypt,5276,0.08,73,14578,0.22,46,19854,0.15,57,9302,12463,-25.36
2000,Luxembourg,8378,0.13,62,11278,0.17,55,19656,0.15,58,2900,3015,-3.81
2000,Morocco,7432,0.12,64,11534,0.17,54,18966,0.14,59,4102,2555,60.55
2000,Slovenia,8770,0.14,61,10147,0.15,57,18917,0.14,60,1377,1542,-10.7
2000,Oman,11319,0.18,56,5131,0.08,73,16450,0.13,61,-6188,-2437,153.92
2000,Belarus,7326,0.11,65,8646,0.13,62,15972,0.12,62,1320,765,72.55
2000,Bangladesh,6389,0.1,67,8883,0.13,60,15272,0.12,63,2494,2834,-12.0
2000,Dominican Republic,5737,0.09,71,9479,0.14,58,15216,0.12,64,3742,2904,28.86
2000,Qatar,11594,0.18,55,3252,0.05,90,14846,0.11,65,-8342,-4714,76.96
2000,Tunisia,5850,0.09,69,8567,0.13,63,14417,0.11,66,2717,2602,4.42
2000,Peru,6955,0.11,66,7415,0.11,65,14370,0.11,67,460,735,-37.41
2000,Kazakhstan,8812,0.14,60,5040,0.08,75,13852,0.11,68,-3772,-2217,70.14
2000,Croatia,4432,0.07,77,7887,0.12,64,12319,0.09,69,3455,3496,-1.17
2000,Costa Rica,5850,0.09,69,6389,0.1,68,12239,0.09,70,539,-307,-275.57
2000,Libya,10081,0.16,58,2081,0.03,107,12162,0.09,71,-8000,-3708,115.75
2000,Sri Lanka,5430,0.08,72,6281,0.09,69,11711,0.09,72,851,1276,-33.31
2000,Bulgaria,4852,0.08,75,6544,0.1,67,11396,0.09,73,1692,1499,12.88
2000,Angola,7921,0.12,63,3040,0.05,94,10961,0.08,74,-4881,-2048,138.33
2000,"Bahrain, Kingdom of",6194,0.1,68,4633,0.07,78,10827,0.08,75,-1561,-665,134.74
2000,Lithuania,3810,0.06,83,5457,0.08,71,9267,0.07,76,1647,1831,-10.05
2000,Estonia,3830,0.06,82,5052,0.08,74,8882,0.07,77,1222,1092,11.9
2000,Ecuador,4927,0.08,74,3721,0.06,83,8648,0.07,78,-1206,-1434,-15.9
2000,Syrian Arab Republic,4634,0.07,76,3815,0.06,82,8449,0.06,79,-819,368,-322.55
2000,El Salvador,2941,0.05,85,4947,0.07,76,7888,0.06,80,2006,1585,26.56
2000,Guatemala,2711,0.04,87,5171,0.08,72,7882,0.06,81,2460,2066,19.07
2000,Trinidad and Tobago,4274,0.07,78,3308,0.05,88,7582,0.06,82,-966,-63,1433.33
2000,Honduras,3343,0.05,84,3988,0.06,80,7331,0.06,83,645,753,-14.34
2000,Lebanese Republic,715,0.01,131,6230,0.09,70,6945,0.05,84,5515,5530,-0.27
2000,Cuba,1676,0.03,108,4843,0.07,77,6519,0.05,85,3167,2869,10.39
2000,Jordan,1899,0.03,101,4597,0.07,79,6496,0.05,86,2698,1885,43.13
2000,Yemen,4079,0.06,79,2324,0.03,103,6403,0.05,87,-1755,-432,306.25
2000,Côte d'Ivoire,3888,0.06,81,2482,0.04,101,6370,0.05,88,-1406,-1763,-20.25
2000,Malta,2453,0.04,94,3413,0.05,86,5866,0.04,89,960,865,10.98
2000,Uruguay,2295,0.04,95,3466,0.05,85,5761,0.04,90,1171,1120,4.55
2000,Uzbekistan,2817,0.04,86,2697,0.04,97,5514,0.04,91,-120,-125,-4.0
2000,Serbia and Montenegro,1723,0.03,107,3711,0.06,84,5434,0.04,92,1988,1798,10.57
2000,"Macao, China",2539,0.04,90,2625,0.04,98,5164,0.04,93,86,-160,-153.75
2000,"Aruba, Netherlands with respect to",2524,0.04,91,2582,0.04,100,5106,0.04,94,58,605,-90.41
2000,Latvia,1868,0.03,102,3202,0.05,91,5070,0.04,95,1334,1231,8.37
2000,Brunei Darussalam,3903,0.06,80,1107,0.02,129,5010,0.04,96,-2796,-1237,126.03
2000,Netherlands Antilles,2009,0.03,98,2862,0.04,96,4871,0.04,97,853,294,190.14
2000,Kenya,1734,0.03,106,3105,0.05,93,4839,0.04,98,1371,1085,26.36
2000,Cyprus,951,0.01,120,3846,0.06,81,4797,0.04,99,2895,2621,10.45
2000,Botswana,2675,0.04,88,2081,0.03,107,4756,0.04,100,-594,-446,33.18
2000,Ghana,1671,0.03,109,2973,0.04,95,4644,0.04,101,1302,1760,-26.02
2000,Jamaica,1295,0.02,115,3301,0.05,89,4596,0.04,102,2006,1659,20.92
2000,Iceland,1901,0.03,100,2589,0.04,99,4490,0.03,103,688,512,34.38
2000,Paraguay,2200,0.03,96,2260,0.03,104,4460,0.03,104,60,-107,-156.07
2000,Turkmenistan,2506,0.04,92,1786,0.03,114,4292,0.03,105,-720,291,-347.42
2000,Panama,859,0.01,125,3379,0.05,87,4238,0.03,106,2520,2694,-6.46
2000,Bosnia and Herzegovina,1069,0.02,118,3107,0.05,92,4176,0.03,107,2038,2554,-20.2
2000,Myanmar,1620,0.03,110,2371,0.04,102,3991,0.03,108,751,1175,-36.09
2000,Zimbabwe,1925,0.03,99,1863,0.03,111,3788,0.03,109,-62,239,-125.94
2000,Mauritius,1557,0.02,111,2093,0.03,106,3650,0.03,110,536,693,-22.66
2000,Gabon,2598,0.04,89,950,0.01,135,3548,0.03,111,-1648,-1553,6.12
2000,North Macedonia,1323,0.02,113,2094,0.03,105,3417,0.03,112,771,585,31.79
2000,Sudan,1807,0.03,104,1553,0.02,117,3360,0.03,113,-254,635,-140.0
2000,Cambodia,1389,0.02,112,1939,0.03,110,3328,0.03,114,550,462,19.05
2000,Cameroon,1833,0.03,103,1489,0.02,122,3322,0.03,115,-344,-283,21.55
2000,Papua New Guinea,2096,0.03,97,1151,0.02,128,3247,0.02,116,-945,-687,37.55
2000,"Bolivia, Plurinational State of",1230,0.02,116,1830,0.03,112,3060,0.02,117,600,704,-14.77
2000,Congo,2489,0.04,93,465,0.01,162,2954,0.02,118,-2024,-739,173.88
2000,Azerbaijan,1745,0.03,105,1172,0.02,125,2917,0.02,119,-573,107,-635.51
2000,Namibia,1320,0.02,114,1550,0.02,118,2870,0.02,120,230,376,-38.83
2000,Nicaragua,881,0.01,124,1802,0.03,113,2683,0.02,121,921,1317,-30.07
2000,Bahamas,555,0.01,136,2002,0.03,109,2557,0.02,122,1447,1325,9.21
2000,Senegal,920,0.01,121,1519,0.02,121,2439,0.02,123,599,537,11.55
2000,"Korea, Democratic People's Republic of",708,0.01,132,1686,0.03,115,2394,0.02,124,978,540,81.11
2000,Nepal,804,0.01,128,1573,0.02,116,2377,0.02,125,769,820,-6.22
2000,Tanzania,734,0.01,130,1524,0.02,120,2258,0.02,126,790,1013,-22.01
2000,Eswatini,910,0.01,122,1046,0.02,132,1956,0.01,127,136,131,3.82
2000,Uganda,403,0.01,143,1536,0.02,119,1939,0.01,128,1133,823,37.67
2000,Madagascar,824,0.01,126,1097,0.02,130,1921,0.01,129,273,158,72.78
2000,Zambia,892,0.01,123,888,0.01,137,1780,0.01,130,-4,-241,-98.34
2000,Ethiopia,486,0.01,141,1260,0.02,123,1746,0.01,131,774,1071,-27.73
2000,Northern Mariana Islands,1017,0.02,119,607,0.01,152,1624,0.01,132,-410,-539,-23.93
2000,Equatorial Guinea,1097,0.02,117,451,0.01,164,1548,0.01,133,-646,-284,127.46
2000,New Caledonia,604,0.01,134,924,0.01,136,1528,0.01,134,320,538,-40.52
2000,Mozambique,364,0.01,147,1158,0.02,126,1522,0.01,135,794,876,-9.36
2000,Democratic Republic of the Congo,807,0.01,127,683,0.01,145,1490,0.01,136,-124,-241,-48.55
2000,Tajikistan,785,0.01,129,675,0.01,146,1460,0.01,137,-110,-27,307.41
2000,Barbados,272,0.0,158,1156,0.02,127,1428,0.01,138,884,844,4.74
2000,Fiji,585,0.01,135,830,0.01,139,1415,0.01,139,245,294,-16.67
2000,Haiti,318,0.0,154,1036,0.02,133,1354,0.01,140,718,691,3.91
2000,Albania,261,0.0,159,1091,0.02,131,1352,0.01,141,830,789,5.2
2000,Mali,545,0.01,137,806,0.01,141,1351,0.01,142,261,253,3.16
2000,Afghanistan,137,0.0,167,1176,0.02,124,1313,0.01,143,1039,846,22.81
2000,Guinea,666,0.01,133,612,0.01,150,1278,0.01,144,-54,-80,-32.5
2000,"Moldova, Republic of",472,0.01,142,777,0.01,142,1249,0.01,145,305,120,154.17
2000,French Polynesia,221,0.0,160,971,0.01,134,1192,0.01,146,750,673,11.44
2000,Armenia,294,0.0,155,882,0.01,138,1176,0.01,147,588,568,3.52
2000,Mongolia,536,0.01,138,615,0.01,148,1151,0.01,148,79,59,33.9
2000,Guyana,498,0.01,140,573,0.01,153,1071,0.01,149,75,-43,-274.42
2000,Kyrgyz Republic,511,0.01,139,558,0.01,155,1069,0.01,150,47,150,-68.67
2000,Georgia,323,0.01,153,709,0.01,144,1032,0.01,151,386,452,-14.6
2000,Lesotho,220,0.0,161,809,0.01,140,1029,0.01,152,589,694,-15.13
2000,Benin,392,0.01,145,613,0.01,149,1005,0.01,153,221,327,-32.42
2000,Liberia,329,0.01,152,668,0.01,147,997,0.01,154,339,51,564.71
2000,Togo,363,0.01,148,562,0.01,154,925,0.01,155,199,206,-3.4
2000,Suriname,396,0.01,144,526,0.01,158,922,0.01,156,130,135,-3.7
2000,Malawi,379,0.01,146,532,0.01,157,911,0.01,157,153,220,-30.45
2000,Lao People's Democratic Republic,330,0.01,151,535,0.01,156,865,0.01,158,205,214,-4.21
2000,American Samoa,346,0.01,150,506,0.01,160,852,0.01,159,160,108,48.15
2000,Burkina Faso,209,0.0,162,611,0.01,151,820,0.01,160,402,423,-4.96
2000,Mauritania,355,0.01,149,454,0.01,163,809,0.01,161,99,27,266.67
2000,Bermuda,51,0.0,178,720,0.01,143,771,0.01,162,669,661,1.21
2000,Belize,196,0.0,163,524,0.01,159,720,0.01,163,328,172,90.7
2000,Niger,283,0.0,156,395,0.01,166,678,0.01,164,112,123,-8.94
2000,Greenland,273,0.0,157,365,0.01,168,638,0.0,165,92,132,-30.3
2000,Seychelles,194,0.0,164,342,0.01,170,536,0.0,166,148,289,-48.79
2000,Eritrea,37,0.0,183,471,0.01,161,508,0.0,167,434,489,-11.25
2000,Chad,183,0.0,165,317,0.0,171,500,0.0,168,134,73,83.56
2000,Maldives,109,0.0,169,389,0.01,167,498,0.0,169,280,311,-9.97
2000,Antigua and Barbuda,52,0.0,176,407,0.01,165,459,0.0,170,355,376,-5.59
2000,Saint Lucia,43,0.0,182,355,0.01,169,398,0.0,171,312,299,4.35
2000,Somalia,123,0.0,168,217,0.0,174,340,0.0,172,94,169,-44.38
2000,Grenada,48,0.0,180,239,0.0,172,287,0.0,173,191,166,15.06
2000,Central African Republic,161,0.0,166,117,0.0,185,278,0.0,174,-44,-15,193.33
2000,Bhutan,103,0.0,170,175,0.0,179,278,0.0,174,72,66,9.09
2000,Rwanda,52,0.0,176,211,0.0,175,263,0.0,176,159,193,-17.62
2000,Cabo Verde,11,0.0,192,230,0.0,173,241,0.0,177,219,235,-6.81
2000,Djibouti,32,0.0,185,207,0.0,176,239,0.0,178,175,166,5.42
2000,Saint Kitts and Nevis,33,0.0,184,196,0.0,177,229,0.0,179,163,125,30.4
2000,Saint Vincent and the Grenadines,47,0.0,181,163,0.0,180,210,0.0,180,116,152,-23.68
2000,The Gambia,16,0.0,188,187,0.0,178,203,0.0,181,171,180,-5.0
2000,Dominica,54,0.0,175,148,0.0,182,202,0.0,182,94,82,14.63
2000,Burundi,50,0.0,179,148,0.0,182,198,0.0,183,98,64,53.13
2000,Samoa,65,0.0,173,106,0.0,187,171,0.0,184,41,95,-56.84
2000,Sierra Leone,13,0.0,190,149,0.0,181,162,0.0,185,136,75,81.33
2000,Solomon Islands,69,0.0,172,92,0.0,188,161,0.0,186,23,-16,-243.75
2000,Palau,12,0.0,191,127,0.0,184,139,0.0,187,115,77,49.35
2000,"Micronesia, Federated States of",22,0.0,187,107,0.0,186,129,0.0,188,85,79,7.59
2000,Guinea-Bissau,62,0.0,174,59,0.0,192,121,0.0,189,-3,0,
2000,Vanuatu,26,0.0,186,87,0.0,189,113,0.0,190,61,72,-15.28
2000,Tonga,9,0.0,193,69,0.0,191,78,0.0,191,60,61,-1.64
2000,Saint Pierre and Miquelon,6,0.0,196,70,0.0,190,76,0.0,192,64,71,-9.86
2000,Guam,74,0.0,171,0,0.0,201,74,0.0,193,-74,-76,-2.63
2000,Marshall Islands,9,0.0,193,55,0.0,193,64,0.0,194,46,61,-24.59
2000,Cook Islands,9,0.0,193,51,0.0,194,60,0.0,195,42,38,10.53
2000,Comoros,14,0.0,189,43,0.0,195,57,0.0,196,29,46,-36.96
2000,Kiribati,4,0.0,197,40,0.0,196,44,0.0,197,36,32,12.5
2000,Sao Tomé and Principe,3,0.0,198,30,0.0,197,33,0.0,198,27,36,-25.0
2000,Montserrat,1,0.0,199,22,0.0,198,23,0.0,199,21,21,0.0
2000,Tuvalu,0,0.0,200,5,0.0,199,5,0.0,200,5,8,-37.5
2000,Niue,0,0.0,200,2,0.0,200,2,0.0,201,2,3,-33.33
1999,United States of America,695797,12.17,1,1059440,18.11,1,1755237,15.17,1,363643,262215,38.68
1999,Germany,543539,9.5,2,474047,8.1,2,1017586,8.8,2,-69492,-72278,-3.85
1999,Japan,417610,7.3,3,309995,5.3,5,727605,6.29,3,-107615,-107443,0.16
1999,France,325526,5.69,4,315748,5.4,4,641274,5.54,4,-9778,-12860,-23.97
1999,United Kingdom,272167,4.76,5,324899,5.55,3,597066,5.16,5,52732,47282,11.53
1999,Canada,238446,4.17,6,220183,3.76,7,458629,3.96,6,-18263,-8261,121.07
1999,Italy,235564,4.12,7,220637,3.77,6,456201,3.94,7,-14927,-27336,-45.39
1999,Netherlands,218579,3.82,8,206162,3.52,8,424741,3.67,8,-12417,-18338,-32.29
1999,China,194931,3.41,9,165699,2.83,10,360630,3.12,9,-29232,-43475,-32.76
1999,"Hong Kong, China",174403,3.05,11,180711,3.09,9,355114,3.07,10,6308,11895,-46.97
1999,Belgium,179152,3.13,10,164810,2.82,11,343962,2.97,11,-14342,,
1999,Mexico,136391,2.39,13,146084,2.5,12,282475,2.44,12,9693,11612,-16.53
1999,"Korea, Republic of",143685,2.51,12,119752,2.05,14,263437,2.28,13,-23933,-39031,-38.68
1999,Spain,104433,1.83,16,135346,2.31,13,239779,2.07,14,30913,24689,25.21
1999,Chinese Taipei,123626,2.16,14,111449,1.91,15,235075,2.03,15,-12177,-7025,73.34
1999,Singapore,114680,2.01,15,111060,1.9,16,225740,1.95,16,-3620,-8163,-55.65
1999,Switzerland,80300,1.4,19,79857,1.37,17,160157,1.38,17,-443,1238,-135.78
1999,Sweden,84889,1.48,17,68580,1.17,20,153469,1.33,18,-16309,-16364,-0.34
1999,Malaysia,84621,1.48,18,65389,1.12,21,150010,1.3,19,-19232,-14984,28.35
1999,Austria,66061,1.16,22,71321,1.22,18,137382,1.19,20,5260,5419,-2.93
1999,Australia,56080,0.98,24,69158,1.18,19,125238,1.08,21,13078,8737,49.69
1999,Ireland,71239,1.25,21,46769,0.8,25,118008,1.02,22,-24470,-21139,15.76
1999,Russian Federation,75551,1.32,20,39537,0.68,30,115088,0.99,23,-36014,-16429,119.21
1999,Thailand,58473,1.02,23,50350,0.86,23,108823,0.94,24,-8123,-11506,-29.4
1999,Brazil,48013,0.84,28,51767,0.88,22,99780,0.86,25,3754,9512,-60.53
1999,Denmark,50296,0.88,27,45753,0.78,27,96049,0.83,26,-4543,-2140,112.29
1999,Indonesia,51243,0.9,25,33321,0.57,32,84564,0.73,27,-17922,-15090,18.77
1999,India,35667,0.62,33,46979,0.8,24,82646,0.71,28,11312,9543,18.54
1999,Norway,45455,0.79,29,34166,0.58,31,79621,0.69,29,-11289,-2926,285.82
1999,"Saudi Arabia, Kingdom of",50761,0.89,26,28011,0.48,40,78772,0.68,30,-22750,-8809,158.26
1999,Finland,42243,0.74,30,32114,0.55,35,74357,0.64,31,-10129,-10792,-6.14
1999,Poland,27359,0.48,34,45883,0.78,26,73242,0.63,32,18524,18825,-1.6
1999,Philippines,36576,0.64,31,32568,0.56,34,69144,0.6,33,-4008,2082,-292.51
1999,United Arab Emirates,36474,0.64,32,31721,0.54,36,68195,0.59,34,-4753,-1249,280.54
1999,Türkiye,26587,0.46,36,40226,0.69,28,66813,0.58,35,13639,19040,-28.37
1999,Portugal,24541,0.43,40,39974,0.68,29,64515,0.56,36,15433,13642,13.13
1999,Israel,25794,0.45,38,33166,0.57,33,58960,0.51,37,7372,6349,16.11
1999,Czech Republic,26556,0.46,37,28463,0.49,38,55019,0.48,38,1907,2485,-23.26
1999,South Africa,26707,0.47,35,26696,0.46,41,53403,0.46,39,-11,2880,-100.38
1999,Hungary,25032,0.44,39,28015,0.48,39,53047,0.46,40,2983,2700,10.48
1999,Argentina,23333,0.41,41,25508,0.44,42,48841,0.42,41,2175,4963,-56.18
1999,Greece,11070,0.19,53,30529,0.52,37,41599,0.36,42,19459,19426,0.17
1999,"Venezuela, Bolivarian Republic of",20963,0.37,43,14064,0.24,46,35027,0.3,43,-6899,-1890,265.03
1999,Iran,21030,0.37,42,13324,0.23,47,34354,0.3,44,-7706,1205,-739.5
1999,Chile,17162,0.3,44,15987,0.27,44,33149,0.29,45,-1175,3559,-133.01
1999,New Zealand,12474,0.22,48,14318,0.24,45,26792,0.23,46,1844,412,347.57
1999,Iraq,13067,0.23,46,10917,0.19,52,23984,0.21,47,-2150,483,-545.13
1999,Ukraine,11582,0.2,50,11846,0.2,48,23428,0.2,48,264,2039,-87.05
1999,Viet Nam,11541,0.2,52,11742,0.2,49,23283,0.2,49,201,2139,-90.6
1999,Nigeria,13856,0.24,45,8588,0.15,59,22444,0.19,50,-5268,-644,718.01
1999,Colombia,11575,0.2,51,10659,0.18,53,22234,0.19,51,-916,3745,-124.46
1999,Algeria,12525,0.22,47,9162,0.16,58,21687,0.19,52,-3363,-809,315.7
1999,Slovak Republic,10211,0.18,54,11318,0.19,50,21529,0.19,53,1107,2354,-52.97
1999,"Kuwait, the State of",12164,0.21,49,7617,0.13,64,19781,0.17,54,-4547,-935,386.31
1999,Egypt,3559,0.06,77,16022,0.27,43,19581,0.17,55,12463,13036,-4.4
1999,Luxembourg,8203,0.14,58,11218,0.19,51,19421,0.17,56,3015,,
1999,Romania,8518,0.15,56,10417,0.18,54,18935,0.16,57,1899,3521,-46.07
1999,Slovenia,8560,0.15,55,10102,0.17,56,18662,0.16,58,1542,1062,45.2
1999,Pakistan,8424,0.15,57,10207,0.17,55,18631,0.16,59,1783,814,119.04
1999,Morocco,7503,0.13,60,10058,0.17,57,17561,0.15,60,2555,3137,-18.55
1999,Tunisia,5872,0.1,66,8474,0.14,60,14346,0.12,61,2602,2612,-0.38
1999,Bangladesh,5497,0.1,68,8331,0.14,61,13828,0.12,62,2834,2374,19.38
1999,Dominican Republic,5137,0.09,70,8041,0.14,62,13178,0.11,63,2904,2608,11.35
1999,Costa Rica,6662,0.12,63,6355,0.11,67,13017,0.11,64,-307,713,-143.06
1999,Peru,6088,0.11,64,6823,0.12,65,12911,0.11,65,735,2463,-70.16
1999,Belarus,5909,0.1,65,6674,0.11,66,12583,0.11,66,765,1479,-48.28
1999,Libya,7961,0.14,59,4253,0.07,75,12214,0.11,67,-3708,-432,758.33
1999,Croatia,4303,0.08,75,7799,0.13,63,12102,0.1,68,3496,3759,-7.0
1999,Oman,7238,0.13,61,4801,0.08,72,12039,0.1,69,-2437,318,-866.35
1999,Sri Lanka,4594,0.08,72,5870,0.1,69,10464,0.09,70,1276,1124,13.52
1999,Qatar,7214,0.13,62,2500,0.04,99,9714,0.08,71,-4714,-1621,190.81
1999,Kazakhstan,5872,0.1,66,3655,0.06,81,9527,0.08,72,-2217,-1020,117.35
1999,Bulgaria,3979,0.07,76,5478,0.09,70,9457,0.08,73,1499,649,130.97
1999,Angola,5157,0.09,69,3109,0.05,90,8266,0.07,74,-2048,-1464,39.89
1999,"Bahrain, Kingdom of",4363,0.08,74,3698,0.06,80,8061,0.07,75,-665,296,-324.66
1999,Lithuania,3004,0.05,81,4835,0.08,71,7839,0.07,76,1831,2085,-12.18
1999,Côte d'Ivoire,4661,0.08,71,2898,0.05,94,7559,0.07,77,-1763,-1615,9.16
1999,Ecuador,4451,0.08,73,3017,0.05,91,7468,0.06,78,-1434,1373,-204.44
1999,Syrian Arab Republic,3464,0.06,78,3832,0.07,78,7296,0.06,79,368,1005,-63.38
1999,Estonia,3017,0.05,80,4109,0.07,76,7126,0.06,80,1092,1542,-29.18
1999,Guatemala,2494,0.04,87,4560,0.08,73,7054,0.06,81,2066,2088,-1.05
1999,Lebanese Republic,677,0.01,127,6207,0.11,68,6884,0.06,82,5530,6408,-13.7
1999,El Salvador,2510,0.04,86,4095,0.07,77,6605,0.06,83,1585,1510,4.97
1999,Uzbekistan,3235,0.06,79,3110,0.05,89,6345,0.05,84,-125,-240,-47.92
1999,Honduras,2777,0.05,83,3530,0.06,83,6307,0.05,85,753,304,147.7
1999,Cuba,1496,0.03,105,4365,0.07,74,5861,0.05,86,2869,2685,6.85
1999,Uruguay,2237,0.04,90,3357,0.06,86,5594,0.05,87,1120,1040,7.69
1999,Jordan,1832,0.03,97,3717,0.06,79,5549,0.05,88,1885,2026,-6.96
1999,Trinidad and Tobago,2804,0.05,82,2741,0.05,97,5545,0.05,89,-63,741,-108.5
1999,Ghana,1720,0.03,100,3480,0.06,85,5200,0.04,90,1760,768,129.17
1999,Botswana,2644,0.05,84,2198,0.04,102,4842,0.04,91,-446,193,-331.09
1999,Malta,1978,0.03,94,2843,0.05,95,4821,0.04,92,865,834,3.72
1999,Serbia and Montenegro,1498,0.03,104,3296,0.06,88,4794,0.04,93,1798,1991,-9.69
1999,Latvia,1723,0.03,99,2954,0.05,92,4677,0.04,94,1231,1380,-10.8
1999,Cyprus,997,0.02,118,3618,0.06,82,4615,0.04,95,2621,2624,-0.11
1999,Kenya,1747,0.03,98,2832,0.05,96,4579,0.04,96,1085,1189,-8.75
1999,Iceland,2004,0.04,93,2516,0.04,98,4520,0.04,97,512,551,-7.08
1999,Yemen,2440,0.04,88,2008,0.03,105,4448,0.04,98,-432,671,-164.38
1999,Panama,822,0.01,121,3516,0.06,84,4338,0.04,99,2694,2614,3.06
1999,"Macao, China",2200,0.04,91,2040,0.03,104,4240,0.04,100,-160,-186,-13.98
1999,Jamaica,1240,0.02,108,2899,0.05,93,4139,0.04,101,1659,1723,-3.71
1999,Bosnia and Herzegovina,751,0.01,124,3305,0.06,87,4056,0.04,102,2554,2305,10.8
1999,Zimbabwe,1887,0.03,95,2126,0.04,103,4013,0.03,103,239,590,-59.49
1999,Brunei Darussalam,2579,0.05,85,1342,0.02,121,3921,0.03,104,-1237,-506,144.47
1999,Paraguay,2013,0.04,92,1906,0.03,107,3919,0.03,105,-107,619,-117.29
1999,Mauritius,1554,0.03,103,2247,0.04,101,3801,0.03,106,693,428,61.92
1999,Myanmar,1125,0.02,113,2300,0.04,100,3425,0.03,107,1175,1601,-26.61
1999,"Aruba, Netherlands with respect to",1389,0.02,107,1994,0.03,106,3383,0.03,108,605,353,71.39
1999,Gabon,2394,0.04,89,841,0.01,137,3235,0.03,109,-1553,-813,91.02
1999,Netherlands Antilles,1451,0.03,106,1745,0.03,112,3196,0.03,110,294,893,-67.08
1999,Papua New Guinea,1875,0.03,96,1188,0.02,124,3063,0.03,111,-687,-532,29.14
1999,North Macedonia,1191,0.02,110,1776,0.03,109,2967,0.03,112,585,604,-3.15
1999,Cameroon,1601,0.03,101,1318,0.02,123,2919,0.03,113,-283,-176,60.8
1999,Namibia,1234,0.02,109,1610,0.03,113,2844,0.02,114,376,416,-9.62
1999,"Bolivia, Plurinational State of",1051,0.02,116,1755,0.03,110,2806,0.02,115,704,879,-19.91
1999,Cambodia,1129,0.02,112,1591,0.03,114,2720,0.02,116,462,366,26.23
1999,Turkmenistan,1187,0.02,111,1478,0.03,118,2665,0.02,117,291,390,-25.38
1999,Senegal,1027,0.02,117,1564,0.03,115,2591,0.02,118,537,487,10.27
1999,Nicaragua,545,0.01,134,1862,0.03,108,2407,0.02,119,1317,919,43.31
1999,Congo,1560,0.03,102,821,0.01,140,2381,0.02,120,-739,-685,7.88
1999,Sudan,780,0.01,123,1415,0.02,120,2195,0.02,121,635,1319,-51.86
1999,Bahamas,426,0.01,145,1751,0.03,111,2177,0.02,122,1325,1516,-12.6
1999,Tanzania,543,0.01,135,1556,0.03,116,2099,0.02,123,1013,864,17.25
1999,Nepal,602,0.01,131,1422,0.02,119,2024,0.02,124,820,772,6.22
1999,Ethiopia,467,0.01,140,1538,0.03,117,2005,0.02,125,1071,956,12.03
1999,Eswatini,937,0.02,119,1068,0.02,129,2005,0.02,125,131,110,19.09
1999,Azerbaijan,929,0.02,120,1036,0.02,130,1965,0.02,127,107,471,-77.28
1999,Zambia,1063,0.02,114,822,0.01,139,1885,0.02,128,-241,68,-454.41
1999,Uganda,519,0.01,137,1342,0.02,121,1861,0.02,129,823,915,-10.05
1999,"Korea, Democratic People's Republic of",637,0.01,128,1177,0.02,125,1814,0.02,130,540,362,49.17
1999,Northern Mariana Islands,1062,0.02,115,523,0.01,155,1585,0.01,131,-539,-559,-3.58
1999,Fiji,609,0.01,130,903,0.02,135,1512,0.01,132,294,210,40.0
1999,Albania,351,0.01,149,1140,0.02,126,1491,0.01,133,789,624,26.44
1999,New Caledonia,468,0.01,139,1006,0.02,133,1474,0.01,134,538,551,-2.36
1999,Mozambique,263,0.0,157,1139,0.02,127,1402,0.01,135,876,560,56.43
1999,Mali,571,0.01,133,824,0.01,138,1395,0.01,136,253,205,23.41
1999,Democratic Republic of the Congo,809,0.01,122,568,0.01,152,1377,0.01,137,-241,-320,-24.69
1999,Barbados,264,0.0,156,1108,0.02,128,1372,0.01,138,844,758,11.35
1999,Haiti,334,0.01,152,1025,0.02,131,1359,0.01,139,691,477,44.86
1999,Tajikistan,690,0.01,126,663,0.01,148,1353,0.01,140,-27,115,-123.48
1999,Madagascar,584,0.01,132,742,0.01,143,1326,0.01,141,158,155,1.94
1999,Guinea,636,0.01,129,556,0.01,153,1192,0.01,142,-80,-156,-48.72
1999,French Polynesia,253,0.0,159,926,0.02,134,1179,0.01,143,673,771,-12.71
1999,Afghanistan,166,0.0,165,1012,0.02,132,1178,0.01,144,846,303,179.21
1999,Benin,422,0.01,146,749,0.01,142,1171,0.01,145,327,329,-0.61
1999,Equatorial Guinea,709,0.01,125,425,0.01,163,1134,0.01,146,-284,-122,132.79
1999,Malawi,453,0.01,144,673,0.01,147,1126,0.01,147,220,84,161.9
1999,Kyrgyz Republic,463,0.01,142,613,0.01,149,1076,0.01,148,150,328,-54.27
1999,"Moldova, Republic of",465,0.01,141,585,0.01,151,1050,0.01,149,120,388,-69.07
1999,Lesotho,172,0.0,164,866,0.01,136,1038,0.01,150,694,747,-7.1
1999,Armenia,232,0.0,162,800,0.01,141,1032,0.01,151,568,681,-16.59
1999,Guyana,523,0.01,136,480,0.01,160,1003,0.01,152,-43,56,-176.79
1999,Liberia,469,0.01,138,520,0.01,156,989,0.01,153,51,45,13.33
1999,Togo,391,0.01,147,597,0.01,150,988,0.01,154,206,168,22.62
1999,Mongolia,454,0.01,143,513,0.01,157,967,0.01,155,59,41,43.9
1999,Burkina Faso,255,0.0,158,678,0.01,146,933,0.01,156,423,413,2.42
1999,Georgia,238,0.0,161,690,0.01,145,928,0.01,157,452,696,-35.06
1999,Suriname,351,0.01,149,486,0.01,159,837,0.01,158,135,207,-34.78
1999,Lao People's Democratic Republic,311,0.01,153,525,0.01,154,836,0.01,159,214,183,16.94
1999,American Samoa,345,0.01,151,453,0.01,161,798,0.01,160,108,83,30.12
1999,Bermuda,51,0.0,177,712,0.01,144,763,0.01,161,661,584,13.18
1999,Mauritania,358,0.01,148,385,0.01,168,743,0.01,162,27,12,125.0
1999,Niger,287,0.01,154,410,0.01,165,697,0.01,163,123,137,-10.22
1999,Greenland,277,0.0,155,409,0.01,166,686,0.01,164,132,154,-14.29
1999,Seychelles,145,0.0,167,434,0.01,162,579,0.01,165,289,262,10.31
1999,Belize,198,0.0,163,370,0.01,169,568,0.0,166,172,123,39.84
1999,Chad,243,0.0,160,316,0.01,171,559,0.0,167,73,94,-22.34
1999,Eritrea,21,0.0,185,510,0.01,158,531,0.0,168,489,480,1.88
1999,Maldives,91,0.0,171,402,0.01,167,493,0.0,169,311,258,20.54
1999,Antigua and Barbuda,38,0.0,180,414,0.01,164,452,0.0,170,376,349,7.74
1999,Saint Lucia,56,0.0,174,355,0.01,170,411,0.0,171,299,266,12.41
1999,Somalia,116,0.0,169,285,0.0,172,401,0.0,172,169,130,30.0
1999,Rwanda,60,0.0,173,253,0.0,173,313,0.0,173,193,225,-14.22
1999,Bhutan,116,0.0,169,182,0.0,179,298,0.0,174,66,26,153.85
1999,Central African Republic,146,0.0,166,131,0.0,182,277,0.0,175,-15,-5,200.0
1999,Cabo Verde,11,0.0,190,246,0.0,174,257,0.0,176,235,218,7.8
1999,Saint Vincent and the Grenadines,49,0.0,179,201,0.0,176,250,0.0,177,152,143,6.29
1999,Grenada,36,0.0,181,202,0.0,175,238,0.0,178,166,165,0.61
1999,Solomon Islands,126,0.0,168,110,0.0,185,236,0.0,179,-16,10,-260.0
1999,Djibouti,28,0.0,182,194,0.0,177,222,0.0,180,166,168,-1.19
1999,The Gambia,12,0.0,188,192,0.0,178,204,0.0,181,180,207,-13.04
1999,Dominica,56,0.0,174,138,0.0,181,194,0.0,182,82,70,17.14
1999,Saint Kitts and Nevis,28,0.0,182,153,0.0,180,181,0.0,183,125,121,3.31
1999,Burundi,54,0.0,176,118,0.0,183,172,0.0,184,64,93,-31.18
1999,Samoa,20,0.0,186,115,0.0,184,135,0.0,185,95,82,15.85
1999,Vanuatu,26,0.0,184,98,0.0,186,124,0.0,186,72,59,22.03
1999,"Micronesia, Federated States of",18,0.0,187,97,0.0,187,115,0.0,187,79,76,3.95
1999,Guinea-Bissau,51,0.0,177,51,0.0,194,102,0.0,188,0,36,-100.0
1999,Palau,7,0.0,194,84,0.0,188,91,0.0,189,77,52,48.08
1999,Sierra Leone,6,0.0,195,81,0.0,189,87,0.0,190,75,88,-14.77
1999,Tonga,12,0.0,188,73,0.0,191,85,0.0,191,61,62,-1.61
1999,Saint Pierre and Miquelon,4,0.0,196,75,0.0,190,79,0.0,192,71,59,20.34
1999,Marshall Islands,8,0.0,193,69,0.0,192,77,0.0,193,61,61,0.0
1999,Guam,76,0.0,172,0,0.0,201,76,0.0,194,-76,-86,-11.63
1999,Comoros,9,0.0,191,55,0.0,193,64,0.0,195,46,48,-4.17
1999,Kiribati,9,0.0,191,41,0.0,196,50,0.0,196,32,27,18.52
1999,Cook Islands,4,0.0,196,42,0.0,195,46,0.0,197,38,35,8.57
1999,Sao Tomé and Principe,2,0.0,198,38,0.0,197,40,0.0,198,36,12,200.0
1999,Montserrat,1,0.0,199,22,0.0,198,23,0.0,199,21,15,40.0
1999,Tuvalu,0,0.0,200,8,0.0,199,8,0.0,200,8,10,-20.0
1999,Niue,0,0.0,200,3,0.0,200,3,0.0,201,3,2,50.0
1998,United States of America,682138,12.4,1,944353,16.81,1,1626491,14.63,1,262215,209838,24.96
1998,Germany,543752,9.88,2,471474,8.39,2,1015226,9.13,2,-72278,-67160,7.62
1998,Japan,387927,7.05,3,280484,4.99,5,668411,6.01,3,-107443,-82203,30.7
1998,France,320631,5.83,4,307771,5.48,4,628402,5.65,4,-12860,-17117,-24.87
1998,United Kingdom,273949,4.98,5,321231,5.72,3,595180,5.35,5,47282,27112,74.4
1998,Italy,245801,4.47,6,218465,3.89,6,464266,4.17,6,-27336,-30282,-9.73
1998,Canada,214327,3.9,7,206066,3.67,7,420393,3.78,7,-8261,-13549,-39.03
1998,Netherlands,213977,3.89,8,195639,3.48,8,409616,3.68,8,-18338,-17101,7.23
1998,"Hong Kong, China",174864,3.18,11,186759,3.32,9,361623,3.25,9,11895,25102,-52.61
1998,Belgium-Luxembourg,181910,3.31,10,168995,3.01,10,350905,3.16,10,-12915,-12601,2.49
1998,China,183712,3.34,9,140237,2.5,11,323949,2.91,11,-43475,-40422,7.55
1998,Spain,111973,2.04,15,136662,2.43,12,248635,2.24,12,24689,14914,65.54
1998,Mexico,117460,2.13,13,129072,2.3,13,246532,2.22,13,11612,2690,331.67
1998,"Korea, Republic of",132313,2.4,12,93282,1.66,16,225595,2.03,14,-39031,8452,-561.8
1998,Chinese Taipei,112467,2.04,14,105442,1.88,14,217909,1.96,15,-7025,-8713,-19.37
1998,Singapore,109895,2.0,16,101732,1.81,15,211627,1.9,16,-8163,7452,-209.54
1998,Switzerland,78856,1.43,18,80094,1.43,17,158950,1.43,17,1238,-190,-751.58
1998,Sweden,84767,1.54,17,68403,1.22,19,153170,1.38,18,-16364,-17161,-4.64
1998,Austria,64085,1.16,22,69504,1.24,18,133589,1.2,19,5419,5955,-9.0
1998,Russian Federation,74444,1.35,19,58015,1.03,23,132459,1.19,20,-16429,-14912,10.17
1998,Malaysia,73256,1.33,20,58272,1.04,22,131528,1.18,21,-14984,293,-5213.99
1998,Australia,55893,1.02,23,64630,1.15,20,120523,1.08,22,8737,2982,192.99
1998,Brazil,51140,0.93,25,60652,1.08,21,111792,1.01,23,9512,11248,-15.43
1998,Ireland,64330,1.17,21,43191,0.77,27,107521,0.97,24,-21139,-15600,35.51
1998,Thailand,54477,0.99,24,42971,0.76,29,97448,0.88,25,-11506,5509,-308.86
1998,Denmark,49013,0.89,27,46873,0.83,25,95886,0.86,26,-2140,-4371,-51.04
1998,Indonesia,50370,0.92,26,35280,0.63,32,85650,0.77,27,-15090,-4994,202.16
1998,Norway,40399,0.73,29,37473,0.67,31,77872,0.7,28,-2926,-12833,-77.2
1998,Finland,43752,0.8,28,32960,0.59,33,76712,0.69,29,-10792,-9860,9.45
1998,India,33437,0.61,32,42980,0.76,28,76417,0.69,30,9543,6424,48.55
1998,Poland,28230,0.51,34,47055,0.84,24,75285,0.68,31,18825,16560,13.68
1998,Türkiye,26881,0.49,35,45921,0.82,26,72802,0.65,32,19040,22300,-14.62
1998,"Saudi Arabia, Kingdom of",38822,0.71,30,30013,0.53,38,68835,0.62,33,-8809,-32000,-72.47
1998,United Arab Emirates,33837,0.62,31,32588,0.58,34,66425,0.6,34,-1249,-6316,-80.22
1998,Portugal,24793,0.45,39,38435,0.68,30,63228,0.57,35,13642,11100,22.9
1998,Philippines,29414,0.53,33,31496,0.56,35,60910,0.55,36,2082,13740,-84.85
1998,Argentina,26441,0.48,36,31404,0.56,36,57845,0.52,37,4963,4080,21.64
1998,South Africa,26362,0.48,37,29242,0.52,40,55604,0.5,38,2880,1971,46.12
1998,Czech Republic,25855,0.47,38,28340,0.5,41,54195,0.49,39,2485,4745,-47.63
1998,Israel,22993,0.42,41,29342,0.52,39,52335,0.47,40,6349,8279,-23.31
1998,Hungary,23005,0.42,40,25705,0.46,42,48710,0.44,41,2700,2135,26.46
1998,Greece,10867,0.2,48,30293,0.54,37,41160,0.37,42,19426,15593,24.58
1998,Chile,16323,0.3,43,19882,0.35,43,36205,0.33,43,3559,2952,20.56
1998,"Venezuela, Bolivarian Republic of",17707,0.32,42,15817,0.28,45,33524,0.3,44,-1890,-9265,-79.6
1998,Iran,13118,0.24,44,14323,0.25,48,27441,0.25,45,1205,-4185,-128.79
1998,Ukraine,12637,0.23,45,14676,0.26,46,27313,0.25,46,2039,2896,-29.59
1998,Colombia,10890,0.2,47,14635,0.26,47,25525,0.23,47,3745,3856,-2.88
1998,New Zealand,12084,0.22,46,12496,0.22,50,24580,0.22,48,412,296,39.19
1998,Slovak Republic,10724,0.19,49,13078,0.23,49,23802,0.21,49,2354,2090,12.63
1998,Viet Nam,9361,0.17,53,11500,0.2,52,20861,0.19,50,2139,2407,-11.13
1998,Romania,8300,0.15,56,11821,0.21,51,20121,0.18,51,3521,2849,23.59
1998,Algeria,10209,0.19,50,9400,0.17,55,19609,0.18,52,-809,-5206,-84.46
1998,Egypt,3130,0.06,79,16166,0.29,44,19296,0.17,53,13036,9290,40.32
1998,Slovenia,9048,0.16,54,10110,0.18,54,19158,0.17,54,1062,985,7.82
1998,Nigeria,9855,0.18,51,9211,0.16,57,19066,0.17,55,-644,-5706,-88.71
1998,"Kuwait, the State of",9554,0.17,52,8619,0.15,58,18173,0.16,56,-935,-5978,-84.36
1998,Pakistan,8494,0.15,55,9308,0.17,56,17802,0.16,57,814,2879,-71.73
1998,Morocco,7153,0.13,57,10290,0.18,53,17443,0.16,58,3137,2493,25.83
1998,Belarus,7070,0.13,58,8549,0.15,59,15619,0.14,59,1479,1388,6.56
1998,Tunisia,5738,0.1,61,8350,0.15,60,14088,0.13,60,2612,2355,10.91
1998,Peru,5757,0.1,60,8220,0.15,62,13977,0.13,61,2463,1733,42.12
1998,Croatia,4517,0.08,71,8276,0.15,61,12793,0.12,62,3759,5120,-26.58
1998,Bangladesh,5121,0.09,66,7495,0.13,64,12616,0.11,63,2374,2431,-2.34
1998,Dominican Republic,4989,0.09,68,7597,0.14,63,12586,0.11,64,2608,1995,30.73
1998,Costa Rica,5526,0.1,62,6239,0.11,66,11765,0.11,65,713,635,12.28
1998,Libya,6032,0.11,59,5600,0.1,71,11632,0.1,66,-432,-4043,-89.31
1998,Iraq,5500,0.1,64,5983,0.11,67,11483,0.1,67,483,-183,-363.93
1998,Oman,5508,0.1,63,5826,0.1,69,11334,0.1,68,318,-2439,-113.04
1998,Sri Lanka,4809,0.09,69,5933,0.11,68,10742,0.1,69,1124,1200,-6.33
1998,Ecuador,4203,0.08,73,5576,0.1,72,9779,0.09,70,1373,-309,-544.34
1998,Kazakhstan,5334,0.1,65,4314,0.08,77,9648,0.09,71,-1020,-2196,-53.55
1998,Lithuania,3710,0.07,74,5795,0.1,70,9505,0.09,72,2085,1785,16.81
1998,Bulgaria,4300,0.08,72,4949,0.09,73,9249,0.08,73,649,-10,-6590.0
1998,Qatar,5030,0.09,67,3409,0.06,85,8439,0.08,74,-1621,-2178,-25.57
1998,Estonia,3245,0.06,78,4787,0.09,75,8032,0.07,75,1542,1501,2.73
1998,Lebanese Republic,662,0.01,121,7070,0.13,65,7732,0.07,76,6408,6824,-6.1
1998,Serbia and Montenegro,2858,0.05,82,4849,0.09,74,7707,0.07,77,1991,2122,-6.17
1998,Côte d'Ivoire,4606,0.08,70,2991,0.05,93,7597,0.07,78,-1615,-1670,-3.29
1998,Guatemala,2563,0.05,84,4651,0.08,76,7214,0.06,79,2088,1461,42.92
1998,"Bahrain, Kingdom of",3270,0.06,77,3566,0.06,84,6836,0.06,80,296,-358,-182.68
1998,Uzbekistan,3530,0.06,76,3290,0.06,87,6820,0.06,81,-240,160,-250.0
1998,Syrian Arab Republic,2890,0.05,81,3895,0.07,80,6785,0.06,82,1005,112,797.32
1998,Uruguay,2771,0.05,83,3811,0.07,82,6582,0.06,83,1040,1001,3.9
1998,El Salvador,2452,0.04,85,3962,0.07,79,6414,0.06,84,1510,1323,14.13
1998,Honduras,2929,0.05,80,3233,0.06,88,6162,0.06,85,304,191,59.16
1998,Cuba,1512,0.03,102,4197,0.07,78,5709,0.05,86,2685,2175,23.45
1998,Jordan,1802,0.03,97,3828,0.07,81,5630,0.05,87,2026,2266,-10.59
1998,Angola,3543,0.06,75,2079,0.04,103,5622,0.05,88,-1464,-2410,-39.25
1998,Trinidad and Tobago,2258,0.04,87,2999,0.05,92,5257,0.05,89,741,445,66.52
1998,Kenya,2008,0.04,92,3197,0.06,89,5205,0.05,90,1189,1225,-2.94
1998,Paraguay,2278,0.04,86,2897,0.05,95,5175,0.05,91,619,1001,-38.16
1998,Latvia,1811,0.03,96,3191,0.06,90,5002,0.04,92,1380,1049,31.55
1998,Zimbabwe,2111,0.04,89,2701,0.05,96,4812,0.04,93,590,551,7.08
1998,Cyprus,1061,0.02,114,3685,0.07,83,4746,0.04,94,2624,2405,9.11
1998,Malta,1834,0.03,95,2668,0.05,97,4502,0.04,95,834,911,-8.45
1998,Iceland,1931,0.04,93,2482,0.04,100,4413,0.04,96,551,167,229.94
1998,Ghana,1795,0.03,98,2563,0.05,99,4358,0.04,97,768,691,11.14
1998,Jamaica,1312,0.02,106,3035,0.05,91,4347,0.04,98,1723,1748,-1.43
1998,Botswana,2058,0.04,90,2251,0.04,101,4309,0.04,99,193,-584,-133.05
1998,Panama,784,0.01,119,3398,0.06,86,4182,0.04,100,2614,2279,14.7
1998,"Macao, China",2141,0.04,88,1955,0.03,107,4096,0.04,101,-186,-66,181.82
1998,Myanmar,1065,0.02,113,2666,0.05,98,3731,0.03,102,1601,1171,36.72
1998,Mauritius,1645,0.03,101,2073,0.04,104,3718,0.03,103,428,597,-28.31
1998,Yemen,1496,0.03,103,2167,0.04,102,3663,0.03,104,671,-490,-236.94
1998,Brunei Darussalam,2058,0.04,90,1552,0.03,112,3610,0.03,105,-506,-264,91.67
1998,Bosnia and Herzegovina,605,0.01,124,2910,0.05,94,3515,0.03,106,2305,1758,31.11
1998,Netherlands Antilles,1169,0.02,109,2062,0.04,105,3231,0.03,107,893,595,50.08
1998,North Macedonia,1311,0.02,107,1915,0.03,108,3226,0.03,108,604,542,11.44
1998,Cameroon,1671,0.03,100,1495,0.03,115,3166,0.03,109,-176,-501,-64.87
1998,"Bolivia, Plurinational State of",1104,0.02,111,1983,0.04,106,3087,0.03,110,879,684,28.51
1998,Gabon,1916,0.03,94,1103,0.02,123,3019,0.03,111,-813,-1920,-57.66
1998,Papua New Guinea,1772,0.03,99,1240,0.02,121,3012,0.03,112,-532,-452,17.7
1998,Namibia,1232,0.02,108,1648,0.03,111,2880,0.03,113,416,415,0.24
1998,"Aruba, Netherlands with respect to",1165,0.02,110,1518,0.03,113,2683,0.02,114,353,391,-9.72
1998,Democratic Republic of the Congo,1422,0.03,104,1102,0.02,124,2524,0.02,115,-320,-679,-52.87
1998,Sudan,596,0.01,126,1915,0.03,108,2511,0.02,116,1319,986,33.77
1998,Senegal,968,0.02,117,1455,0.03,117,2423,0.02,117,487,430,13.26
1998,Zambia,1032,0.02,115,1100,0.02,125,2132,0.02,118,68,-96,-170.83
1998,Bahamas,300,0.01,153,1816,0.03,110,2116,0.02,119,1516,1441,5.2
1998,Ethiopia,561,0.01,131,1517,0.03,114,2078,0.02,120,956,526,81.75
1998,Nicaragua,573,0.01,130,1492,0.03,116,2065,0.02,121,919,873,5.27
1998,Eswatini,973,0.02,116,1083,0.02,126,2056,0.02,122,110,104,5.77
1998,Congo,1365,0.02,105,680,0.01,147,2045,0.02,123,-685,-742,-7.68
1998,Tanzania,589,0.01,129,1453,0.03,118,2042,0.02,124,864,584,47.95
1998,Cambodia,800,0.01,118,1166,0.02,122,1966,0.02,125,366,328,11.59
1998,Uganda,501,0.01,136,1416,0.03,119,1917,0.02,126,915,761,20.24
1998,Nepal,474,0.01,138,1246,0.02,120,1720,0.02,127,772,1287,-40.02
1998,Azerbaijan,605,0.01,124,1076,0.02,127,1681,0.02,128,471,14,3264.29
1998,"Korea, Democratic People's Republic of",651,0.01,122,1013,0.02,130,1664,0.01,129,362,289,25.26
1998,"Moldova, Republic of",630,0.01,123,1018,0.02,128,1648,0.01,130,388,295,31.53
1998,Northern Mariana Islands,1085,0.02,112,526,0.01,154,1611,0.01,131,-559,-382,46.34
1998,Turkmenistan,590,0.01,128,980,0.02,132,1570,0.01,132,390,230,69.57
1998,Kyrgyz Republic,514,0.01,134,842,0.01,137,1356,0.01,133,328,105,212.38
1998,Mali,556,0.01,132,761,0.01,141,1317,0.01,134,205,178,15.17
1998,New Caledonia,378,0.01,147,929,0.02,134,1307,0.01,135,551,386,42.75
1998,Tajikistan,595,0.01,127,710,0.01,145,1305,0.01,136,115,5,2200.0
1998,French Polynesia,247,0.0,157,1018,0.02,128,1265,0.01,137,771,711,8.44
1998,Barbados,252,0.0,156,1010,0.02,131,1262,0.01,138,758,713,6.31
1998,Fiji,512,0.01,135,722,0.01,144,1234,0.01,139,210,343,-38.78
1998,Madagascar,538,0.01,133,693,0.01,146,1231,0.01,140,155,178,-12.92
1998,Guinea,693,0.01,120,537,0.01,153,1230,0.01,141,-156,-65,140.0
1998,Benin,407,0.01,145,736,0.01,142,1143,0.01,142,329,257,28.02
1998,Lesotho,194,0.0,161,941,0.02,133,1135,0.01,143,747,944,-20.87
1998,Armenia,221,0.0,159,902,0.02,135,1123,0.01,144,681,659,3.34
1998,Haiti,320,0.01,151,797,0.01,139,1117,0.01,145,477,436,9.4
1998,Georgia,191,0.0,162,887,0.02,136,1078,0.01,146,696,704,-1.14
1998,Burkina Faso,319,0.01,152,732,0.01,143,1051,0.01,147,413,355,16.34
1998,Albania,205,0.0,160,829,0.01,138,1034,0.01,148,624,507,23.08
1998,Guyana,484,0.01,137,540,0.01,152,1024,0.01,149,56,34,64.71
1998,Mozambique,230,0.0,158,790,0.01,140,1020,0.01,150,560,517,8.32
1998,Togo,420,0.01,143,588,0.01,149,1008,0.01,151,168,221,-23.98
1998,Mongolia,462,0.01,139,503,0.01,157,965,0.01,152,41,-101,-140.59
1998,Malawi,431,0.01,141,515,0.01,155,946,0.01,153,84,244,-65.57
1998,Lao People's Democratic Republic,370,0.01,148,553,0.01,150,923,0.01,154,183,347,-47.26
1998,American Samoa,415,0.01,144,498,0.01,158,913,0.01,155,83,105,-20.95
1998,Suriname,345,0.01,149,552,0.01,151,897,0.01,156,207,94,120.21
1998,Liberia,425,0.01,142,470,0.01,160,895,0.01,157,45,180,-75.0
1998,Niger,334,0.01,150,471,0.01,159,805,0.01,158,137,102,34.31
1998,Mauritania,387,0.01,146,399,0.01,163,786,0.01,159,12,4,200.0
1998,Equatorial Guinea,439,0.01,140,317,0.01,169,756,0.01,160,-122,-139,-12.23
1998,Bermuda,45,0.0,177,629,0.01,148,674,0.01,161,584,562,3.91
1998,Greenland,255,0.0,155,409,0.01,162,664,0.01,162,154,104,48.08
1998,Afghanistan,159,0.0,164,462,0.01,161,621,0.01,163,303,460,-34.13
1998,Chad,262,0.0,154,356,0.01,166,618,0.01,164,94,97,-3.09
1998,Eritrea,28,0.0,181,508,0.01,156,536,0.0,165,480,468,2.56
1998,Seychelles,122,0.0,167,384,0.01,165,506,0.0,166,262,227,15.42
1998,Belize,172,0.0,163,295,0.01,170,467,0.0,167,123,110,11.82
1998,Maldives,96,0.0,170,354,0.01,167,450,0.0,168,258,259,-0.39
1998,Antigua and Barbuda,36,0.0,178,385,0.01,164,421,0.0,169,349,341,2.35
1998,Saint Lucia,62,0.0,173,328,0.01,168,390,0.0,170,266,271,-1.85
1998,Somalia,127,0.0,166,257,0.0,172,384,0.0,171,130,134,-2.99
1998,Rwanda,60,0.0,175,285,0.01,171,345,0.0,172,225,209,7.66
1998,Central African Republic,151,0.0,165,146,0.0,180,297,0.0,173,-5,-22,-77.27
1998,The Gambia,21,0.0,186,228,0.0,173,249,0.0,174,207,263,-21.29
1998,Solomon Islands,118,0.0,168,128,0.0,183,246,0.0,175,10,1,900.0
1998,Saint Vincent and the Grenadines,50,0.0,176,193,0.0,177,243,0.0,176,143,142,0.7
1998,Bhutan,108,0.0,169,134,0.0,181,242,0.0,177,26,19,36.84
1998,Cabo Verde,10,0.0,189,228,0.0,173,238,0.0,178,218,221,-1.36
1998,Grenada,35,0.0,179,200,0.0,175,235,0.0,179,165,150,10.0
1998,Djibouti,28,0.0,181,196,0.0,176,224,0.0,180,168,145,15.86
1998,Burundi,65,0.0,172,158,0.0,178,223,0.0,181,93,35,165.71
1998,Dominica,62,0.0,173,132,0.0,182,194,0.0,182,70,83,-15.66
1998,Saint Kitts and Nevis,28,0.0,181,149,0.0,179,177,0.0,183,121,106,14.15
1998,Vanuatu,34,0.0,180,93,0.0,187,127,0.0,184,59,59,0.0
1998,"Micronesia, Federated States of",24,0.0,185,100,0.0,184,124,0.0,185,76,82,-7.32
1998,Samoa,15,0.0,187,97,0.0,185,112,0.0,186,82,82,0.0
1998,Sierra Leone,7,0.0,190,95,0.0,186,102,0.0,187,88,76,15.79
1998,Guinea-Bissau,27,0.0,184,63,0.0,191,90,0.0,188,36,41,-12.2
1998,Guam,86,0.0,171,0,0.0,200,86,0.0,189,-86,-89,-3.37
1998,Tonga,7,0.0,190,69,0.0,188,76,0.0,190,62,63,-1.59
1998,Palau,11,0.0,188,63,0.0,191,74,0.0,191,52,66,-21.21
1998,Marshall Islands,6,0.0,192,67,0.0,189,73,0.0,192,61,45,35.56
1998,Saint Pierre and Miquelon,5,0.0,195,64,0.0,190,69,0.0,193,59,61,-3.28
1998,Comoros,6,0.0,192,54,0.0,193,60,0.0,194,48,49,-2.04
1998,Cook Islands,3,0.0,198,38,0.0,194,41,0.0,195,35,45,-22.22
1998,Kiribati,6,0.0,192,33,0.0,195,39,0.0,196,27,33,-18.18
1998,Montserrat,4,0.0,197,19,0.0,196,23,0.0,197,15,29,-48.28
1998,Sao Tomé and Principe,5,0.0,195,17,0.0,197,22,0.0,198,12,11,9.09
1998,Tuvalu,0,0.0,199,10,0.0,198,10,0.0,199,10,8,25.0
1998,Niue,0,0.0,199,2,0.0,199,2,0.0,200,2,2,0.0
1997,United States of America,689182,12.33,1,899020,15.85,1,1588202,14.1,1,209838,196952,6.54
1997,Germany,512891,9.17,2,445731,7.86,2,958622,8.51,2,-67160,-65551,2.45
1997,Japan,420957,7.53,3,338754,5.97,3,759711,6.75,3,-82203,-61749,33.12
1997,United Kingdom,280406,5.01,5,307518,5.42,4,587924,5.22,4,27112,28805,-5.88
1997,France,302144,5.4,4,285027,5.03,5,587171,5.21,5,-17117,-10949,56.33
1997,Italy,240414,4.3,6,210132,3.71,7,450546,4.0,6,-30282,-44030,-31.22
1997,Canada,214422,3.83,7,200873,3.54,8,415295,3.69,7,-13549,-26475,-48.82
1997,"Hong Kong, China",188195,3.37,9,213297,3.76,6,401492,3.56,8,25102,20370,23.23
1997,Netherlands,207832,3.72,8,190731,3.36,9,398563,3.54,9,-17101,-18076,-5.39
1997,Belgium-Luxembourg,174531,3.12,11,161930,2.86,10,336461,2.99,10,-12601,-9423,33.73
1997,China,182792,3.27,10,142370,2.51,12,325162,2.89,11,-40422,-12215,230.92
1997,"Korea, Republic of",136164,2.44,12,144616,2.55,11,280780,2.49,12,8452,20624,-59.02
1997,Singapore,124985,2.24,13,132437,2.34,13,257422,2.29,13,7452,6324,17.84
1997,Chinese Taipei,123159,2.2,14,114446,2.02,15,237605,2.11,14,-8713,-14252,-38.86
1997,Mexico,110431,1.97,15,113121,1.99,16,223552,1.98,15,2690,-4021,-166.9
1997,Spain,100756,1.8,16,115670,2.04,14,216426,1.92,16,14914,13978,6.7
1997,Russian Federation,86895,1.55,17,71983,1.27,19,158878,1.41,17,-14912,-21593,-30.94
1997,Malaysia,78736,1.41,19,79029,1.39,17,157765,1.4,18,293,91,221.98
1997,Switzerland,76150,1.36,20,75960,1.34,18,152110,1.35,19,-190,-1523,-87.52
1997,Sweden,82757,1.48,18,65596,1.16,22,148353,1.32,20,-17161,-17986,-4.59
1997,Australia,62910,1.13,21,65892,1.16,20,128802,1.14,21,2982,5126,-41.83
1997,Austria,59784,1.07,23,65739,1.16,21,125523,1.11,22,5955,10283,-42.09
1997,Thailand,57345,1.03,24,62854,1.11,24,120199,1.07,23,5509,16611,-66.84
1997,Brazil,52994,0.95,27,64242,1.13,23,117236,1.04,24,11248,9234,21.81
1997,Indonesia,56298,1.01,25,51304,0.9,25,107602,0.96,25,-4994,-6885,-27.47
1997,Denmark,49273,0.88,28,44902,0.79,27,94175,0.84,26,-4371,-6124,-28.63
1997,Ireland,53348,0.95,26,37748,0.67,31,91096,0.81,27,-15600,-14019,11.28
1997,"Saudi Arabia, Kingdom of",60732,1.09,22,28732,0.51,39,89464,0.79,28,-32000,-32985,-2.99
1997,Norway,48542,0.87,29,35709,0.63,32,84251,0.75,29,-12833,-14030,-8.53
1997,India,35008,0.63,32,41432,0.73,29,76440,0.68,30,6424,4837,32.81
1997,Türkiye,26260,0.47,35,48560,0.86,26,74820,0.66,31,22300,20383,9.4
1997,United Arab Emirates,40423,0.72,31,34107,0.6,34,74530,0.66,32,-6316,-6771,-6.72
1997,Finland,41471,0.74,30,31611,0.56,36,73082,0.65,33,-9860,-9702,1.63
1997,Poland,25750,0.46,36,42310,0.75,28,68060,0.6,34,16560,12695,30.45
1997,South Africa,31027,0.55,33,32998,0.58,35,64025,0.57,35,1971,961,105.1
1997,Philippines,24882,0.44,37,38622,0.68,30,63504,0.56,36,13740,13718,0.16
1997,Portugal,23955,0.43,38,35055,0.62,33,59010,0.52,37,11100,10584,4.88
1997,Argentina,26370,0.47,34,30450,0.54,38,56820,0.5,38,4080,-49,-8426.53
1997,Israel,22503,0.4,40,30782,0.54,37,53285,0.47,39,8279,11010,-24.8
1997,Czech Republic,22360,0.4,41,27105,0.48,40,49465,0.44,40,4745,5635,-15.79
1997,Hungary,19100,0.34,42,21235,0.37,42,40335,0.36,41,2135,2440,-12.5
1997,Chile,17870,0.32,44,20822,0.37,43,38692,0.34,42,2952,2572,14.77
1997,"Venezuela, Bolivarian Republic of",23871,0.43,39,14606,0.26,46,38477,0.34,43,-9265,-13180,-29.7
1997,Greece,11326,0.2,51,26919,0.47,41,38245,0.34,44,15593,16527,-5.65
1997,Iran,18381,0.33,43,14196,0.25,48,32577,0.29,45,-4185,-6117,-31.58
1997,Ukraine,14232,0.25,46,17128,0.3,44,31360,0.28,46,2896,3202,-9.56
1997,New Zealand,14223,0.25,48,14519,0.26,47,28742,0.26,47,296,362,-18.23
1997,Colombia,11522,0.21,50,15378,0.27,45,26900,0.24,48,3856,3097,24.51
1997,Nigeria,15207,0.27,45,9501,0.17,55,24708,0.22,49,-5706,-9715,-41.27
1997,Algeria,13894,0.25,49,8688,0.15,59,22582,0.2,50,-5206,-4160,25.14
1997,"Kuwait, the State of",14224,0.25,47,8246,0.15,61,22470,0.2,51,-5978,-6516,-8.26
1997,Slovak Republic,9635,0.17,52,11725,0.21,50,21360,0.19,52,2090,2295,-8.93
1997,Viet Nam,9185,0.16,54,11592,0.2,52,20777,0.18,53,2407,3889,-38.11
1997,Pakistan,8717,0.16,55,11596,0.2,51,20313,0.18,54,2879,2810,2.46
1997,Romania,8431,0.15,56,11280,0.2,53,19711,0.18,55,2849,3350,-14.96
1997,Slovenia,8372,0.15,57,9357,0.16,56,17729,0.16,56,985,1111,-11.34
1997,Egypt,3921,0.07,77,13211,0.23,49,17132,0.15,57,9290,9484,-2.05
1997,Morocco,7032,0.13,60,9525,0.17,54,16557,0.15,58,2493,2823,-11.69
1997,Belarus,7301,0.13,59,8689,0.15,58,15990,0.14,59,1388,1287,7.85
1997,Peru,6825,0.12,61,8558,0.15,60,15383,0.14,60,1733,2069,-16.24
1997,Libya,9576,0.17,53,5533,0.1,68,15109,0.13,61,-4043,-4568,-11.49
1997,Tunisia,5559,0.1,63,7914,0.14,62,13473,0.12,62,2355,2184,7.83
1997,Croatia,3981,0.07,76,9101,0.16,57,13082,0.12,63,5120,3141,63.01
1997,Oman,7630,0.14,58,5191,0.09,69,12821,0.11,64,-2439,-2618,-6.84
1997,Bangladesh,4832,0.09,68,7263,0.13,64,12095,0.11,65,2431,2783,-12.65
1997,Dominican Republic,4614,0.08,70,6609,0.12,65,11223,0.1,66,1995,1674,19.18
1997,Kazakhstan,6497,0.12,62,4301,0.08,76,10798,0.1,67,-2196,-1670,31.5
1997,Sri Lanka,4639,0.08,69,5839,0.1,66,10478,0.09,68,1200,1321,-9.16
1997,Ecuador,5264,0.09,65,4955,0.09,71,10219,0.09,69,-309,-965,-67.98
1997,Bulgaria,4940,0.09,67,4930,0.09,72,9870,0.09,70,-10,185,-105.41
1997,Lithuania,3860,0.07,79,5645,0.1,67,9505,0.08,71,1785,1205,48.13
1997,Costa Rica,4335,0.08,74,4970,0.09,70,9305,0.08,72,635,569,11.6
1997,Iraq,4602,0.08,71,4419,0.08,75,9021,0.08,73,-183,2801,-106.53
1997,Qatar,5500,0.1,64,3322,0.06,87,8822,0.08,74,-2178,-1632,33.46
1997,"Bahrain, Kingdom of",4384,0.08,73,4026,0.07,80,8410,0.07,75,-358,-428,-16.36
1997,Uzbekistan,4025,0.07,75,4185,0.07,77,8210,0.07,76,160,500,-68.0
1997,Lebanese Republic,643,0.01,127,7467,0.13,63,8110,0.07,77,6824,6804,0.29
1997,Syrian Arab Republic,3916,0.07,78,4028,0.07,79,7944,0.07,78,112,1381,-91.89
1997,Angola,5007,0.09,66,2597,0.05,96,7604,0.07,79,-2410,-3055,-21.11
1997,Serbia and Montenegro,2677,0.05,84,4799,0.08,73,7476,0.07,80,2122,2084,1.82
1997,Estonia,2936,0.05,81,4437,0.08,74,7373,0.07,81,1501,1146,30.98
1997,Côte d'Ivoire,4451,0.08,72,2781,0.05,93,7232,0.06,82,-1670,-1544,8.16
1997,Uruguay,2726,0.05,83,3727,0.07,84,6453,0.06,83,1001,926,8.1
1997,Guatemala,2391,0.04,92,3852,0.07,82,6243,0.06,84,1461,1090,34.04
1997,El Salvador,2416,0.04,90,3739,0.07,83,6155,0.05,85,1323,1434,-7.74
1997,Jordan,1836,0.03,98,4102,0.07,78,5938,0.05,86,2266,2477,-8.52
1997,Paraguay,2402,0.04,91,3403,0.06,86,5805,0.05,87,1001,1022,-2.05
1997,Cuba,1812,0.03,99,3987,0.07,81,5799,0.05,88,2175,1190,82.77
1997,Zimbabwe,2541,0.05,86,3092,0.05,90,5633,0.05,89,551,397,38.79
1997,Trinidad and Tobago,2543,0.05,85,2988,0.05,92,5531,0.05,90,445,-354,-225.71
1997,Kenya,2054,0.04,95,3279,0.06,88,5333,0.05,91,1225,881,39.05
1997,Botswana,2842,0.05,82,2258,0.04,100,5100,0.05,92,-584,-724,-19.34
1997,Honduras,2440,0.04,89,2631,0.05,95,5071,0.05,93,191,138,38.41
1997,Cyprus,1250,0.02,110,3655,0.06,85,4905,0.04,94,2405,2588,-7.07
1997,Brunei Darussalam,2467,0.04,88,2203,0.04,101,4670,0.04,95,-264,13,-2130.77
1997,Yemen,2504,0.04,87,2014,0.04,108,4518,0.04,96,-490,-637,-23.08
1997,Jamaica,1383,0.02,108,3131,0.06,89,4514,0.04,97,1748,1582,10.49
1997,Latvia,1672,0.03,101,2721,0.05,94,4393,0.04,98,1049,877,19.61
1997,"Macao, China",2148,0.04,94,2082,0.04,105,4230,0.04,99,-66,4,-1750.0
1997,Malta,1641,0.03,103,2552,0.05,97,4193,0.04,100,911,1070,-14.86
1997,Gabon,3024,0.05,80,1104,0.02,126,4128,0.04,101,-1920,-2227,-13.79
1997,Ghana,1635,0.03,104,2326,0.04,99,3961,0.04,102,691,439,57.4
1997,Papua New Guinea,2163,0.04,93,1711,0.03,112,3874,0.03,103,-452,-788,-42.64
1997,Iceland,1851,0.03,97,2018,0.04,107,3869,0.03,104,167,145,15.17
1997,"Aruba, Netherlands with respect to",1725,0.03,100,2116,0.04,103,3841,0.03,105,391,302,29.47
1997,Mauritius,1592,0.03,105,2189,0.04,102,3781,0.03,106,597,487,22.59
1997,Panama,723,0.01,125,3002,0.05,91,3725,0.03,107,2279,2157,5.66
1997,Netherlands Antilles,1488,0.03,106,2083,0.04,104,3571,0.03,108,595,1250,-52.4
1997,Cameroon,1860,0.03,96,1359,0.02,118,3219,0.03,109,-501,-541,-7.39
1997,Namibia,1338,0.02,109,1753,0.03,111,3091,0.03,110,415,252,64.68
1997,"Bolivia, Plurinational State of",1167,0.02,112,1851,0.03,109,3018,0.03,111,684,498,37.35
1997,North Macedonia,1237,0.02,111,1779,0.03,110,3016,0.03,112,542,480,12.92
1997,Bosnia and Herzegovina,575,0.01,134,2333,0.04,98,2908,0.03,113,1758,1546,13.71
1997,Myanmar,866,0.02,119,2037,0.04,106,2903,0.03,114,1171,612,91.34
1997,Congo,1668,0.03,102,926,0.02,134,2594,0.02,115,-742,206,-460.19
1997,"Korea, Democratic People's Republic of",1098,0.02,113,1387,0.02,117,2485,0.02,116,289,411,-29.68
1997,Senegal,905,0.02,117,1335,0.02,120,2240,0.02,117,430,448,-4.02
1997,Turkmenistan,1000,0.02,114,1230,0.02,122,2230,0.02,118,230,-380,-160.53
1997,Democratic Republic of the Congo,1449,0.03,107,770,0.01,139,2219,0.02,119,-679,-458,48.25
1997,Sudan,594,0.01,131,1580,0.03,115,2174,0.02,120,986,928,6.25
1997,Nepal,406,0.01,148,1693,0.03,113,2099,0.02,121,1287,1013,27.05
1997,Tanzania,753,0.01,122,1337,0.02,119,2090,0.02,122,584,604,-3.31
1997,"Moldova, Republic of",875,0.02,118,1170,0.02,123,2045,0.02,123,295,275,7.27
1997,Eswatini,962,0.02,115,1066,0.02,127,2028,0.02,124,104,206,-49.51
1997,Nicaragua,577,0.01,133,1450,0.03,116,2027,0.02,125,873,688,26.89
1997,Uganda,555,0.01,138,1316,0.02,121,1871,0.02,126,761,604,25.99
1997,Bahamas,181,0.0,161,1622,0.03,114,1803,0.02,127,1441,1179,22.22
1997,Cambodia,736,0.01,124,1064,0.02,128,1800,0.02,128,328,428,-23.36
1997,Zambia,915,0.02,116,819,0.01,136,1734,0.02,129,-96,-202,-52.48
1997,Ethiopia,587,0.01,132,1113,0.02,125,1700,0.02,130,526,984,-46.54
1997,Fiji,622,0.01,128,965,0.02,130,1587,0.01,131,343,239,43.51
1997,Azerbaijan,780,0.01,121,794,0.01,137,1574,0.01,132,14,331,-95.77
1997,Tajikistan,745,0.01,123,750,0.01,140,1495,0.01,133,5,-100,-105.0
1997,New Caledonia,543,0.01,139,929,0.02,133,1472,0.01,134,386,460,-16.09
1997,Lesotho,196,0.0,160,1140,0.02,124,1336,0.01,135,944,939,0.53
1997,Malawi,537,0.01,140,781,0.01,138,1318,0.01,136,244,143,70.63
1997,Kyrgyz Republic,604,0.01,129,709,0.01,143,1313,0.01,137,105,333,-68.47
1997,Guinea,685,0.01,126,620,0.01,152,1305,0.01,138,-65,-61,6.56
1997,Mali,561,0.01,137,739,0.01,141,1300,0.01,139,178,339,-47.49
1997,Barbados,283,0.01,151,996,0.02,129,1279,0.01,140,713,552,29.17
1997,Northern Mariana Islands,815,0.01,120,433,0.01,160,1248,0.01,141,-382,-229,66.81
1997,Guyana,596,0.01,130,630,0.01,151,1226,0.01,142,34,51,-33.33
1997,Suriname,564,0.01,136,658,0.01,147,1222,0.01,143,94,-36,-361.11
1997,Madagascar,516,0.01,141,694,0.01,145,1210,0.01,144,178,120,48.33
1997,Georgia,240,0.0,153,944,0.02,131,1184,0.01,145,704,488,44.26
1997,French Polynesia,224,0.0,157,935,0.02,132,1159,0.01,146,711,767,-7.3
1997,Armenia,233,0.0,155,892,0.02,135,1125,0.01,147,659,566,16.43
1997,Benin,424,0.01,145,681,0.01,146,1105,0.01,148,257,126,103.97
1997,Togo,424,0.01,145,645,0.01,150,1069,0.01,149,221,223,-0.9
1997,Lao People's Democratic Republic,359,0.01,149,706,0.01,144,1065,0.01,150,347,367,-5.45
1997,Liberia,430,0.01,143,610,0.01,154,1040,0.01,151,180,-75,-340.0
1997,Mongolia,569,0.01,135,468,0.01,159,1037,0.01,152,-101,27,-474.07
1997,Mozambique,222,0.0,158,739,0.01,141,961,0.01,153,517,542,-4.61
1997,American Samoa,424,0.01,145,529,0.01,157,953,0.01,154,105,158,-33.54
1997,Mauritania,429,0.01,144,433,0.01,160,862,0.01,155,4,-41,-109.76
1997,Haiti,212,0.0,159,648,0.01,148,860,0.01,156,436,575,-24.17
1997,Equatorial Guinea,497,0.01,142,358,0.01,165,855,0.01,157,-139,60,-331.67
1997,Burkina Faso,232,0.0,156,587,0.01,156,819,0.01,158,355,414,-14.25
1997,Albania,139,0.0,167,646,0.01,149,785,0.01,159,507,731,-30.64
1997,Afghanistan,144,0.0,166,604,0.01,155,748,0.01,160,460,533,-13.7
1997,Greenland,293,0.01,150,397,0.01,162,690,0.01,161,104,100,4.0
1997,Bermuda,57,0.0,175,619,0.01,153,676,0.01,162,562,501,12.18
1997,Niger,272,0.0,152,374,0.01,164,646,0.01,163,102,123,-17.07
1997,Eritrea,57,0.0,175,525,0.01,158,582,0.01,164,468,455,2.86
1997,Chad,237,0.0,154,334,0.01,168,571,0.01,165,97,94,3.19
1997,Belize,176,0.0,162,286,0.01,172,462,0.0,166,110,87,26.44
1997,Seychelles,113,0.0,169,340,0.01,167,453,0.0,167,227,239,-5.02
1997,Somalia,157,0.0,164,291,0.01,171,448,0.0,168,134,91,47.25
1997,Maldives,90,0.0,170,349,0.01,166,439,0.0,169,259,222,16.67
1997,Antigua and Barbuda,38,0.0,181,379,0.01,163,417,0.0,170,341,327,4.28
1997,Saint Lucia,61,0.0,174,332,0.01,169,393,0.0,171,271,233,16.31
1997,Rwanda,88,0.0,172,297,0.01,170,385,0.0,172,209,198,5.56
1997,Solomon Islands,157,0.0,164,158,0.0,178,315,0.0,173,1,-11,-109.09
1997,Central African Republic,163,0.0,163,141,0.0,180,304,0.0,174,-22,-6,266.67
1997,The Gambia,15,0.0,188,278,0.0,173,293,0.0,175,263,237,10.97
1997,Bhutan,118,0.0,168,137,0.0,181,255,0.0,176,19,28,-32.14
1997,Cabo Verde,14,0.0,190,235,0.0,174,249,0.0,177,221,221,0.0
1997,Saint Vincent and the Grenadines,46,0.0,179,188,0.0,175,234,0.0,178,142,86,65.12
1997,Burundi,86,0.0,173,121,0.0,183,207,0.0,179,35,88,-60.23
1997,Djibouti,31,0.0,183,176,0.0,176,207,0.0,179,145,143,1.4
1997,Grenada,23,0.0,184,173,0.0,177,196,0.0,181,150,132,13.64
1997,Saint Kitts and Nevis,41,0.0,180,147,0.0,179,188,0.0,182,106,127,-16.54
1997,Dominica,52,0.0,177,135,0.0,182,187,0.0,183,83,82,1.22
1997,Guinea-Bissau,48,0.0,178,89,0.0,188,137,0.0,184,41,59,-30.51
1997,Vanuatu,35,0.0,182,94,0.0,186,129,0.0,185,59,68,-13.24
1997,"Micronesia, Federated States of",17,0.0,185,99,0.0,184,116,0.0,186,82,82,0.0
1997,Samoa,15,0.0,188,97,0.0,185,112,0.0,187,82,90,-8.89
1997,Sierra Leone,17,0.0,185,93,0.0,187,110,0.0,188,76,164,-53.66
1997,Palau,14,0.0,190,80,0.0,189,94,0.0,189,66,50,32.0
1997,Guam,89,0.0,171,0,0.0,200,89,0.0,190,-89,-73,21.92
1997,Tonga,10,0.0,192,73,0.0,190,83,0.0,191,63,64,-1.56
1997,Marshall Islands,16,0.0,187,61,0.0,192,77,0.0,192,45,54,-16.67
1997,Saint Pierre and Miquelon,5,0.0,195,66,0.0,191,71,0.0,193,61,70,-12.86
1997,Comoros,6,0.0,193,55,0.0,193,61,0.0,194,49,51,-3.92
1997,Cook Islands,3,0.0,197,48,0.0,194,51,0.0,195,45,40,12.5
1997,Kiribati,6,0.0,193,39,0.0,195,45,0.0,196,33,33,0.0
1997,Montserrat,3,0.0,197,32,0.0,196,35,0.0,197,29,27,7.41
1997,Sao Tomé and Principe,5,0.0,195,16,0.0,197,21,0.0,198,11,18,-38.89
1997,Tuvalu,0,0.0,199,8,0.0,198,8,0.0,199,8,6,33.33
1997,Niue,0,0.0,199,2,0.0,199,2,0.0,200,2,4,-50.0
1996,United States of America,625073,11.56,1,822025,14.99,1,1447098,13.29,1,196952,186109,5.83
1996,Germany,524649,9.71,2,459098,8.37,2,983747,9.03,2,-65551,-59589,10.01
1996,Japan,410901,7.6,3,349152,6.37,3,760053,6.98,3,-61749,-107234,-42.42
1996,France,305509,5.65,4,294560,5.37,4,600069,5.51,4,-10949,-11771,-6.98
1996,United Kingdom,258527,4.78,5,287332,5.24,5,545859,5.01,5,28805,29297,-1.68
1996,Italy,252293,4.67,6,208263,3.8,6,460556,4.23,6,-44030,-27776,58.52
1996,Netherlands,208999,3.87,7,190923,3.48,8,399922,3.67,7,-18076,-17939,0.76
1996,"Hong Kong, China",180914,3.35,9,201284,3.67,7,382198,3.51,8,20370,22201,-8.25
1996,Canada,201633,3.73,8,175158,3.19,9,376791,3.46,9,-26475,-23771,11.38
1996,Belgium-Luxembourg,177337,3.28,10,167914,3.06,10,345251,3.17,10,-9423,-13331,-29.32
1996,China,151048,2.79,11,138833,2.53,12,289881,2.66,11,-12215,-16696,-26.84
1996,"Korea, Republic of",129715,2.4,12,150339,2.74,11,280054,2.57,12,20624,10061,104.99
1996,Singapore,125014,2.31,13,131338,2.4,13,256352,2.35,13,6324,6239,1.36
1996,Spain,107243,1.98,15,121221,2.21,14,228464,2.1,14,13978,15688,-10.9
1996,Chinese Taipei,117331,2.17,14,103079,1.88,15,220410,2.02,15,-14252,-9489,50.19
1996,Mexico,96000,1.78,16,91979,1.68,16,187979,1.73,16,-4021,-5115,-21.39
1996,Switzerland,79747,1.48,19,78224,1.43,18,157971,1.45,17,-1523,-1489,2.28
1996,Russian Federation,89685,1.66,17,68092,1.24,21,157777,1.45,18,-21593,-19816,8.97
1996,Malaysia,78327,1.45,20,78418,1.43,17,156745,1.44,19,91,3776,-97.59
1996,Sweden,84916,1.57,18,66930,1.22,22,151846,1.39,20,-17986,-15404,16.76
1996,Thailand,55721,1.03,24,72332,1.32,19,128053,1.18,21,16611,14347,15.78
1996,Austria,58222,1.08,23,68505,1.25,20,126727,1.16,22,10283,8499,20.99
1996,Australia,60301,1.12,22,65427,1.19,23,125728,1.15,23,5126,8172,-37.27
1996,Brazil,47747,0.88,29,56981,1.04,24,104728,0.96,24,9234,7631,21.01
1996,Denmark,51415,0.95,25,45291,0.83,25,96706,0.89,25,-6124,-4967,23.29
1996,Indonesia,49814,0.92,26,42929,0.78,27,92743,0.85,26,-6885,-4787,43.83
1996,"Saudi Arabia, Kingdom of",60729,1.12,21,27744,0.51,40,88473,0.81,27,-32985,-21949,50.28
1996,Norway,49645,0.92,27,35615,0.65,30,85260,0.78,28,-14030,-9024,55.47
1996,Ireland,48339,0.89,28,34320,0.63,32,82659,0.76,29,-14019,-12365,13.38
1996,Finland,41124,0.76,30,31422,0.57,35,72546,0.67,30,-9702,-11020,-11.96
1996,India,33105,0.61,32,37942,0.69,28,71047,0.65,31,4837,4077,18.64
1996,United Arab Emirates,37334,0.69,31,30563,0.56,36,67897,0.62,32,-6771,-4586,47.65
1996,Türkiye,23245,0.43,37,43628,0.8,26,66873,0.61,33,20383,14111,44.45
1996,Poland,24440,0.45,35,37135,0.68,29,61575,0.57,34,12695,6155,106.26
1996,Portugal,24618,0.46,34,35202,0.64,31,59820,0.55,35,10584,9827,7.7
1996,South Africa,29221,0.54,33,30182,0.55,37,59403,0.55,36,961,2693,-64.31
1996,Philippines,20408,0.38,42,34126,0.62,33,54534,0.5,37,13718,10839,26.56
1996,Israel,20610,0.38,41,31620,0.58,34,52230,0.48,38,11010,10533,4.53
1996,Czech Republic,22165,0.41,40,27800,0.51,39,49965,0.46,39,5635,3750,50.27
1996,Argentina,23811,0.44,36,23762,0.43,41,47573,0.44,40,-49,-845,-94.2
1996,Greece,11711,0.22,50,28238,0.52,38,39949,0.37,41,16527,14844,11.34
1996,Iran,22391,0.41,39,16274,0.3,45,38665,0.36,42,-6117,-4478,36.6
1996,Chile,16627,0.31,43,19199,0.35,42,35826,0.33,43,2572,-126,-2141.27
1996,Hungary,15705,0.29,45,18145,0.33,43,33850,0.31,44,2440,2600,-6.15
1996,"Venezuela, Bolivarian Republic of",23060,0.43,38,9880,0.18,53,32940,0.3,45,-13180,-5808,126.93
1996,Ukraine,14401,0.27,47,17603,0.32,44,32004,0.29,46,3202,2356,35.91
1996,New Zealand,14362,0.27,48,14724,0.27,46,29086,0.27,47,362,312,16.03
1996,Colombia,10587,0.2,51,13684,0.25,47,24271,0.22,48,3097,3727,-16.9
1996,"Kuwait, the State of",14889,0.28,46,8373,0.15,57,23262,0.21,49,-6516,-4995,30.45
1996,Nigeria,16153,0.3,44,6438,0.12,64,22591,0.21,50,-9715,-4120,135.8
1996,Algeria,13250,0.25,49,9090,0.17,56,22340,0.21,51,-4160,-158,2532.91
1996,Pakistan,9321,0.17,53,12131,0.22,49,21452,0.2,52,2810,3469,-19.0
1996,Slovak Republic,8830,0.16,54,11125,0.2,52,19955,0.18,53,2295,190,1107.89
1996,Romania,8085,0.15,56,11435,0.21,50,19520,0.18,54,3350,2368,41.47
1996,Viet Nam,7255,0.13,58,11144,0.2,51,18399,0.17,55,3889,2706,43.72
1996,Slovenia,8312,0.15,55,9423,0.17,55,17735,0.16,56,1111,1176,-5.53
1996,Morocco,6881,0.13,59,9704,0.18,54,16585,0.15,57,2823,3142,-10.15
1996,Egypt,3535,0.07,77,13019,0.24,48,16554,0.15,58,9484,8304,14.21
1996,Libya,10155,0.19,52,5587,0.1,66,15742,0.14,59,-4568,-3363,35.83
1996,Peru,5878,0.11,61,7947,0.14,58,13825,0.13,60,2069,2093,-1.15
1996,Tunisia,5516,0.1,63,7700,0.14,60,13216,0.12,61,2184,2427,-10.01
1996,Belarus,5652,0.1,62,6939,0.13,63,12591,0.12,62,1287,761,69.12
1996,Croatia,4643,0.09,68,7784,0.14,59,12427,0.11,63,3141,2835,10.79
1996,Oman,7346,0.14,57,4728,0.09,70,12074,0.11,64,-2618,-1689,55.0
1996,Bangladesh,4249,0.08,71,7032,0.13,62,11281,0.1,65,2783,3193,-12.84
1996,Kazakhstan,5911,0.11,60,4241,0.08,76,10152,0.09,66,-1670,-1443,15.73
1996,Bulgaria,4890,0.09,66,5075,0.09,69,9965,0.09,67,185,305,-39.34
1996,Dominican Republic,4053,0.07,74,5727,0.1,65,9780,0.09,68,1674,1390,20.43
1996,Sri Lanka,4095,0.08,73,5416,0.1,67,9511,0.09,69,1321,1387,-4.76
1996,Syrian Arab Republic,3999,0.07,75,5380,0.1,68,9379,0.09,70,1381,1146,20.51
1996,"Bahrain, Kingdom of",4700,0.09,67,4272,0.08,75,8972,0.08,71,-428,-398,7.54
1996,Uzbekistan,4210,0.08,72,4710,0.09,71,8920,0.08,72,500,-680,-173.53
1996,Ecuador,4900,0.09,65,3935,0.07,79,8835,0.08,73,-965,-114,746.49
1996,Lebanese Republic,736,0.01,122,7540,0.14,61,8276,0.08,74,6804,6622,2.75
1996,Costa Rica,3758,0.07,76,4327,0.08,73,8085,0.07,75,569,614,-7.33
1996,Lithuania,3355,0.06,78,4560,0.08,72,7915,0.07,76,1205,945,27.51
1996,Qatar,4500,0.08,69,2868,0.05,90,7368,0.07,77,-1632,-159,926.42
1996,Côte d'Ivoire,4446,0.08,70,2902,0.05,89,7348,0.07,78,-1544,-875,76.46
1996,Angola,5095,0.09,64,2040,0.04,102,7135,0.07,79,-3055,-2174,40.52
1996,Serbia and Montenegro,2018,0.04,91,4102,0.07,77,6120,0.06,80,2084,1135,83.61
1996,Jordan,1816,0.03,96,4293,0.08,74,6109,0.06,81,2477,1928,28.48
1996,Uruguay,2397,0.04,86,3323,0.06,81,5720,0.05,82,926,761,21.68
1996,Paraguay,2182,0.04,87,3204,0.06,85,5386,0.05,83,1022,1125,-9.16
1996,Cyprus,1391,0.03,107,3979,0.07,78,5370,0.05,84,2588,2461,5.16
1996,Estonia,2078,0.04,88,3224,0.06,82,5302,0.05,85,1146,706,62.32
1996,Cuba,2015,0.04,92,3205,0.06,84,5220,0.05,86,1190,1225,-2.86
1996,Zimbabwe,2406,0.04,85,2803,0.05,91,5209,0.05,87,397,542,-26.75
1996,Guatemala,2056,0.04,90,3146,0.06,86,5202,0.05,88,1090,1302,-16.28
1996,Kenya,2068,0.04,89,2949,0.05,88,5017,0.05,89,881,1112,-20.77
1996,El Salvador,1789,0.03,98,3223,0.06,83,5012,0.05,90,1434,1677,-14.49
1996,Brunei Darussalam,2481,0.05,83,2494,0.05,95,4975,0.05,91,13,-311,-104.18
1996,Yemen,2675,0.05,80,2038,0.04,103,4713,0.04,92,-637,-363,75.48
1996,Trinidad and Tobago,2500,0.05,82,2146,0.04,98,4646,0.04,93,-354,-740,-52.16
1996,Malta,1731,0.03,101,2801,0.05,92,4532,0.04,94,1070,976,9.63
1996,Jamaica,1383,0.03,108,2965,0.05,87,4348,0.04,95,1582,1391,13.73
1996,Papua New Guinea,2529,0.05,81,1741,0.03,107,4270,0.04,96,-788,-1202,-34.44
1996,Iraq,731,0.01,123,3532,0.06,80,4263,0.04,97,2801,169,1557.4
1996,Botswana,2447,0.05,84,1723,0.03,108,4170,0.04,98,-724,-231,213.42
1996,Honduras,2007,0.04,93,2145,0.04,99,4152,0.04,99,138,110,25.45
1996,Gabon,3184,0.06,79,957,0.02,134,4141,0.04,100,-2227,-1831,21.63
1996,Mauritius,1802,0.03,97,2289,0.04,97,4091,0.04,101,487,438,11.19
1996,"Macao, China",1996,0.04,94,2000,0.04,105,3996,0.04,102,4,45,-91.11
1996,Iceland,1897,0.04,95,2042,0.04,101,3939,0.04,103,145,-44,-429.55
1996,Netherlands Antilles,1269,0.02,110,2519,0.05,94,3788,0.03,104,1250,319,291.85
1996,Ghana,1669,0.03,103,2108,0.04,100,3777,0.03,105,439,182,141.21
1996,"Aruba, Netherlands with respect to",1733,0.03,100,2035,0.04,104,3768,0.03,106,302,250,20.8
1996,Latvia,1443,0.03,105,2320,0.04,96,3763,0.03,107,877,513,70.96
1996,Panama,623,0.01,128,2780,0.05,93,3403,0.03,108,2157,1886,14.37
1996,Namibia,1418,0.03,106,1670,0.03,109,3088,0.03,109,252,207,21.74
1996,Turkmenistan,1695,0.03,102,1315,0.02,121,3010,0.03,110,-380,-515,-26.21
1996,Cameroon,1768,0.03,99,1227,0.02,122,2995,0.03,111,-541,-452,19.69
1996,Congo,1345,0.02,109,1551,0.03,112,2896,0.03,112,206,-502,-141.04
1996,North Macedonia,1147,0.02,111,1627,0.03,111,2774,0.03,113,480,515,-6.8
1996,"Bolivia, Plurinational State of",1137,0.02,112,1635,0.03,110,2772,0.03,114,498,323,54.18
1996,Democratic Republic of the Congo,1547,0.03,104,1089,0.02,126,2636,0.02,115,-458,-692,-33.82
1996,Senegal,988,0.02,114,1436,0.03,114,2424,0.02,116,448,419,6.92
1996,"Korea, Democratic People's Republic of",909,0.02,115,1320,0.02,120,2229,0.02,117,411,421,-2.38
1996,Bosnia and Herzegovina,336,0.01,147,1882,0.03,106,2218,0.02,118,1546,930,66.24
1996,Tanzania,784,0.01,118,1388,0.03,117,2172,0.02,119,604,993,-39.17
1996,Sudan,620,0.01,129,1548,0.03,113,2168,0.02,120,928,663,39.97
1996,Myanmar,746,0.01,121,1358,0.02,119,2104,0.02,121,612,484,26.45
1996,Eswatini,856,0.02,116,1062,0.02,129,1918,0.02,122,206,142,45.07
1996,Zambia,1037,0.02,113,835,0.02,138,1872,0.02,123,-202,-340,-40.59
1996,"Moldova, Republic of",795,0.01,117,1070,0.02,128,1865,0.02,124,275,95,189.47
1996,Ethiopia,417,0.01,144,1401,0.03,115,1818,0.02,125,984,723,36.1
1996,Nepal,385,0.01,145,1398,0.03,116,1783,0.02,126,1013,988,2.53
1996,Uganda,587,0.01,130,1191,0.02,123,1778,0.02,127,604,596,1.34
1996,Fiji,748,0.01,120,987,0.02,132,1735,0.02,128,239,273,-12.45
1996,Cambodia,644,0.01,125,1072,0.02,127,1716,0.02,129,428,332,28.92
1996,Nicaragua,466,0.01,140,1154,0.02,124,1620,0.01,130,688,509,35.17
1996,Azerbaijan,630,0.01,126,961,0.02,133,1591,0.01,131,331,33,903.03
1996,Bahamas,186,0.0,162,1365,0.02,118,1551,0.01,132,1179,1067,10.5
1996,New Caledonia,535,0.01,134,995,0.02,131,1530,0.01,133,460,392,17.35
1996,Tajikistan,770,0.01,119,670,0.01,144,1440,0.01,134,-100,60,-266.67
1996,Guinea,709,0.01,124,648,0.01,149,1357,0.01,135,-61,117,-152.14
1996,Kyrgyz Republic,505,0.01,137,838,0.02,137,1343,0.01,136,333,113,194.69
1996,Lesotho,187,0.0,161,1126,0.02,125,1313,0.01,137,939,947,-0.84
1996,French Polynesia,253,0.0,153,1020,0.02,130,1273,0.01,138,767,812,-5.54
1996,Mali,433,0.01,142,772,0.01,140,1205,0.01,139,339,331,2.42
1996,Liberia,630,0.01,126,555,0.01,155,1185,0.01,140,-75,-310,-75.81
1996,Benin,528,0.01,135,654,0.01,148,1182,0.01,141,126,326,-61.35
1996,Armenia,290,0.01,151,856,0.02,136,1146,0.01,142,566,403,40.45
1996,Albania,207,0.0,158,938,0.02,135,1145,0.01,143,731,512,42.77
1996,Guyana,546,0.01,132,597,0.01,153,1143,0.01,144,51,72,-29.17
1996,Madagascar,509,0.01,136,629,0.01,151,1138,0.01,145,120,121,-0.83
1996,Barbados,281,0.01,152,833,0.02,139,1114,0.01,146,552,532,3.76
1996,Togo,441,0.01,141,664,0.01,146,1105,0.01,147,223,216,3.24
1996,Malawi,481,0.01,139,624,0.01,152,1105,0.01,147,143,70,104.29
1996,Suriname,537,0.01,133,501,0.01,157,1038,0.01,149,-36,108,-133.33
1996,Lao People's Democratic Republic,323,0.01,149,690,0.01,142,1013,0.01,150,367,278,32.01
1996,Mozambique,217,0.0,157,759,0.01,141,976,0.01,151,542,536,1.12
1996,Mauritania,491,0.01,138,450,0.01,161,941,0.01,152,-41,-57,-28.07
1996,Northern Mariana Islands,563,0.01,131,334,0.01,165,897,0.01,153,-229,-192,19.27
1996,Georgia,199,0.0,159,687,0.01,143,886,0.01,154,488,241,102.49
1996,Burkina Faso,233,0.0,155,647,0.01,150,880,0.01,155,414,179,131.28
1996,Mongolia,424,0.01,143,451,0.01,160,875,0.01,156,27,-58,-146.55
1996,Greenland,369,0.01,146,469,0.01,159,838,0.01,157,100,63,58.73
1996,Afghanistan,128,0.0,167,661,0.01,147,789,0.01,158,533,221,141.18
1996,American Samoa,313,0.01,150,471,0.01,158,784,0.01,159,158,144,9.72
1996,Niger,325,0.01,148,448,0.01,162,773,0.01,160,123,86,43.02
1996,Haiti,90,0.0,170,665,0.01,145,755,0.01,161,575,543,5.89
1996,Eritrea,98,0.0,169,553,0.01,156,651,0.01,162,455,368,23.64
1996,Bermuda,68,0.0,174,569,0.01,154,637,0.01,163,501,494,1.42
1996,Chad,238,0.0,154,332,0.01,166,570,0.01,164,94,122,-22.95
1996,Equatorial Guinea,232,0.0,156,292,0.01,169,524,0.0,165,60,-6,-1100.0
1996,Seychelles,140,0.0,166,379,0.01,163,519,0.0,166,239,181,32.04
1996,Somalia,192,0.0,160,283,0.01,170,475,0.0,167,91,73,24.66
1996,Belize,168,0.0,163,255,0.0,173,423,0.0,168,87,95,-8.42
1996,Antigua and Barbuda,38,0.0,180,365,0.01,164,403,0.0,169,327,293,11.6
1996,Saint Lucia,80,0.0,171,313,0.01,167,393,0.0,170,233,198,17.68
1996,Maldives,80,0.0,171,302,0.01,168,382,0.0,171,222,183,21.31
1996,Rwanda,60,0.0,175,258,0.0,171,318,0.0,172,198,182,8.79
1996,Solomon Islands,162,0.0,164,151,0.0,178,313,0.0,173,-11,-14,-21.43
1996,Central African Republic,147,0.0,165,141,0.0,180,288,0.0,174,-6,4,-250.0
1996,The Gambia,21,0.0,185,258,0.0,171,279,0.0,175,237,166,42.77
1996,Sierra Leone,47,0.0,177,211,0.0,175,258,0.0,176,164,91,80.22
1996,Cabo Verde,13,0.0,189,234,0.0,174,247,0.0,177,221,244,-9.43
1996,Bhutan,100,0.0,168,128,0.0,183,228,0.0,178,28,9,211.11
1996,Djibouti,29,0.0,182,172,0.0,176,201,0.0,179,143,163,-12.27
1996,Dominica,51,0.0,176,133,0.0,181,184,0.0,180,82,68,20.59
1996,Saint Vincent and the Grenadines,46,0.0,178,132,0.0,182,178,0.0,181,86,93,-7.53
1996,Grenada,20,0.0,186,152,0.0,177,172,0.0,182,132,102,29.41
1996,Saint Kitts and Nevis,22,0.0,184,149,0.0,179,171,0.0,183,127,114,11.4
1996,Burundi,39,0.0,179,127,0.0,184,166,0.0,184,88,129,-31.78
1996,Vanuatu,30,0.0,181,98,0.0,187,128,0.0,185,68,67,1.49
1996,"Micronesia, Federated States of",18,0.0,188,100,0.0,185,118,0.0,186,82,68,20.59
1996,Guinea-Bissau,28,0.0,183,87,0.0,188,115,0.0,187,59,109,-45.87
1996,Samoa,10,0.0,192,100,0.0,185,110,0.0,188,90,86,4.65
1996,Marshall Islands,19,0.0,187,73,0.0,190,92,0.0,189,54,52,3.85
1996,Tonga,11,0.0,191,75,0.0,189,86,0.0,190,64,63,1.59
1996,Palau,13,0.0,189,63,0.0,192,76,0.0,191,50,38,31.58
1996,Saint Pierre and Miquelon,3,0.0,196,73,0.0,190,76,0.0,191,70,64,9.38
1996,Guam,73,0.0,173,0,0.0,200,73,0.0,193,-73,-85,-14.12
1996,Comoros,6,0.0,193,57,0.0,193,63,0.0,194,51,52,-1.92
1996,Cook Islands,3,0.0,196,43,0.0,194,46,0.0,195,40,43,-6.98
1996,Kiribati,5,0.0,194,38,0.0,195,43,0.0,196,33,28,17.86
1996,Montserrat,3,0.0,196,30,0.0,196,33,0.0,197,27,27,0.0
1996,Sao Tomé and Principe,4,0.0,195,22,0.0,197,26,0.0,198,18,24,-25.0
1996,Tuvalu,0,0.0,199,6,0.0,198,6,0.0,199,6,6,0.0
1996,Niue,0,0.0,199,4,0.0,199,4,0.0,200,4,4,0.0
1995,United States of America,584743,11.32,1,770852,14.77,1,1355595,13.05,1,186109,176588,5.39
1995,Germany,523461,10.13,2,463872,8.89,2,987333,9.51,2,-59589,-45547,30.83
1995,Japan,443116,8.58,3,335882,6.43,3,778998,7.5,3,-107234,-121770,-11.94
1995,France,301162,5.83,4,289391,5.54,4,590553,5.69,4,-11771,-4570,157.57
1995,United Kingdom,237953,4.61,5,267250,5.12,5,505203,4.86,5,29297,28997,1.03
1995,Italy,233766,4.52,6,205990,3.95,6,439756,4.23,6,-27776,-22196,25.14
1995,Netherlands,203171,3.93,7,185232,3.55,8,388403,3.74,7,-17939,-10548,70.07
1995,"Hong Kong, China",173871,3.37,10,196072,3.76,7,369943,3.56,8,22201,14413,54.03
1995,Canada,192197,3.72,8,168426,3.23,9,360623,3.47,9,-23771,-10304,130.7
1995,Belgium-Luxembourg,178265,3.45,9,164934,3.16,10,343199,3.3,10,-13331,-13980,-4.64
1995,China,148780,2.88,11,132084,2.53,12,280864,2.7,11,-16696,-5391,209.7
1995,"Korea, Republic of",125058,2.42,12,135119,2.59,11,260177,2.5,12,10061,6335,58.82
1995,Singapore,118268,2.29,13,124507,2.39,13,242775,2.34,13,6239,5845,6.74
1995,Chinese Taipei,113047,2.19,14,103558,1.98,15,216605,2.09,14,-9489,-8594,10.41
1995,Spain,97849,1.89,15,113537,2.18,14,211386,2.04,15,15688,12167,28.94
1995,Switzerland,81641,1.58,17,80152,1.54,16,161793,1.56,16,-1489,-2363,-36.99
1995,Mexico,79542,1.54,19,74427,1.43,18,153969,1.48,17,-5115,21104,-124.24
1995,Malaysia,73915,1.43,20,77691,1.49,17,151606,1.46,18,3776,755,400.13
1995,Sweden,80440,1.56,18,65036,1.25,21,145476,1.4,19,-15404,-10364,48.63
1995,Russian Federation,82419,1.6,16,62603,1.2,22,145022,1.4,20,-19816,-16927,17.07
1995,Thailand,56439,1.09,22,70786,1.36,19,127225,1.22,21,14347,9198,55.98
1995,Austria,57738,1.12,21,66237,1.27,20,123975,1.19,22,8499,10231,-16.93
1995,Australia,53111,1.03,23,61283,1.17,23,114394,1.1,23,8172,5897,38.58
1995,Brazil,46506,0.9,26,54137,1.04,24,100643,0.97,24,7631,-7353,-203.78
1995,Denmark,50906,0.99,24,45939,0.88,25,96845,0.93,25,-4967,-5652,-12.12
1995,Indonesia,45417,0.88,27,40630,0.78,26,86047,0.83,26,-4787,-8072,-40.7
1995,"Saudi Arabia, Kingdom of",50040,0.97,25,28091,0.54,37,78131,0.75,27,-21949,-19276,13.87
1995,Ireland,44705,0.87,28,32340,0.62,31,77045,0.74,28,-12365,-8384,47.48
1995,Norway,41992,0.81,29,32968,0.63,29,74960,0.72,29,-9024,-7353,22.73
1995,Finland,40490,0.78,30,29470,0.56,34,69960,0.67,30,-11020,-6428,71.44
1995,India,30630,0.59,31,34707,0.66,28,65337,0.63,31,4077,1821,123.89
1995,South Africa,27853,0.54,33,30546,0.59,32,58399,0.56,32,2693,-1945,-238.46
1995,Türkiye,21599,0.42,36,35710,0.68,27,57309,0.55,33,14111,5164,173.26
1995,Portugal,22783,0.44,35,32610,0.62,30,55393,0.53,34,9827,9072,8.32
1995,United Arab Emirates,28364,0.55,32,23778,0.46,40,52142,0.5,35,-4586,-3628,26.41
1995,Poland,22895,0.44,34,29050,0.56,35,51945,0.5,36,6155,5440,13.14
1995,Israel,19046,0.37,39,29579,0.57,33,48625,0.47,37,10533,8353,26.1
1995,Czech Republic,21335,0.41,37,25085,0.48,39,46420,0.45,38,3750,1370,173.72
1995,Philippines,17502,0.34,42,28341,0.54,36,45843,0.44,39,10839,9337,16.09
1995,Argentina,20967,0.41,38,20122,0.39,41,41089,0.4,40,-845,5868,-114.4
1995,Greece,11054,0.21,49,25898,0.5,38,36952,0.36,41,14844,12103,22.65
1995,Iran,18360,0.36,41,13882,0.27,46,32242,0.31,42,-4478,-5660,-20.88
1995,Chile,16024,0.31,43,15898,0.3,42,31922,0.31,43,-126,216,-158.33
1995,"Venezuela, Bolivarian Republic of",18457,0.36,40,12649,0.24,48,31106,0.3,44,-5808,-6902,-15.85
1995,Ukraine,13128,0.25,45,15484,0.3,43,28612,0.28,45,2356,443,431.83
1995,Hungary,12865,0.25,46,15465,0.3,44,28330,0.27,46,2600,3855,-32.56
1995,New Zealand,13645,0.26,44,13957,0.27,45,27602,0.27,47,312,-271,-215.13
1995,Colombia,10126,0.2,51,13853,0.27,47,23979,0.23,48,3727,3404,9.49
1995,"Kuwait, the State of",12785,0.25,47,7790,0.15,59,20575,0.2,49,-4995,-4563,9.47
1995,Nigeria,12342,0.24,48,8222,0.16,56,20564,0.2,50,-4120,-2802,47.04
1995,Algeria,10258,0.2,50,10100,0.19,52,20358,0.2,51,-158,262,-160.31
1995,Pakistan,7992,0.15,55,11461,0.22,50,19453,0.19,52,3469,1524,127.62
1995,Romania,7910,0.15,56,10278,0.2,51,18188,0.18,53,2368,958,147.18
1995,Slovenia,8316,0.16,54,9492,0.18,54,17808,0.17,54,1176,476,147.06
1995,Slovak Republic,8580,0.17,52,8770,0.17,55,17350,0.17,55,190,-80,-337.5
1995,Morocco,6881,0.13,57,10023,0.19,53,16904,0.16,56,3142,2716,15.68
1995,Egypt,3435,0.07,76,11739,0.22,49,15174,0.15,57,8304,6722,23.53
1995,Libya,8510,0.16,53,5147,0.1,68,13657,0.13,58,-3363,-3542,-5.05
1995,Viet Nam,5449,0.11,61,8155,0.16,57,13604,0.13,59,2706,1772,52.71
1995,Tunisia,5475,0.11,60,7902,0.15,58,13377,0.13,60,2427,1923,26.21
1995,Peru,5491,0.11,59,7584,0.15,60,13075,0.13,61,2093,1202,74.13
1995,Croatia,4517,0.09,65,7352,0.14,61,11869,0.11,62,2835,969,192.57
1995,Bulgaria,5355,0.1,62,5660,0.11,64,11015,0.11,63,305,580,-47.41
1995,Oman,6068,0.12,58,4379,0.08,70,10447,0.1,64,-1689,-1531,10.32
1995,Belarus,4803,0.09,64,5564,0.11,65,10367,0.1,65,761,556,36.87
1995,Bangladesh,3501,0.07,74,6694,0.13,63,10195,0.1,66,3193,1668,91.43
1995,Kazakhstan,5250,0.1,63,3807,0.07,73,9057,0.09,67,-1443,330,-537.27
1995,Sri Lanka,3798,0.07,69,5185,0.1,66,8983,0.09,68,1387,1568,-11.54
1995,Dominican Republic,3780,0.07,70,5170,0.1,67,8950,0.09,69,1390,1450,-4.14
1995,Ecuador,4307,0.08,66,4193,0.08,71,8500,0.08,70,-114,-130,-12.31
1995,Syrian Arab Republic,3563,0.07,72,4709,0.09,69,8272,0.08,71,1146,2420,-52.64
1995,Lebanese Republic,656,0.01,124,7278,0.14,62,7934,0.08,72,6622,5463,21.22
1995,"Bahrain, Kingdom of",4113,0.08,67,3715,0.07,74,7828,0.08,73,-398,139,-386.33
1995,Costa Rica,3476,0.07,75,4090,0.08,72,7566,0.07,74,614,911,-32.6
1995,Qatar,3557,0.07,73,3398,0.07,78,6955,0.07,75,-159,-1286,-87.64
1995,Côte d'Ivoire,3806,0.07,68,2931,0.06,83,6737,0.06,76,-875,-825,6.06
1995,Lithuania,2705,0.05,79,3650,0.07,77,6355,0.06,77,945,320,195.31
1995,Uzbekistan,3430,0.07,77,2750,0.05,88,6180,0.06,78,-680,55,-1336.36
1995,Jordan,1769,0.03,95,3697,0.07,75,5466,0.05,79,1928,1957,-1.48
1995,Guatemala,1991,0.04,88,3293,0.06,80,5284,0.05,80,1302,1231,5.77
1995,Paraguay,2019,0.04,86,3144,0.06,81,5163,0.05,81,1125,579,94.3
1995,Angola,3642,0.07,71,1468,0.03,111,5110,0.05,82,-2174,-1564,39.0
1995,El Salvador,1652,0.03,98,3329,0.06,79,4981,0.05,83,1677,1298,29.2
1995,Uruguay,2106,0.04,85,2867,0.05,85,4973,0.05,84,761,873,-12.83
1995,Cyprus,1229,0.02,109,3690,0.07,76,4919,0.05,85,2461,2049,20.11
1995,Kenya,1879,0.04,92,2991,0.06,82,4870,0.05,86,1112,504,120.63
1995,Malta,1914,0.04,90,2890,0.06,84,4804,0.05,87,976,877,11.29
1995,Zimbabwe,2118,0.04,84,2660,0.05,91,4778,0.05,88,542,357,51.82
1995,Brunei Darussalam,2402,0.05,82,2091,0.04,94,4493,0.04,89,-311,-356,-12.64
1995,Cuba,1600,0.03,100,2825,0.05,86,4425,0.04,90,1225,670,82.84
1995,Estonia,1840,0.04,93,2546,0.05,92,4386,0.04,91,706,351,101.14
1995,Jamaica,1427,0.03,105,2818,0.05,87,4245,0.04,92,1391,1012,37.45
1995,Serbia and Montenegro,1531,0.03,103,2666,0.05,90,4197,0.04,93,1135,300,278.33
1995,Trinidad and Tobago,2454,0.05,81,1714,0.03,106,4168,0.04,94,-740,-734,0.82
1995,Papua New Guinea,2654,0.05,80,1452,0.03,112,4106,0.04,95,-1202,-1110,8.29
1995,Botswana,2142,0.04,83,1911,0.04,98,4053,0.04,96,-231,-238,-2.94
1995,"Macao, China",1997,0.04,87,2042,0.04,95,4039,0.04,97,45,135,-66.67
1995,Honduras,1769,0.03,95,1879,0.04,101,3648,0.04,98,110,257,-57.2
1995,Ghana,1724,0.03,97,1906,0.04,99,3630,0.03,99,182,683,-73.35
1995,Gabon,2713,0.05,78,882,0.02,132,3595,0.03,100,-1831,-1594,14.87
1995,Iceland,1802,0.03,94,1758,0.03,104,3560,0.03,101,-44,-151,-70.86
1995,Yemen,1945,0.04,89,1582,0.03,110,3527,0.03,102,-363,1153,-131.48
1995,Mauritius,1538,0.03,102,1976,0.04,96,3514,0.03,103,438,583,-24.87
1995,Netherlands Antilles,1522,0.03,104,1841,0.04,102,3363,0.03,104,319,382,-16.49
1995,Turkmenistan,1880,0.04,91,1365,0.03,116,3245,0.03,105,-515,-675,-23.7
1995,Panama,625,0.01,126,2511,0.05,93,3136,0.03,106,1886,1821,3.57
1995,Latvia,1305,0.03,108,1818,0.03,103,3123,0.03,107,513,260,97.31
1995,Namibia,1409,0.03,106,1616,0.03,108,3025,0.03,108,207,104,99.04
1995,"Aruba, Netherlands with respect to",1347,0.03,107,1597,0.03,109,2944,0.03,109,250,82,204.88
1995,North Macedonia,1204,0.02,110,1719,0.03,105,2923,0.03,110,515,398,29.4
1995,Reunion,209,0.0,155,2711,0.05,89,2920,0.03,111,2502,2187,14.4
1995,Cameroon,1651,0.03,99,1199,0.02,121,2850,0.03,112,-452,-403,12.16
1995,"Bolivia, Plurinational State of",1101,0.02,112,1424,0.03,113,2525,0.02,113,323,177,82.49
1995,Democratic Republic of the Congo,1563,0.03,101,871,0.02,133,2434,0.02,114,-692,-589,17.49
1995,Senegal,993,0.02,114,1412,0.03,114,2405,0.02,115,419,231,81.39
1995,Tanzania,682,0.01,123,1675,0.03,107,2357,0.02,116,993,985,0.81
1995,"Korea, Democratic People's Republic of",959,0.02,115,1380,0.03,115,2339,0.02,117,421,226,86.28
1995,Martinique,242,0.0,153,1970,0.04,97,2212,0.02,118,1728,1423,21.43
1995,Myanmar,851,0.02,118,1335,0.03,117,2186,0.02,119,484,88,450.0
1995,Guadeloupe,162,0.0,164,1901,0.04,100,2063,0.02,120,1739,1387,25.38
1995,Cambodia,855,0.02,117,1187,0.02,122,2042,0.02,121,332,254,30.71
1995,Eswatini,866,0.02,116,1008,0.02,127,1874,0.02,122,142,146,-2.74
1995,Congo,1172,0.02,111,670,0.01,145,1842,0.02,123,-502,-328,53.05
1995,Sudan,556,0.01,129,1219,0.02,120,1775,0.02,124,663,724,-8.43
1995,Zambia,1040,0.02,113,700,0.01,143,1740,0.02,125,-340,-333,2.1
1995,Nepal,345,0.01,146,1333,0.03,118,1678,0.02,126,988,793,24.59
1995,"Moldova, Republic of",745,0.01,121,840,0.02,134,1585,0.02,127,95,95,0.0
1995,Ethiopia,422,0.01,140,1145,0.02,123,1567,0.02,128,723,661,9.38
1995,Tajikistan,750,0.01,120,810,0.02,136,1560,0.02,129,60,55,9.09
1995,New Caledonia,565,0.01,128,957,0.02,130,1522,0.01,130,392,510,-23.14
1995,Guinea,702,0.01,122,819,0.02,135,1521,0.01,131,117,190,-38.42
1995,Uganda,460,0.01,136,1056,0.02,126,1516,0.01,132,596,466,27.9
1995,Fiji,619,0.01,127,892,0.02,131,1511,0.01,133,273,270,1.11
1995,Nicaragua,466,0.01,135,975,0.02,129,1441,0.01,134,509,532,-4.32
1995,Bahamas,176,0.0,158,1243,0.02,119,1419,0.01,135,1067,889,20.02
1995,Liberia,820,0.02,119,510,0.01,156,1330,0.01,136,-310,52,-696.15
1995,Azerbaijan,635,0.01,125,668,0.01,146,1303,0.01,137,33,123,-73.17
1995,Lesotho,160,0.0,166,1107,0.02,124,1267,0.01,138,947,736,28.67
1995,Bosnia and Herzegovina,152,0.0,168,1082,0.02,125,1234,0.01,139,930,803,15.82
1995,Mali,441,0.01,138,772,0.01,137,1213,0.01,140,331,254,30.31
1995,French Polynesia,193,0.0,157,1005,0.02,128,1198,0.01,141,812,649,25.12
1995,Benin,420,0.01,141,746,0.01,140,1166,0.01,142,326,33,887.88
1995,Iraq,496,0.01,131,665,0.01,147,1161,0.01,143,169,46,267.39
1995,Madagascar,507,0.01,130,628,0.01,149,1135,0.01,144,121,96,26.04
1995,Suriname,477,0.01,133,585,0.01,152,1062,0.01,145,108,152,-28.95
1995,Barbados,239,0.0,154,771,0.01,138,1010,0.01,146,532,433,22.86
1995,Guyana,455,0.01,137,527,0.01,154,982,0.01,147,72,50,44.0
1995,Togo,378,0.01,144,594,0.01,150,972,0.01,148,216,-106,-303.77
1995,Armenia,271,0.01,151,674,0.01,144,945,0.01,149,403,178,126.4
1995,Kyrgyz Republic,409,0.01,142,522,0.01,155,931,0.01,150,113,-24,-570.83
1995,Mauritania,488,0.01,132,431,0.01,161,919,0.01,151,-57,-48,18.75
1995,Albania,202,0.0,156,714,0.01,141,916,0.01,152,512,464,10.34
1995,French Guiana,158,0.0,167,752,0.01,139,910,0.01,153,594,527,12.71
1995,Lao People's Democratic Republic,311,0.01,147,589,0.01,151,900,0.01,154,278,263,5.7
1995,Mongolia,473,0.01,134,415,0.01,163,888,0.01,155,-58,-98,-40.82
1995,Malawi,405,0.01,143,475,0.01,157,880,0.01,156,70,155,-54.84
1995,Mozambique,168,0.0,161,704,0.01,142,872,0.01,157,536,862,-37.82
1995,Greenland,371,0.01,145,434,0.01,160,805,0.01,158,63,78,-19.23
1995,Haiti,110,0.0,171,653,0.01,148,763,0.01,159,543,169,221.3
1995,Burkina Faso,276,0.01,149,455,0.01,158,731,0.01,160,179,242,-26.03
1995,American Samoa,272,0.01,150,416,0.01,162,688,0.01,161,144,246,-41.46
1995,Northern Mariana Islands,432,0.01,139,240,0.0,174,672,0.01,162,-192,-190,1.05
1995,Niger,288,0.01,148,374,0.01,166,662,0.01,163,86,103,-16.5
1995,Chad,243,0.0,152,365,0.01,167,608,0.01,164,122,29,320.69
1995,Bermuda,56,0.0,178,550,0.01,153,606,0.01,165,494,519,-4.82
1995,Afghanistan,166,0.0,163,387,0.01,165,553,0.01,166,221,286,-22.73
1995,Georgia,151,0.0,169,392,0.01,164,543,0.01,167,241,185,30.27
1995,Eritrea,86,0.0,175,454,0.01,159,540,0.01,168,368,411,-10.46
1995,Belize,162,0.0,164,257,0.0,171,419,0.0,169,95,109,-12.84
1995,Somalia,172,0.0,159,245,0.0,173,417,0.0,170,73,145,-49.66
1995,Saint Lucia,109,0.0,172,307,0.01,169,416,0.0,171,198,197,0.51
1995,Antigua and Barbuda,53,0.0,180,346,0.01,168,399,0.0,172,293,298,-1.68
1995,Maldives,85,0.0,176,268,0.01,170,353,0.0,173,183,147,24.49
1995,Central African Republic,171,0.0,160,175,0.0,180,346,0.0,174,4,-12,-133.33
1995,Burundi,105,0.0,173,234,0.0,176,339,0.0,175,129,104,24.04
1995,Solomon Islands,168,0.0,161,154,0.0,181,322,0.0,176,-14,-3,366.67
1995,Rwanda,54,0.0,179,236,0.0,175,290,0.0,177,182,195,-6.67
1995,Seychelles,52,0.0,181,233,0.0,177,285,0.0,178,181,155,16.77
1995,Cabo Verde,8,0.0,198,252,0.0,172,260,0.0,179,244,204,19.61
1995,Equatorial Guinea,127,0.0,170,121,0.0,187,248,0.0,180,-6,-25,-76.0
1995,Bhutan,103,0.0,174,112,0.0,189,215,0.0,181,9,26,-65.38
1995,The Gambia,16,0.0,191,182,0.0,178,198,0.0,182,166,177,-6.21
1995,Djibouti,14,0.0,192,177,0.0,179,191,0.0,183,163,184,-11.41
1995,Saint Vincent and the Grenadines,43,0.0,183,136,0.0,182,179,0.0,184,93,80,16.25
1995,Sierra Leone,42,0.0,184,133,0.0,183,175,0.0,185,91,35,160.0
1995,Dominica,45,0.0,182,113,0.0,188,158,0.0,186,68,49,38.78
1995,Guinea-Bissau,24,0.0,186,133,0.0,183,157,0.0,187,109,131,-16.79
1995,Saint Kitts and Nevis,19,0.0,190,133,0.0,183,152,0.0,188,114,106,7.55
1995,Grenada,22,0.0,188,124,0.0,186,146,0.0,189,102,96,6.25
1995,Vanuatu,28,0.0,185,95,0.0,190,123,0.0,190,67,64,4.69
1995,"Micronesia, Federated States of",21,0.0,189,89,0.0,192,110,0.0,191,68,87,-21.84
1995,Samoa,9,0.0,197,95,0.0,190,104,0.0,192,86,77,11.69
1995,Marshall Islands,23,0.0,187,75,0.0,194,98,0.0,193,52,48,8.33
1995,Tonga,14,0.0,192,77,0.0,193,91,0.0,194,63,55,14.55
1995,Guam,85,0.0,176,0,0.0,204,85,0.0,195,-85,-85,0.0
1995,Saint Pierre and Miquelon,10,0.0,196,74,0.0,195,84,0.0,196,64,63,1.59
1995,Comoros,11,0.0,195,63,0.0,196,74,0.0,197,52,42,23.81
1995,Palau,14,0.0,192,52,0.0,197,66,0.0,198,38,31,22.58
1995,Cook Islands,5,0.0,200,48,0.0,198,53,0.0,199,43,45,-4.44
1995,Kiribati,7,0.0,199,35,0.0,199,42,0.0,200,28,21,33.33
1995,Sao Tomé and Principe,5,0.0,200,29,0.0,201,34,0.0,201,24,22,9.09
1995,Montserrat,3,0.0,202,30,0.0,200,33,0.0,202,27,27,0.0
1995,Tuvalu,0,0.0,203,6,0.0,202,6,0.0,203,6,8,-25.0
1995,Niue,0,0.0,203,4,0.0,203,4,0.0,204,4,4,0.0
1994,United States of America,512627,11.85,1,689215,15.72,1,1201842,13.8,1,176588,138665,27.35
1994,Germany,426935,9.87,2,381388,8.7,2,808323,9.28,2,-45547,-37485,21.51
1994,Japan,397005,9.18,3,275235,6.28,3,672240,7.72,3,-121770,-120620,0.95
1994,France,250571,5.79,4,246001,5.61,4,496572,5.7,4,-4570,-4268,7.08
1994,United Kingdom,205079,4.74,5,234076,5.34,5,439155,5.04,5,28997,27937,3.79
1994,Italy,191362,4.42,6,169166,3.86,6,360528,4.14,6,-22196,-21134,5.03
1994,Canada,165376,3.82,7,155072,3.54,8,320448,3.68,7,-10304,-6143,67.74
1994,"Hong Kong, China",151465,3.5,9,165878,3.78,7,317343,3.64,8,14413,5923,143.34
1994,Netherlands,160885,3.72,8,150337,3.43,9,311222,3.57,9,-10548,-13975,-24.52
1994,Belgium-Luxembourg,147107,3.4,10,133127,3.04,10,280234,3.22,10,-13980,-9559,46.25
1994,China,121006,2.8,11,115615,2.64,11,236621,2.72,11,-5391,12215,-144.13
1994,Singapore,96825,2.24,12,102670,2.34,12,199495,2.29,12,5845,11222,-47.91
1994,"Korea, Republic of",96013,2.22,13,102348,2.34,13,198361,2.28,13,6335,1564,305.05
1994,Chinese Taipei,94078,2.17,14,85484,1.95,15,179562,2.06,14,-8594,-8606,-0.14
1994,Spain,76696,1.77,15,88863,2.03,14,165559,1.9,15,12167,12922,-5.84
1994,Mexico,60882,1.41,19,81986,1.87,16,142868,1.64,16,21104,15661,34.76
1994,Switzerland,70360,1.63,16,67997,1.55,17,138357,1.59,17,-2363,-2357,0.25
1994,Sweden,65822,1.52,18,55458,1.27,19,121280,1.39,18,-10364,-7221,43.53
1994,Malaysia,58845,1.36,20,59600,1.36,18,118445,1.36,19,755,-1481,-150.98
1994,Russian Federation,67379,1.56,17,50452,1.15,23,117831,1.35,20,-16927,-8162,107.39
1994,Australia,47528,1.1,21,53425,1.22,22,100953,1.16,21,5897,2854,106.62
1994,Austria,45002,1.04,23,55233,1.26,20,100235,1.15,22,10231,8441,21.21
1994,Thailand,45261,1.05,22,54459,1.24,21,99720,1.14,23,9198,9108,0.99
1994,Brazil,43545,1.01,24,36192,0.83,25,79737,0.92,24,-7353,-10951,-32.86
1994,Denmark,42343,0.98,26,36691,0.84,24,79034,0.91,25,-5652,-6445,-12.3
1994,Indonesia,40055,0.93,27,31983,0.73,26,72038,0.83,26,-8072,-8495,-4.98
1994,"Saudi Arabia, Kingdom of",42614,0.98,25,23338,0.53,33,65952,0.76,27,-19276,-14197,35.78
1994,Norway,34785,0.8,28,27432,0.63,27,62217,0.71,28,-7353,-7897,-6.89
1994,Ireland,33996,0.79,29,25612,0.58,30,59608,0.68,29,-8384,-7831,7.06
1994,Finland,29703,0.69,30,23275,0.53,34,52978,0.61,30,-6428,-5461,17.71
1994,India,25022,0.58,33,26843,0.61,29,51865,0.6,31,1821,1216,49.75
1994,United Arab Emirates,26403,0.61,31,22775,0.52,36,49178,0.56,32,-3628,-4626,-21.57
1994,South Africa,25308,0.58,32,23363,0.53,32,48671,0.56,33,-1945,-4231,-54.03
1994,Portugal,17989,0.42,36,27061,0.62,28,45050,0.52,34,9072,8784,3.28
1994,Israel,16884,0.39,38,25237,0.58,31,42121,0.48,35,8353,7798,7.12
1994,Türkiye,18106,0.42,35,23270,0.53,35,41376,0.48,36,5164,14085,-63.34
1994,Poland,17240,0.4,37,22680,0.52,37,39920,0.46,37,5440,6040,-9.93
1994,Argentina,15659,0.36,41,21527,0.49,39,37186,0.43,38,5868,3666,60.07
1994,Philippines,13304,0.31,42,22641,0.52,38,35945,0.41,39,9337,7559,23.52
1994,Czech Republic,15940,0.37,40,17310,0.39,41,33250,0.38,40,1370,150,813.33
1994,Iran,19434,0.45,34,13774,0.31,43,33208,0.38,41,-5660,3347,-269.11
1994,Greece,9404,0.22,49,21507,0.49,40,30911,0.35,42,12103,13571,-10.82
1994,"Venezuela, Bolivarian Republic of",16089,0.37,39,9187,0.21,49,25276,0.29,43,-6902,-2176,217.19
1994,Hungary,10700,0.25,46,14555,0.33,42,25255,0.29,44,3855,3625,6.34
1994,New Zealand,12184,0.28,43,11913,0.27,44,24097,0.28,45,-271,-906,-70.09
1994,Chile,11604,0.27,44,11820,0.27,46,23424,0.27,46,216,1934,-88.83
1994,Ukraine,10305,0.24,47,10748,0.25,47,21053,0.24,47,443,1716,-74.18
1994,Colombia,8479,0.2,51,11883,0.27,45,20362,0.23,48,3404,2716,25.33
1994,Algeria,8892,0.21,50,9154,0.21,50,18046,0.21,49,262,-1625,-116.12
1994,"Kuwait, the State of",11260,0.26,45,6697,0.15,55,17957,0.21,50,-4563,-3212,42.06
1994,Pakistan,7365,0.17,53,8889,0.2,51,16254,0.19,51,1524,2812,-45.8
1994,Nigeria,9415,0.22,48,6613,0.15,56,16028,0.18,52,-2802,-2400,16.75
1994,Slovenia,6828,0.16,54,7304,0.17,53,14132,0.16,53,476,446,6.73
1994,Morocco,5556,0.13,57,8272,0.19,52,13828,0.16,54,2716,3036,-10.54
1994,Egypt,3463,0.08,66,10185,0.23,48,13648,0.16,55,6722,5109,31.57
1994,Slovak Republic,6690,0.15,55,6610,0.15,57,13300,0.15,56,-80,865,-109.25
1994,Romania,6151,0.14,56,7109,0.16,54,13260,0.15,57,958,1630,-41.23
1994,Libya,7865,0.18,52,4323,0.1,68,12188,0.14,58,-3542,-1991,77.9
1994,Tunisia,4657,0.11,59,6580,0.15,58,11237,0.13,59,1923,2412,-20.27
1994,Peru,4424,0.1,60,5626,0.13,61,10050,0.12,60,1202,846,42.08
1994,Viet Nam,4054,0.09,62,5826,0.13,60,9880,0.11,61,1772,547,223.95
1994,Oman,5545,0.13,58,4014,0.09,69,9559,0.11,62,-1531,-1003,52.64
1994,Croatia,4260,0.1,61,5229,0.12,63,9489,0.11,63,969,753,28.69
1994,Bulgaria,4005,0.09,63,4585,0.1,67,8590,0.1,64,580,1320,-56.06
1994,Syrian Arab Republic,3047,0.07,71,5467,0.12,62,8514,0.1,65,2420,993,143.71
1994,Dominican Republic,3453,0.08,67,4903,0.11,64,8356,0.1,66,1450,1443,0.49
1994,Sri Lanka,3208,0.07,70,4776,0.11,65,7984,0.09,67,1568,1132,38.52
1994,Bangladesh,2934,0.07,73,4602,0.1,66,7536,0.09,68,1668,1449,15.11
1994,Ecuador,3820,0.09,64,3690,0.08,72,7510,0.09,69,-130,-342,-61.99
1994,"Bahrain, Kingdom of",3622,0.08,65,3761,0.09,71,7383,0.08,70,139,134,3.73
1994,Kazakhstan,3231,0.07,68,3561,0.08,73,6792,0.08,71,330,610,-45.9
1994,Costa Rica,2878,0.07,74,3789,0.09,70,6667,0.08,72,911,889,2.47
1994,Lebanese Republic,470,0.01,126,5933,0.14,59,6403,0.07,73,5463,4369,25.04
1994,Belarus,2510,0.06,78,3066,0.07,75,5576,0.06,74,556,569,-2.28
1994,Uzbekistan,2550,0.06,77,2605,0.06,79,5155,0.06,75,55,107,-48.6
1994,Qatar,3213,0.07,69,1927,0.04,94,5140,0.06,76,-1286,-1354,-5.02
1994,Jordan,1424,0.03,95,3381,0.08,74,4805,0.06,77,1957,2293,-14.65
1994,Uruguay,1913,0.04,83,2786,0.06,77,4699,0.05,78,873,680,28.38
1994,Côte d'Ivoire,2742,0.06,75,1917,0.04,95,4659,0.05,79,-825,-404,104.21
1994,Angola,3018,0.07,72,1454,0.03,108,4472,0.05,80,-1564,-2299,-31.97
1994,Lithuania,2030,0.05,82,2350,0.05,85,4380,0.05,81,320,254,25.98
1994,Guatemala,1550,0.04,92,2781,0.06,78,4331,0.05,82,1231,1259,-2.22
1994,Paraguay,1843,0.04,88,2422,0.06,82,4265,0.05,83,579,964,-39.94
1994,Papua New Guinea,2632,0.06,76,1522,0.03,103,4154,0.05,84,-1110,-1286,-13.69
1994,Zimbabwe,1884,0.04,84,2241,0.05,86,4125,0.05,85,357,252,41.67
1994,Brunei Darussalam,2210,0.05,80,1854,0.04,96,4064,0.05,86,-356,-345,3.19
1994,Malta,1570,0.04,91,2447,0.06,81,4017,0.05,87,877,819,7.08
1994,Cyprus,968,0.02,110,3017,0.07,76,3985,0.05,88,2049,1666,22.99
1994,"Macao, China",1866,0.04,87,2001,0.05,92,3867,0.04,89,135,238,-43.28
1994,El Salvador,1249,0.03,104,2547,0.06,80,3796,0.04,90,1298,1113,16.62
1994,Kenya,1587,0.04,90,2091,0.05,89,3678,0.04,91,504,400,26.0
1994,Turkmenistan,2145,0.05,81,1470,0.03,107,3615,0.04,92,-675,-499,35.27
1994,Ghana,1425,0.03,94,2108,0.05,88,3533,0.04,93,683,1601,-57.34
1994,Botswana,1878,0.04,85,1640,0.04,100,3518,0.04,94,-238,-9,2544.44
1994,Cuba,1385,0.03,96,2055,0.05,91,3440,0.04,95,670,500,34.0
1994,Jamaica,1212,0.03,105,2224,0.05,87,3436,0.04,96,1012,1061,-4.62
1994,Mauritius,1347,0.03,100,1930,0.04,93,3277,0.04,97,583,416,40.14
1994,Netherlands Antilles,1376,0.03,98,1758,0.04,97,3134,0.04,98,382,664,-42.47
1994,Gabon,2350,0.05,79,756,0.02,132,3106,0.04,99,-1594,-1450,9.93
1994,Iceland,1623,0.04,89,1472,0.03,106,3095,0.04,100,-151,-58,160.34
1994,Yemen,934,0.02,112,2087,0.05,90,3021,0.03,101,1153,2210,-47.83
1994,Honduras,1378,0.03,97,1635,0.04,101,3013,0.03,102,257,231,11.26
1994,Trinidad and Tobago,1868,0.04,86,1134,0.03,116,3002,0.03,103,-734,-199,268.84
1994,Panama,583,0.01,118,2404,0.05,83,2987,0.03,104,1821,1635,11.38
1994,Estonia,1303,0.03,102,1654,0.04,98,2957,0.03,105,351,90,290.0
1994,"Aruba, Netherlands with respect to",1357,0.03,99,1439,0.03,109,2796,0.03,106,82,187,-56.15
1994,Namibia,1308,0.03,101,1412,0.03,110,2720,0.03,107,104,86,20.93
1994,North Macedonia,1086,0.03,106,1484,0.03,105,2570,0.03,108,398,144,176.39
1994,Cameroon,1486,0.03,93,1083,0.02,117,2569,0.03,109,-403,-781,-48.4
1994,Reunion,171,0.0,154,2358,0.05,84,2529,0.03,110,2187,1900,15.11
1994,"Korea, Democratic People's Republic of",1034,0.02,107,1260,0.03,111,2294,0.03,111,226,620,-63.55
1994,Latvia,991,0.02,109,1251,0.03,112,2242,0.03,112,260,-126,-306.35
1994,"Bolivia, Plurinational State of",1032,0.02,108,1209,0.03,114,2241,0.03,113,177,478,-62.97
1994,Tanzania,519,0.01,121,1504,0.03,104,2023,0.02,114,985,1047,-5.92
1994,Democratic Republic of the Congo,1256,0.03,103,667,0.02,137,1923,0.02,115,-589,-530,11.13
1994,Martinique,219,0.01,151,1642,0.04,99,1861,0.02,116,1423,1429,-0.42
1994,Senegal,791,0.02,115,1022,0.02,120,1813,0.02,117,231,380,-39.21
1994,Sudan,503,0.01,123,1227,0.03,113,1730,0.02,118,724,528,37.12
1994,Eswatini,781,0.02,116,927,0.02,122,1708,0.02,119,146,193,-24.35
1994,Guadeloupe,152,0.0,158,1539,0.04,102,1691,0.02,120,1387,1288,7.69
1994,Myanmar,798,0.02,114,886,0.02,124,1684,0.02,121,88,228,-61.4
1994,Congo,959,0.02,111,631,0.01,139,1590,0.02,122,-328,-487,-32.65
1994,Zambia,927,0.02,113,594,0.01,142,1521,0.02,123,-333,-17,1858.82
1994,Nepal,362,0.01,137,1155,0.03,115,1517,0.02,124,793,506,56.72
1994,Azerbaijan,655,0.02,117,778,0.02,131,1433,0.02,125,123,-357,-134.45
1994,Fiji,572,0.01,119,842,0.02,130,1414,0.02,126,270,270,0.0
1994,Ethiopia,372,0.01,135,1033,0.02,119,1405,0.02,127,661,588,12.41
1994,Uganda,409,0.01,132,875,0.02,127,1284,0.01,128,466,356,30.9
1994,New Caledonia,366,0.01,136,876,0.02,126,1242,0.01,129,510,499,2.2
1994,Cambodia,490,0.01,124,744,0.02,133,1234,0.01,130,254,187,35.83
1994,"Moldova, Republic of",565,0.01,120,660,0.02,138,1225,0.01,131,95,145,-34.48
1994,Bahamas,167,0.0,155,1056,0.02,118,1223,0.01,132,889,792,12.25
1994,Guinea,516,0.01,122,706,0.02,134,1222,0.01,133,190,169,12.43
1994,Nicaragua,335,0.01,142,867,0.02,129,1202,0.01,134,532,477,11.53
1994,Mozambique,157,0.0,156,1019,0.02,121,1176,0.01,135,862,823,4.74
1994,Serbia and Montenegro,400,0.01,133,700,0.02,135,1100,0.01,136,300,200,50.0
1994,French Polynesia,221,0.01,150,870,0.02,128,1091,0.01,137,649,695,-6.62
1994,Tajikistan,490,0.01,124,545,0.01,147,1035,0.01,138,55,113,-51.33
1994,Lesotho,143,0.0,164,879,0.02,125,1022,0.01,139,736,737,-0.14
1994,Madagascar,450,0.01,129,546,0.01,146,996,0.01,140,96,179,-46.37
1994,Bosnia and Herzegovina,91,0.0,172,894,0.02,123,985,0.01,141,803,270,197.41
1994,Guyana,456,0.01,127,506,0.01,148,962,0.01,142,50,70,-28.57
1994,Iraq,453,0.01,128,499,0.01,149,952,0.01,143,46,76,-39.47
1994,Mali,335,0.01,142,589,0.01,143,924,0.01,144,254,156,62.82
1994,Lao People's Democratic Republic,301,0.01,145,564,0.01,144,865,0.01,145,263,191,37.7
1994,Malawi,342,0.01,140,497,0.01,151,839,0.01,146,155,226,-31.42
1994,Benin,398,0.01,134,431,0.01,153,829,0.01,147,33,187,-82.35
1994,French Guiana,149,0.0,162,676,0.02,136,825,0.01,148,527,420,25.48
1994,Barbados,182,0.0,153,615,0.01,140,797,0.01,149,433,390,11.03
1994,Mauritania,410,0.01,131,362,0.01,159,772,0.01,150,-48,22,-318.18
1994,Liberia,353,0.01,139,405,0.01,155,758,0.01,151,52,-30,-273.33
1994,American Samoa,252,0.01,148,498,0.01,150,750,0.01,152,246,-14,-1857.14
1994,Albania,140,0.0,166,604,0.01,141,744,0.01,153,464,450,3.11
1994,Suriname,271,0.01,147,423,0.01,154,694,0.01,154,152,199,-23.62
1994,Northern Mariana Islands,430,0.01,130,240,0.01,170,670,0.01,155,-190,,
1994,Kyrgyz Republic,340,0.01,141,316,0.01,164,656,0.01,156,-24,90,-126.67
1994,Greenland,285,0.01,146,363,0.01,158,648,0.01,157,78,33,136.36
1994,Mongolia,356,0.01,138,258,0.01,168,614,0.01,158,-98,-4,2350.0
1994,Armenia,216,0.0,152,394,0.01,156,610,0.01,159,178,98,81.63
1994,Bermuda,32,0.0,186,551,0.01,145,583,0.01,160,519,499,4.01
1994,Eritrea,78,0.0,175,489,0.01,152,567,0.01,161,411,307,33.88
1994,Niger,225,0.01,149,328,0.01,163,553,0.01,162,103,88,17.05
1994,Togo,328,0.01,144,222,0.01,173,550,0.01,163,-106,43,-346.51
1994,Afghanistan,105,0.0,171,391,0.01,157,496,0.01,164,286,-223,-228.25
1994,Georgia,155,0.0,157,340,0.01,162,495,0.01,165,185,98,88.78
1994,Burkina Faso,107,0.0,169,349,0.01,160,456,0.01,166,242,440,-45.0
1994,Somalia,152,0.0,158,297,0.01,166,449,0.01,167,145,171,-15.2
1994,Belize,151,0.0,160,260,0.01,167,411,0.0,168,109,158,-31.01
1994,Saint Lucia,106,0.0,170,303,0.01,165,409,0.0,169,197,180,9.44
1994,Antigua and Barbuda,44,0.0,182,342,0.01,161,386,0.0,170,298,261,14.18
1994,Burundi,120,0.0,167,224,0.01,172,344,0.0,171,104,128,-18.75
1994,Haiti,82,0.0,174,251,0.01,169,333,0.0,172,169,275,-38.55
1994,Chad,148,0.0,163,177,0.0,179,325,0.0,173,29,69,-57.97
1994,Maldives,75,0.0,176,222,0.01,173,297,0.0,174,147,138,6.52
1994,Central African Republic,151,0.0,160,139,0.0,182,290,0.0,175,-12,15,-180.0
1994,Solomon Islands,142,0.0,165,139,0.0,182,281,0.0,176,-3,8,-137.5
1994,Rwanda,41,0.0,183,236,0.01,171,277,0.0,177,195,266,-26.69
1994,Sierra Leone,115,0.0,168,150,0.0,181,265,0.0,178,35,29,20.69
1994,Seychelles,51,0.0,179,206,0.0,177,257,0.0,179,155,187,-17.11
1994,The Gambia,35,0.0,184,212,0.0,175,247,0.0,180,177,194,-8.76
1994,Cabo Verde,5,0.0,198,209,0.0,176,214,0.0,181,204,150,36.0
1994,Djibouti,12,0.0,192,196,0.0,178,208,0.0,182,184,199,-7.54
1994,Guinea-Bissau,33,0.0,185,164,0.0,180,197,0.0,183,131,33,296.97
1994,Saint Vincent and the Grenadines,50,0.0,180,130,0.0,184,180,0.0,184,80,76,5.26
1994,Bhutan,66,0.0,177,92,0.0,189,158,0.0,185,26,25,4.0
1994,Saint Kitts and Nevis,22,0.0,189,128,0.0,185,150,0.0,186,106,91,16.48
1994,Dominica,47,0.0,181,96,0.0,188,143,0.0,187,49,45,8.89
1994,Grenada,23,0.0,188,119,0.0,186,142,0.0,188,96,98,-2.04
1994,Vanuatu,25,0.0,187,89,0.0,190,114,0.0,189,64,55,16.36
1994,"Micronesia, Federated States of",11,0.0,194,98,0.0,187,109,0.0,190,87,79,10.13
1994,Equatorial Guinea,62,0.0,178,37,0.0,198,99,0.0,191,-25,2,-1350.0
1994,Marshall Islands,22,0.0,189,70,0.0,193,92,0.0,192,48,53,-9.43
1994,Saint Pierre and Miquelon,12,0.0,192,75,0.0,192,87,0.0,193,63,56,12.5
1994,Guam,85,0.0,173,0,0.0,204,85,0.0,194,-85,-106,-19.81
1994,Samoa,4,0.0,200,81,0.0,191,85,0.0,194,77,99,-22.22
1994,Tonga,14,0.0,191,69,0.0,194,83,0.0,196,55,45,22.22
1994,Comoros,11,0.0,194,53,0.0,195,64,0.0,197,42,37,13.51
1994,Palau,11,0.0,194,42,0.0,197,53,0.0,198,31,,
1994,Cook Islands,4,0.0,200,49,0.0,196,53,0.0,198,45,53,-15.09
1994,Sao Tomé and Principe,8,0.0,197,30,0.0,199,38,0.0,200,22,27,-18.52
1994,Montserrat,3,0.0,202,30,0.0,199,33,0.0,201,27,23,17.39
1994,Kiribati,5,0.0,198,26,0.0,201,31,0.0,202,21,25,-16.0
1994,Tuvalu,0,0.0,203,8,0.0,202,8,0.0,203,8,7,14.29
1994,Niue,0,0.0,203,4,0.0,203,4,0.0,204,4,4,0.0
1993,United States of America,464773,12.25,1,603438,15.66,1,1068211,13.97,1,138665,105760,31.11
1993,Germany,380096,10.02,2,342611,8.89,2,722707,9.45,2,-37485,-21423,74.98
1993,Japan,362244,9.55,3,241624,6.27,3,603868,7.9,3,-120620,-106639,13.11
1993,France,221619,5.84,4,217351,5.64,4,438970,5.74,4,-4268,3767,-213.3
1993,United Kingdom,181381,4.78,5,209318,5.43,5,390699,5.11,5,27937,31548,-11.45
1993,Italy,169229,4.46,6,148095,3.84,6,317324,4.15,6,-21134,10296,-305.26
1993,Canada,145178,3.83,7,139035,3.61,8,284213,3.72,7,-6143,-5173,18.75
1993,"Hong Kong, China",135385,3.57,9,141308,3.67,7,276693,3.62,8,5923,7754,-23.61
1993,Netherlands,140245,3.7,8,126270,3.28,9,266515,3.49,9,-13975,-5685,145.82
1993,Belgium-Luxembourg,127580,3.36,10,118021,3.06,10,245601,3.21,10,-9559,1915,-599.16
1993,China,91744,2.42,11,103959,2.7,11,195703,2.56,11,12215,-4355,-380.48
1993,"Korea, Republic of",82236,2.17,13,83800,2.17,13,166036,2.17,12,1564,5143,-69.59
1993,Chinese Taipei,85718,2.26,12,77112,2.0,15,162830,2.13,13,-8606,-9827,-12.42
1993,Singapore,74012,1.95,14,85234,2.21,12,159246,2.08,14,11222,8699,29.0
1993,Spain,64603,1.7,15,77525,2.01,14,142128,1.86,15,12922,35424,-63.52
1993,Switzerland,63185,1.67,16,60828,1.58,17,124013,1.62,16,-2357,45,-5337.78
1993,Mexico,51886,1.37,17,67547,1.75,16,119433,1.56,17,15661,18017,-13.08
1993,Malaysia,47131,1.24,19,45650,1.18,20,92781,1.21,18,-1481,-915,61.86
1993,Sweden,49934,1.32,18,42713,1.11,22,92647,1.21,19,-7221,-6101,18.36
1993,Austria,40685,1.07,23,49126,1.27,18,89811,1.17,20,8441,9575,-11.84
1993,Australia,42723,1.13,21,45577,1.18,21,88300,1.15,21,2854,983,190.34
1993,Thailand,36969,0.97,26,46077,1.2,19,83046,1.09,22,9108,8214,10.88
1993,Russian Federation,44297,1.17,20,36135,0.94,23,80432,1.05,23,-8162,-1302,526.88
1993,"Saudi Arabia, Kingdom of",42395,1.12,22,28198,0.73,27,70593,0.92,24,-14197,-16582,-14.38
1993,Denmark,37754,1.0,25,31309,0.81,24,69063,0.9,25,-6445,-5863,9.93
1993,Brazil,38555,1.02,24,27604,0.72,28,66159,0.87,26,-10951,-12677,-13.62
1993,Indonesia,36823,0.97,27,28328,0.74,26,65151,0.85,27,-8495,-6687,27.04
1993,Norway,31978,0.84,28,24081,0.62,30,56059,0.73,28,-7897,-9073,-12.96
1993,Ireland,28992,0.76,29,21161,0.55,35,50153,0.66,29,-7831,-5854,33.77
1993,United Arab Emirates,25620,0.68,30,20994,0.54,36,46614,0.61,30,-4626,-7346,-37.03
1993,Türkiye,15343,0.4,36,29428,0.76,25,44771,0.59,31,14085,8155,72.72
1993,India,21572,0.57,33,22788,0.59,31,44360,0.58,32,1216,3951,-69.22
1993,South Africa,24222,0.64,31,19991,0.52,38,44213,0.58,33,-4231,-3702,14.29
1993,Finland,23495,0.62,32,18034,0.47,40,41529,0.54,34,-5461,-2773,96.93
1993,Portugal,15428,0.41,35,24212,0.63,29,39640,0.52,35,8784,11231,-21.79
1993,Iran,18080,0.48,34,21427,0.56,34,39507,0.52,36,3347,5992,-44.14
1993,Israel,14826,0.39,37,22624,0.59,32,37450,0.49,37,7798,7134,9.31
1993,Poland,14140,0.37,40,20180,0.52,37,34320,0.45,38,6040,4040,49.5
1993,Greece,8442,0.22,49,22013,0.57,33,30455,0.4,39,13571,13710,-1.01
1993,Argentina,13118,0.35,41,16784,0.44,41,29902,0.39,40,3666,2637,39.02
1993,Philippines,11129,0.29,42,18688,0.48,39,29817,0.39,41,7559,5746,31.55
1993,Czech Republic,14465,0.38,39,14615,0.38,42,29080,0.38,42,150,,
1993,"Venezuela, Bolivarian Republic of",14686,0.39,38,12510,0.32,44,27196,0.36,43,-2176,-120,1713.33
1993,Hungary,8905,0.23,48,12530,0.33,43,21435,0.28,44,3625,375,866.67
1993,Chile,9199,0.24,47,11133,0.29,45,20332,0.27,45,1934,176,998.86
1993,New Zealand,10542,0.28,43,9636,0.25,47,20178,0.26,46,-906,-584,55.14
1993,Algeria,10410,0.27,44,8785,0.23,50,19195,0.25,47,-1625,-3200,-49.22
1993,Nigeria,9908,0.26,46,7508,0.19,52,17416,0.23,48,-2400,-3611,-33.54
1993,Ukraine,7817,0.21,50,9533,0.25,48,17350,0.23,49,1716,-946,-281.4
1993,"Kuwait, the State of",10248,0.27,45,7036,0.18,53,17284,0.23,50,-3212,690,-565.51
1993,Colombia,7116,0.19,52,9832,0.26,46,16948,0.22,51,2716,-321,-946.11
1993,Pakistan,6688,0.18,53,9500,0.25,49,16188,0.21,52,2812,2062,36.37
1993,Libya,7542,0.2,51,5551,0.14,59,13093,0.17,53,-1991,-4777,-58.32
1993,Slovenia,6083,0.16,54,6529,0.17,55,12612,0.16,54,446,-539,-182.75
1993,Slovak Republic,5460,0.14,55,6325,0.16,57,11785,0.15,55,865,,
1993,Romania,4892,0.13,57,6522,0.17,56,11414,0.15,56,1630,1760,-7.39
1993,Egypt,3105,0.08,69,8214,0.21,51,11319,0.15,57,5109,5194,-1.64
1993,Morocco,3696,0.1,62,6732,0.17,54,10428,0.14,58,3036,3375,-10.04
1993,Tunisia,3802,0.1,59,6214,0.16,58,10016,0.13,59,2412,2412,0.0
1993,Oman,5299,0.14,56,4296,0.11,64,9595,0.13,60,-1003,-1526,-34.27
1993,Croatia,3913,0.1,58,4666,0.12,62,8579,0.11,61,753,-97,-876.29
1993,Bulgaria,3580,0.09,63,4900,0.13,60,8480,0.11,62,1320,670,97.01
1993,Dominican Republic,3211,0.08,67,4654,0.12,63,7865,0.1,63,1443,1028,40.37
1993,Peru,3385,0.09,64,4231,0.11,65,7616,0.1,64,846,386,119.17
1993,"Bahrain, Kingdom of",3723,0.1,61,3857,0.1,70,7580,0.1,65,134,799,-83.23
1993,Syrian Arab Republic,3146,0.08,68,4139,0.11,66,7285,0.1,66,993,397,150.13
1993,Kazakhstan,3277,0.09,65,3887,0.1,69,7164,0.09,67,610,722,-15.51
1993,Sri Lanka,2859,0.08,72,3991,0.1,68,6850,0.09,68,1132,990,14.34
1993,Bangladesh,2545,0.07,76,3994,0.1,67,6539,0.09,69,1449,1634,-11.32
1993,Viet Nam,2985,0.08,70,3532,0.09,72,6517,0.09,70,547,-40,-1467.5
1993,Costa Rica,2626,0.07,74,3515,0.09,73,6141,0.08,71,889,600,48.17
1993,Uzbekistan,2722,0.07,73,2829,0.07,74,5551,0.07,72,107,127,-15.75
1993,Ecuador,2904,0.08,71,2562,0.07,78,5466,0.07,73,-342,-506,-32.41
1993,Lebanese Republic,452,0.01,125,4821,0.13,61,5273,0.07,74,4369,3642,19.96
1993,Angola,3762,0.1,60,1463,0.04,102,5225,0.07,75,-2299,-1767,30.11
1993,Qatar,3245,0.09,66,1891,0.05,91,5136,0.07,76,-1354,-1826,-25.85
1993,Jordan,1246,0.03,94,3539,0.09,71,4785,0.06,77,2293,2040,12.4
1993,Côte d'Ivoire,2519,0.07,77,2115,0.05,87,4634,0.06,78,-404,-523,-22.75
1993,Belarus,1970,0.05,81,2539,0.07,79,4509,0.06,79,569,-64,-989.06
1993,Lithuania,2025,0.05,80,2279,0.06,82,4304,0.06,80,254,187,35.83
1993,Brunei Darussalam,2167,0.06,79,1822,0.05,92,3989,0.05,81,-345,-919,-62.46
1993,Uruguay,1645,0.04,86,2325,0.06,81,3970,0.05,82,680,342,98.83
1993,Guatemala,1340,0.04,91,2599,0.07,76,3939,0.05,83,1259,1237,1.78
1993,Papua New Guinea,2585,0.07,75,1299,0.03,109,3884,0.05,84,-1286,-442,190.95
1993,"Macao, China",1787,0.05,83,2025,0.05,89,3812,0.05,85,238,202,17.82
1993,Botswana,1780,0.05,84,1771,0.05,95,3551,0.05,86,-9,119,-107.56
1993,Ghana,974,0.03,108,2575,0.07,77,3549,0.05,87,1601,917,74.59
1993,Malta,1355,0.04,90,2174,0.06,84,3529,0.05,88,819,791,3.54
1993,Yemen,611,0.02,117,2821,0.07,75,3432,0.04,89,2210,1968,12.3
1993,Cyprus,867,0.02,109,2533,0.07,80,3400,0.04,90,1666,2326,-28.37
1993,Zimbabwe,1567,0.04,87,1819,0.05,93,3386,0.04,91,252,758,-66.75
1993,Netherlands Antilles,1283,0.03,93,1947,0.05,90,3230,0.04,92,664,309,114.89
1993,Jamaica,1071,0.03,99,2132,0.06,86,3203,0.04,93,1061,629,68.68
1993,El Salvador,1032,0.03,102,2145,0.06,85,3177,0.04,94,1113,1059,5.1
1993,Kenya,1374,0.04,89,1774,0.05,94,3148,0.04,95,400,502,-20.32
1993,Gabon,2295,0.06,78,845,0.02,123,3140,0.04,96,-1450,-1382,4.92
1993,Trinidad and Tobago,1662,0.04,85,1463,0.04,102,3125,0.04,97,-199,-587,-66.1
1993,Mauritius,1299,0.03,92,1715,0.04,96,3014,0.04,98,416,323,28.79
1993,Cameroon,1883,0.05,82,1102,0.03,112,2985,0.04,99,-781,-677,15.36
1993,Panama,553,0.01,120,2188,0.06,83,2741,0.04,100,1635,1522,7.42
1993,Iceland,1399,0.04,88,1341,0.03,107,2740,0.04,101,-58,156,-137.18
1993,"Korea, Democratic People's Republic of",1020,0.03,103,1640,0.04,98,2660,0.03,102,620,700,-11.43
1993,"Aruba, Netherlands with respect to",1209,0.03,96,1396,0.04,106,2605,0.03,103,187,198,-5.56
1993,Honduras,1173,0.03,97,1404,0.04,105,2577,0.03,104,231,89,159.55
1993,Namibia,1240,0.03,95,1326,0.03,108,2566,0.03,105,86,-58,-248.28
1993,Cuba,1000,0.03,104,1500,0.04,100,2500,0.03,106,500,-100,-600.0
1993,Paraguay,725,0.02,113,1689,0.04,97,2414,0.03,107,964,765,26.01
1993,North Macedonia,1055,0.03,101,1199,0.03,111,2254,0.03,108,144,7,1957.14
1993,Reunion,176,0.0,151,2076,0.05,88,2252,0.03,109,1900,2184,-13.0
1993,Tanzania,450,0.01,126,1497,0.04,101,1947,0.03,110,1047,1094,-4.3
1993,"Bolivia, Plurinational State of",728,0.02,112,1206,0.03,110,1934,0.03,111,478,380,25.79
1993,Latvia,998,0.03,106,872,0.02,120,1870,0.02,112,-126,17,-841.18
1993,Martinique,202,0.01,147,1631,0.04,99,1833,0.02,113,1429,1508,-5.24
1993,Senegal,707,0.02,114,1087,0.03,113,1794,0.02,114,380,361,5.26
1993,Democratic Republic of the Congo,1144,0.03,98,614,0.02,134,1758,0.02,115,-530,-311,70.42
1993,Estonia,805,0.02,111,895,0.02,117,1700,0.02,116,90,-32,-381.25
1993,Congo,1068,0.03,100,581,0.02,135,1649,0.02,117,-487,-732,-33.47
1993,Zambia,826,0.02,110,809,0.02,126,1635,0.02,118,-17,39,-143.59
1993,Azerbaijan,993,0.03,107,636,0.02,131,1629,0.02,119,-357,-573,-37.7
1993,Eswatini,680,0.02,116,873,0.02,119,1553,0.02,120,193,227,-14.98
1993,Guadeloupe,130,0.0,159,1418,0.04,104,1548,0.02,121,1288,1411,-8.72
1993,Turkmenistan,1000,0.03,104,501,0.01,147,1501,0.02,122,-499,-357,39.78
1993,Myanmar,586,0.02,118,814,0.02,125,1400,0.02,123,228,120,90.0
1993,Sudan,417,0.01,130,945,0.02,116,1362,0.02,124,528,502,5.18
1993,Guinea,561,0.01,119,730,0.02,129,1291,0.02,125,169,223,-24.22
1993,Nepal,384,0.01,132,890,0.02,118,1274,0.02,126,506,407,24.32
1993,New Caledonia,359,0.01,135,858,0.02,122,1217,0.02,127,499,508,-1.77
1993,Fiji,450,0.01,126,720,0.02,130,1170,0.02,128,270,187,44.39
1993,Afghanistan,688,0.02,115,465,0.01,152,1153,0.02,129,-223,217,-202.76
1993,Bahamas,162,0.0,152,954,0.02,115,1116,0.01,130,792,846,-6.38
1993,Mali,478,0.01,123,634,0.02,132,1112,0.01,131,156,266,-41.35
1993,"Moldova, Republic of",483,0.01,121,628,0.02,133,1111,0.01,132,145,170,-14.71
1993,Mozambique,132,0.0,157,955,0.02,114,1087,0.01,133,823,716,14.94
1993,Nicaragua,267,0.01,145,744,0.02,128,1011,0.01,134,477,632,-24.53
1993,Lesotho,133,0.0,156,870,0.02,121,1003,0.01,135,737,790,-6.71
1993,Iraq,457,0.01,124,533,0.01,142,990,0.01,136,76,85,-10.59
1993,French Polynesia,147,0.0,154,842,0.02,124,989,0.01,137,695,786,-11.58
1993,Ethiopia,199,0.01,148,787,0.02,127,986,0.01,138,588,670,-12.24
1993,Benin,384,0.01,132,571,0.01,138,955,0.01,139,187,243,-23.05
1993,American Samoa,481,0.01,122,467,0.01,151,948,0.01,140,-14,102,-113.73
1993,Guyana,414,0.01,131,484,0.01,149,898,0.01,141,70,150,-53.33
1993,Mauritania,423,0.01,129,445,0.01,154,868,0.01,142,22,-18,-222.22
1993,Malawi,320,0.01,140,546,0.01,139,866,0.01,143,226,339,-33.33
1993,Suriname,326,0.01,139,525,0.01,143,851,0.01,144,199,151,31.79
1993,Liberia,440,0.01,128,410,0.01,157,850,0.01,145,-30,-215,-86.05
1993,Madagascar,335,0.01,138,514,0.01,145,849,0.01,146,179,144,24.31
1993,Tajikistan,350,0.01,136,463,0.01,153,813,0.01,147,113,21,438.1
1993,Serbia and Montenegro,300,0.01,142,500,0.01,148,800,0.01,148,200,1320,-84.85
1993,Kyrgyz Republic,340,0.01,137,430,0.01,156,770,0.01,149,90,101,-10.89
1993,Barbados,187,0.0,149,577,0.01,136,764,0.01,150,390,333,17.12
1993,Mongolia,383,0.01,134,379,0.01,158,762,0.01,151,-4,29,-113.79
1993,Cambodia,284,0.01,144,471,0.01,150,755,0.01,152,187,178,5.06
1993,Uganda,179,0.0,150,535,0.01,140,714,0.01,153,356,363,-1.93
1993,Albania,122,0.0,162,572,0.01,137,694,0.01,154,450,471,-4.46
1993,Lao People's Democratic Republic,241,0.01,146,432,0.01,155,673,0.01,155,191,137,39.42
1993,Niger,287,0.01,143,375,0.01,159,662,0.01,156,88,146,-39.73
1993,Greenland,313,0.01,141,346,0.01,163,659,0.01,157,33,123,-73.17
1993,French Guiana,102,0.0,168,522,0.01,144,624,0.01,158,420,569,-26.19
1993,Burkina Faso,69,0.0,171,509,0.01,146,578,0.01,159,440,402,9.45
1993,Bermuda,35,0.0,184,534,0.01,141,569,0.01,160,499,477,4.61
1993,Bosnia and Herzegovina,95,0.0,169,365,0.01,160,460,0.01,161,270,84,221.43
1993,Haiti,80,0.0,170,355,0.01,161,435,0.01,162,275,205,34.15
1993,Saint Lucia,120,0.0,164,300,0.01,166,420,0.01,163,180,190,-5.26
1993,Somalia,121,0.0,163,292,0.01,167,413,0.01,164,171,97,76.29
1993,Armenia,156,0.0,153,254,0.01,170,410,0.01,165,98,123,-20.33
1993,Belize,123,0.0,161,281,0.01,168,404,0.01,166,158,133,18.8
1993,Rwanda,66,0.0,175,332,0.01,164,398,0.01,167,266,222,19.82
1993,Eritrea,42,0.0,183,349,0.01,162,391,0.01,168,307,335,-8.36
1993,Antigua and Barbuda,62,0.0,177,323,0.01,165,385,0.01,169,261,247,5.67
1993,Chad,131,0.0,158,200,0.01,173,331,0.0,170,69,61,13.11
1993,The Gambia,67,0.0,174,261,0.01,169,328,0.0,171,194,161,20.5
1993,Togo,136,0.0,155,179,0.0,176,315,0.0,172,43,119,-63.87
1993,Seychelles,51,0.0,181,238,0.01,171,289,0.0,173,187,144,29.86
1993,Solomon Islands,129,0.0,160,137,0.0,180,266,0.0,174,8,10,-20.0
1993,Sierra Leone,118,0.0,165,147,0.0,179,265,0.0,175,29,-3,-1066.67
1993,Burundi,68,0.0,173,196,0.01,174,264,0.0,176,128,149,-14.09
1993,Maldives,53,0.0,180,191,0.0,175,244,0.0,177,138,124,11.29
1993,Georgia,69,0.0,171,167,0.0,177,236,0.0,178,98,159,-38.36
1993,Central African Republic,110,0.0,166,125,0.0,182,235,0.0,179,15,38,-60.53
1993,Djibouti,12,0.0,192,211,0.01,172,223,0.0,180,199,203,-1.97
1993,Saint Vincent and the Grenadines,58,0.0,178,134,0.0,181,192,0.0,181,76,54,40.74
1993,Cabo Verde,4,0.0,197,154,0.0,178,158,0.0,182,150,175,-14.29
1993,Bhutan,65,0.0,176,90,0.0,188,155,0.0,183,25,59,-57.63
1993,Saint Kitts and Nevis,27,0.0,187,118,0.0,183,145,0.0,184,91,69,31.88
1993,Dominica,48,0.0,182,93,0.0,187,141,0.0,185,45,52,-13.46
1993,"Micronesia, Federated States of",30,0.0,185,109,0.0,185,139,0.0,186,79,75,5.33
1993,Grenada,20,0.0,190,118,0.0,183,138,0.0,187,98,87,12.64
1993,Equatorial Guinea,57,0.0,179,59,0.0,194,116,0.0,188,2,6,-66.67
1993,Samoa,6,0.0,194,105,0.0,186,111,0.0,189,99,104,-4.81
1993,Guam,106,0.0,167,0,0.0,202,106,0.0,190,-106,-77,37.66
1993,Vanuatu,23,0.0,188,78,0.0,189,101,0.0,191,55,58,-5.17
1993,Guinea-Bissau,28,0.0,186,61,0.0,190,89,0.0,192,33,90,-63.33
1993,Comoros,22,0.0,189,59,0.0,194,81,0.0,193,37,47,-21.28
1993,Tonga,16,0.0,191,61,0.0,190,77,0.0,194,45,51,-11.76
1993,Marshall Islands,8,0.0,193,61,0.0,190,69,0.0,195,53,53,0.0
1993,Saint Pierre and Miquelon,5,0.0,195,61,0.0,190,66,0.0,196,56,51,9.8
1993,Cook Islands,4,0.0,197,57,0.0,196,61,0.0,197,53,51,3.92
1993,Sao Tomé and Principe,5,0.0,195,32,0.0,197,37,0.0,198,27,24,12.5
1993,Kiribati,3,0.0,199,28,0.0,198,31,0.0,199,25,32,-21.88
1993,Montserrat,3,0.0,199,26,0.0,199,29,0.0,200,23,32,-28.13
1993,Tuvalu,0,0.0,201,7,0.0,200,7,0.0,201,7,5,40.0
1993,Niue,0,0.0,201,4,0.0,201,4,0.0,202,4,4,0.0
1992,United States of America,448163,11.86,1,553923,14.21,1,1002086,13.05,1,105760,86633,22.08
1992,Germany,430042,11.38,2,408619,10.48,2,838661,10.92,2,-21423,-12935,65.62
1992,Japan,339885,8.99,3,233246,5.98,4,573131,7.46,3,-106639,-77787,37.09
1992,France,235871,6.24,4,239638,6.15,3,475509,6.19,4,3767,14684,-74.35
1992,United Kingdom,190003,5.03,5,221551,5.68,5,411554,5.36,5,31548,24983,26.28
1992,Italy,178155,4.71,6,188451,4.83,6,366606,4.77,6,10296,13214,-22.08
1992,Netherlands,140335,3.71,7,134650,3.45,7,274985,3.58,7,-5685,-7758,-26.72
1992,Canada,134435,3.56,8,129262,3.32,8,263697,3.43,8,-5173,-2381,117.26
1992,Belgium-Luxembourg,123132,3.26,9,125047,3.21,10,248179,3.23,9,1915,1983,-3.43
1992,"Hong Kong, China",119586,3.16,10,127340,3.27,9,246926,3.22,10,7754,5224,48.43
1992,China,84940,2.25,11,80585,2.07,13,165525,2.16,11,-4355,-8119,-46.36
1992,Spain,64334,1.7,15,99758,2.56,11,164092,2.14,12,35424,33129,6.93
1992,"Korea, Republic of",76632,2.03,13,81775,2.1,12,158407,2.06,13,5143,9655,-46.73
1992,Chinese Taipei,82036,2.17,12,72209,1.85,14,154245,2.01,14,-9827,-13436,-26.86
1992,Singapore,63472,1.68,16,72171,1.85,15,135643,1.77,15,8699,7327,18.73
1992,Switzerland,65678,1.74,14,65723,1.69,16,131401,1.71,16,45,4968,-99.09
1992,Mexico,46196,1.22,19,64213,1.65,17,110409,1.44,17,18017,9037,99.37
1992,Sweden,56118,1.49,17,50017,1.28,19,106135,1.38,18,-6101,-5227,16.72
1992,Austria,44537,1.18,20,54112,1.39,18,98649,1.28,19,9575,9704,-1.33
1992,Australia,42824,1.13,21,43807,1.12,20,86631,1.13,20,983,-206,-577.18
1992,"Saudi Arabia, Kingdom of",50280,1.33,18,33698,0.86,25,83978,1.09,21,-16582,-18718,-11.41
1992,Russian Federation,42039,1.11,22,40737,1.04,21,82776,1.08,22,-1302,,
1992,Malaysia,40771,1.08,24,39856,1.02,23,80627,1.05,23,-915,2299,-139.8
1992,Denmark,41577,1.1,23,35714,0.92,24,77291,1.01,24,-5863,-3634,61.34
1992,Thailand,32472,0.86,28,40686,1.04,22,73158,0.95,25,8214,9141,-10.14
1992,Indonesia,33967,0.9,27,27280,0.7,27,61247,0.8,26,-6687,-3273,104.31
1992,Norway,35145,0.93,26,26072,0.67,28,61217,0.8,27,-9073,-8535,6.3
1992,Brazil,35793,0.95,25,23116,0.59,32,58909,0.77,28,-12677,-8673,46.17
1992,Ireland,28331,0.75,29,22477,0.58,34,50808,0.66,29,-5854,-3453,69.53
1992,Portugal,18350,0.49,35,29581,0.76,26,47931,0.62,30,11231,9833,14.22
1992,Iran,19868,0.53,33,25860,0.66,29,45728,0.6,31,5992,9266,-35.33
1992,Finland,23981,0.63,31,21208,0.54,35,45189,0.59,32,-2773,-1271,118.17
1992,India,19628,0.52,34,23579,0.6,30,43207,0.56,33,3951,2721,45.2
1992,South Africa,23440,0.62,32,19738,0.51,37,43178,0.56,34,-3702,-4450,-16.81
1992,United Arab Emirates,24756,0.66,30,17410,0.45,39,42166,0.55,35,-7346,-10690,-31.28
1992,Türkiye,14716,0.39,36,22871,0.59,33,37587,0.49,36,8155,7452,9.43
1992,Israel,13119,0.35,39,20253,0.52,36,33372,0.43,37,7134,6737,5.89
1992,Poland,14500,0.38,37,18540,0.48,38,33040,0.43,38,4040,4590,-11.98
1992,Greece,9510,0.25,49,23220,0.6,31,32730,0.43,39,13710,12914,6.16
1992,"Venezuela, Bolivarian Republic of",14185,0.38,38,14065,0.36,43,28250,0.37,40,-120,-4008,-97.01
1992,Argentina,12235,0.32,41,14872,0.38,41,27107,0.35,41,2637,-3703,-171.21
1992,Czech and Slovak Federal Republic,12550,0.33,40,14080,0.36,42,26630,0.35,42,1530,-780,-296.15
1992,Philippines,9751,0.26,48,15497,0.4,40,25248,0.33,43,5746,4061,41.49
1992,Hungary,10705,0.28,44,11080,0.28,44,21785,0.28,44,375,1185,-68.35
1992,Chile,10007,0.26,45,10183,0.26,45,20190,0.26,45,176,-771,-122.83
1992,Nigeria,11886,0.31,42,8275,0.21,49,20161,0.26,46,-3611,-3278,10.16
1992,Algeria,11510,0.3,43,8310,0.21,48,19820,0.26,47,-3200,-4670,-31.48
1992,New Zealand,9785,0.26,47,9201,0.24,47,18986,0.25,48,-584,-1238,-52.83
1992,Pakistan,7317,0.19,51,9379,0.24,46,16696,0.22,49,2062,1911,7.9
1992,Ukraine,8045,0.21,50,7099,0.18,53,15144,0.2,50,-946,,
1992,Libya,9942,0.26,46,5165,0.13,58,15107,0.2,51,-4777,-5873,-18.66
1992,"Kuwait, the State of",6571,0.17,54,7261,0.19,52,13832,0.18,52,690,3673,-81.21
1992,Colombia,6900,0.18,52,6579,0.17,54,13479,0.18,53,-321,-2155,-85.1
1992,Slovenia,6681,0.18,53,6142,0.16,57,12823,0.17,54,-539,,
1992,Morocco,3973,0.11,59,7348,0.19,51,11321,0.15,55,3375,2589,30.36
1992,Egypt,3051,0.08,68,8245,0.21,50,11296,0.15,56,5194,4203,23.58
1992,Romania,4500,0.12,57,6260,0.16,56,10760,0.14,57,1760,1393,26.35
1992,Tunisia,4019,0.11,58,6431,0.16,55,10450,0.14,58,2412,1490,61.88
1992,Oman,5428,0.14,55,3902,0.1,65,9330,0.12,59,-1526,-1544,-1.17
1992,Croatia,4597,0.12,56,4500,0.12,59,9097,0.12,60,-97,,
1992,Bulgaria,3550,0.09,64,4220,0.11,61,7770,0.1,61,670,30,2133.33
1992,"Bahrain, Kingdom of",3464,0.09,65,4263,0.11,60,7727,0.1,62,799,604,32.28
1992,Peru,3578,0.09,62,3964,0.1,64,7542,0.1,63,386,-580,-166.55
1992,Kazakhstan,3245,0.09,66,3967,0.1,63,7212,0.09,64,722,,
1992,Belarus,3559,0.09,63,3495,0.09,69,7054,0.09,65,-64,,
1992,Dominican Republic,2831,0.07,71,3859,0.1,66,6690,0.09,66,1028,605,69.92
1992,Syrian Arab Republic,3093,0.08,67,3490,0.09,70,6583,0.09,67,397,-662,-159.97
1992,Serbia and Montenegro,2539,0.07,74,3859,0.1,66,6398,0.08,68,1320,,
1992,Sri Lanka,2455,0.06,75,3445,0.09,71,5900,0.08,69,990,1067,-7.22
1992,Qatar,3841,0.1,60,2015,0.05,88,5856,0.08,70,-1826,-1490,22.55
1992,Bangladesh,2098,0.06,77,3732,0.1,68,5830,0.08,71,1634,1723,-5.17
1992,Angola,3755,0.1,61,1988,0.05,89,5743,0.07,72,-1767,-2063,-14.35
1992,Uzbekistan,2735,0.07,72,2862,0.07,74,5597,0.07,73,127,,
1992,Ecuador,3007,0.08,69,2501,0.06,78,5508,0.07,74,-506,-455,11.21
1992,Côte d'Ivoire,2875,0.08,70,2352,0.06,81,5227,0.07,75,-523,-583,-10.29
1992,Viet Nam,2581,0.07,73,2541,0.07,76,5122,0.07,76,-40,251,-115.94
1992,Lebanese Republic,560,0.01,117,4202,0.11,62,4762,0.06,77,3642,3204,13.67
1992,Jordan,1215,0.03,99,3255,0.08,73,4470,0.06,78,2040,1378,48.04
1992,Cyprus,987,0.03,106,3313,0.08,72,4300,0.06,79,2326,1668,39.45
1992,Costa Rica,1841,0.05,81,2441,0.06,79,4282,0.06,80,600,279,115.05
1992,Lithuania,2029,0.05,79,2216,0.06,83,4245,0.06,81,187,,
1992,Brunei Darussalam,2401,0.06,76,1482,0.04,104,3883,0.05,82,-919,-1474,-37.65
1992,Malta,1540,0.04,90,2331,0.06,82,3871,0.05,83,791,896,-11.72
1992,Guatemala,1295,0.03,96,2532,0.06,77,3827,0.05,84,1237,649,90.6
1992,Uruguay,1703,0.05,85,2045,0.05,86,3748,0.05,85,342,32,968.75
1992,"Macao, China",1766,0.05,83,1968,0.05,90,3734,0.05,86,202,187,8.02
1992,Zimbabwe,1445,0.04,92,2203,0.06,84,3648,0.05,87,758,523,44.93
1992,Botswana,1742,0.05,84,1861,0.05,92,3603,0.05,88,119,98,21.43
1992,Netherlands Antilles,1559,0.04,89,1868,0.05,91,3427,0.04,89,309,540,-42.78
1992,Ghana,1252,0.03,97,2169,0.06,85,3421,0.04,90,917,438,109.36
1992,Papua New Guinea,1927,0.05,80,1485,0.04,103,3412,0.04,91,-442,154,-387.01
1992,Iceland,1528,0.04,91,1684,0.04,97,3212,0.04,92,156,211,-26.07
1992,Yemen,619,0.02,115,2587,0.07,75,3206,0.04,93,1968,1366,44.07
1992,Kenya,1339,0.04,94,1841,0.05,94,3180,0.04,94,502,827,-39.3
1992,Cuba,1600,0.04,87,1500,0.04,102,3100,0.04,95,-100,-200,-50.0
1992,Cameroon,1840,0.05,82,1163,0.03,109,3003,0.04,96,-677,-661,2.42
1992,Mauritius,1302,0.03,95,1625,0.04,99,2927,0.04,97,323,363,-11.02
1992,Trinidad and Tobago,1691,0.04,86,1104,0.03,111,2795,0.04,98,-587,-318,84.59
1992,Gabon,2082,0.06,78,700,0.02,130,2782,0.04,99,-1382,-1409,-1.92
1992,Jamaica,1047,0.03,103,1676,0.04,98,2723,0.04,100,629,618,1.78
1992,"Korea, Democratic People's Republic of",1010,0.03,105,1710,0.04,96,2720,0.04,101,700,800,-12.5
1992,El Salvador,796,0.02,108,1855,0.05,93,2651,0.03,102,1059,928,14.12
1992,Namibia,1341,0.04,93,1283,0.03,107,2624,0.03,103,-58,-64,-9.38
1992,Reunion,210,0.01,146,2394,0.06,80,2604,0.03,104,2184,1983,10.14
1992,Azerbaijan,1571,0.04,88,998,0.03,115,2569,0.03,105,-573,,
1992,Panama,502,0.01,121,2024,0.05,87,2526,0.03,106,1522,1337,13.84
1992,"Aruba, Netherlands with respect to",1108,0.03,102,1306,0.03,106,2414,0.03,107,198,524,-62.21
1992,North Macedonia,1199,0.03,100,1206,0.03,108,2405,0.03,108,7,,
1992,Democratic Republic of the Congo,1246,0.03,98,935,0.02,116,2181,0.03,109,-311,-345,-9.86
1992,Honduras,1031,0.03,104,1120,0.03,110,2151,0.03,110,89,36,147.22
1992,Paraguay,657,0.02,113,1422,0.04,105,2079,0.03,111,765,723,5.81
1992,Martinique,255,0.01,144,1763,0.05,95,2018,0.03,112,1508,1484,1.62
1992,Tanzania,416,0.01,126,1510,0.04,101,1926,0.03,113,1094,1191,-8.14
1992,"Bolivia, Plurinational State of",710,0.02,111,1090,0.03,112,1800,0.02,114,380,121,214.05
1992,Senegal,673,0.02,112,1034,0.03,114,1707,0.02,115,361,472,-23.52
1992,Guadeloupe,137,0.0,156,1548,0.04,100,1685,0.02,116,1411,1502,-6.06
1992,Congo,1183,0.03,101,451,0.01,148,1634,0.02,117,-732,-435,68.28
1992,Latvia,778,0.02,109,795,0.02,125,1573,0.02,118,17,,
1992,Zambia,756,0.02,110,795,0.02,125,1551,0.02,119,39,-265,-114.72
1992,Eswatini,639,0.02,114,866,0.02,120,1505,0.02,120,227,127,78.74
1992,Turkmenistan,900,0.02,107,543,0.01,139,1443,0.02,121,-357,,
1992,New Caledonia,409,0.01,127,917,0.02,117,1326,0.02,122,508,419,21.24
1992,Guinea,517,0.01,120,740,0.02,128,1257,0.02,123,223,48,364.58
1992,Bahamas,192,0.01,147,1038,0.03,113,1230,0.02,124,846,866,-2.31
1992,Myanmar,531,0.01,118,651,0.02,132,1182,0.02,125,120,227,-47.14
1992,Nepal,369,0.01,131,776,0.02,127,1145,0.01,126,407,480,-15.21
1992,Sudan,319,0.01,137,821,0.02,124,1140,0.01,127,502,585,-14.19
1992,Malawi,396,0.01,128,735,0.02,129,1131,0.01,128,339,234,44.87
1992,Iraq,518,0.01,119,603,0.02,136,1121,0.01,129,85,46,84.78
1992,"Moldova, Republic of",470,0.01,122,640,0.02,133,1110,0.01,130,170,,
1992,Nicaragua,223,0.01,145,855,0.02,121,1078,0.01,131,632,479,31.94
1992,Fiji,443,0.01,124,630,0.02,134,1073,0.01,132,187,202,-7.43
1992,Lesotho,109,0.0,161,899,0.02,118,1008,0.01,133,790,746,5.9
1992,Ethiopia,169,0.0,151,839,0.02,123,1008,0.01,133,670,283,136.75
1992,French Polynesia,106,0.0,163,892,0.02,119,998,0.01,135,786,785,0.13
1992,Mozambique,139,0.0,155,855,0.02,121,994,0.01,136,716,737,-2.85
1992,Liberia,590,0.02,116,375,0.01,158,965,0.01,137,-215,109,-297.25
1992,Mali,342,0.01,132,608,0.02,135,950,0.01,138,266,359,-25.91
1992,Suriname,391,0.01,129,542,0.01,140,933,0.01,139,151,150,0.67
1992,Benin,335,0.01,133,578,0.01,137,913,0.01,140,243,-89,-373.03
1992,Estonia,444,0.01,123,412,0.01,154,856,0.01,141,-32,,
1992,Mauritania,425,0.01,125,407,0.01,155,832,0.01,142,-18,-14,28.57
1992,Niger,333,0.01,134,479,0.01,144,812,0.01,143,146,48,204.17
1992,Mongolia,389,0.01,130,418,0.01,151,807,0.01,144,29,13,123.08
1992,Madagascar,327,0.01,136,471,0.01,145,798,0.01,145,144,111,29.73
1992,Greenland,333,0.01,134,456,0.01,147,789,0.01,146,123,67,83.58
1992,French Guiana,102,0.0,164,671,0.02,131,773,0.01,147,569,700,-18.71
1992,Kyrgyz Republic,317,0.01,138,418,0.01,151,735,0.01,148,101,,
1992,Guyana,292,0.01,140,442,0.01,150,734,0.01,149,150,59,154.24
1992,American Samoa,316,0.01,139,418,0.01,151,734,0.01,149,102,45,126.67
1992,Barbados,191,0.01,148,524,0.01,142,715,0.01,151,333,492,-32.32
1992,Cambodia,265,0.01,143,443,0.01,149,708,0.01,152,178,32,456.25
1992,Togo,275,0.01,142,394,0.01,157,669,0.01,153,119,190,-37.37
1992,Uganda,142,0.0,153,505,0.01,143,647,0.01,154,363,-4,-9175.0
1992,Bermuda,85,0.0,166,562,0.01,138,647,0.01,154,477,455,4.84
1992,Bosnia and Herzegovina,276,0.01,141,360,0.01,159,636,0.01,156,84,,
1992,Albania,70,0.0,172,541,0.01,141,611,0.01,157,471,310,51.94
1992,Afghanistan,181,0.0,150,398,0.01,156,579,0.01,158,217,254,-14.57
1992,Burkina Faso,64,0.0,178,466,0.01,146,530,0.01,159,402,427,-5.85
1992,Saint Lucia,123,0.0,159,313,0.01,161,436,0.01,160,190,185,2.7
1992,Chad,182,0.0,149,243,0.01,167,425,0.01,161,61,55,10.91
1992,Belize,141,0.0,154,274,0.01,165,415,0.01,162,133,136,-2.21
1992,Lao People's Democratic Republic,133,0.0,157,270,0.01,166,403,0.01,163,137,73,87.67
1992,Antigua and Barbuda,65,0.0,176,312,0.01,162,377,0.0,164,247,245,0.82
1992,Eritrea,16,0.0,189,351,0.01,160,367,0.0,165,335,,
1992,Somalia,130,0.0,158,227,0.01,168,357,0.0,166,97,63,53.97
1992,Rwanda,66,0.0,174,288,0.01,163,354,0.0,167,222,213,4.23
1992,Haiti,73,0.0,170,278,0.01,164,351,0.0,168,205,234,-12.39
1992,Sierra Leone,149,0.0,152,146,0.0,177,295,0.0,169,-3,18,-116.67
1992,Georgia,68,0.0,173,227,0.01,168,295,0.0,169,159,,
1992,Burundi,72,0.0,171,221,0.01,170,293,0.0,171,149,165,-9.7
1992,Armenia,83,0.0,167,206,0.01,173,289,0.0,172,123,,
1992,The Gambia,57,0.0,179,218,0.01,172,275,0.0,173,161,166,-3.01
1992,Maldives,65,0.0,176,189,0.0,175,254,0.0,174,124,85,45.88
1992,Central African Republic,107,0.0,162,145,0.0,178,252,0.0,175,38,-34,-211.76
1992,Tajikistan,111,0.0,160,132,0.0,179,243,0.0,176,21,,
1992,Seychelles,48,0.0,182,192,0.0,174,240,0.0,177,144,123,17.07
1992,Djibouti,16,0.0,189,219,0.01,171,235,0.0,178,203,197,3.05
1992,Solomon Islands,102,0.0,164,112,0.0,182,214,0.0,179,10,28,-64.29
1992,Saint Vincent and the Grenadines,78,0.0,168,132,0.0,179,210,0.0,180,54,73,-26.03
1992,Bhutan,66,0.0,174,125,0.0,181,191,0.0,181,59,20,195.0
1992,Cabo Verde,5,0.0,195,180,0.0,176,185,0.0,182,175,141,24.11
1992,Dominica,53,0.0,180,105,0.0,185,158,0.0,183,52,56,-7.14
1992,Grenada,20,0.0,188,107,0.0,184,127,0.0,184,87,98,-11.22
1992,"Micronesia, Federated States of",24,0.0,185,99,0.0,186,123,0.0,185,75,79,-5.06
1992,Saint Kitts and Nevis,26,0.0,183,95,0.0,188,121,0.0,186,69,83,-16.87
1992,Samoa,6,0.0,193,110,0.0,183,116,0.0,187,104,88,18.18
1992,Equatorial Guinea,50,0.0,181,56,0.0,194,106,0.0,188,6,30,-80.0
1992,Vanuatu,24,0.0,185,82,0.0,189,106,0.0,188,58,65,-10.77
1992,Guinea-Bissau,6,0.0,193,96,0.0,187,102,0.0,190,90,56,60.71
1992,Saint Pierre and Miquelon,25,0.0,184,76,0.0,190,101,0.0,191,51,51,0.0
1992,Comoros,22,0.0,187,69,0.0,191,91,0.0,192,47,34,38.24
1992,Guam,77,0.0,169,0,0.0,201,77,0.0,193,-77,-73,5.48
1992,Tonga,12,0.0,191,63,0.0,192,75,0.0,194,51,46,10.87
1992,Marshall Islands,9,0.0,192,62,0.0,193,71,0.0,195,53,45,17.78
1992,Cook Islands,3,0.0,198,54,0.0,195,57,0.0,196,51,35,45.71
1992,Kiribati,5,0.0,195,37,0.0,196,42,0.0,197,32,20,60.0
1992,Montserrat,2,0.0,199,34,0.0,197,36,0.0,198,32,37,-13.51
1992,Sao Tomé and Principe,5,0.0,195,29,0.0,198,34,0.0,199,24,25,-4.0
1992,Tuvalu,0,0.0,200,5,0.0,199,5,0.0,200,5,4,25.0
1992,Niue,0,0.0,200,4,0.0,200,4,0.0,201,4,3,33.33
1991,United States of America,421730,12.01,1,508363,14.02,1,930093,13.03,1,86633,123395,-29.79
1991,Germany,402843,11.47,2,389908,10.75,2,792751,11.11,2,-12935,-65414,-80.23
1991,Japan,314786,8.97,3,236999,6.53,3,551785,7.73,3,-77787,-52213,48.98
1991,France,217100,6.18,4,231784,6.39,4,448884,6.29,4,14684,17848,-17.73
1991,United Kingdom,184964,5.27,5,209947,5.79,5,394911,5.53,5,24983,37805,-33.92
1991,Italy,169465,4.83,6,182679,5.04,6,352144,4.93,6,13214,11664,13.29
1991,Netherlands,133631,3.81,7,125873,3.47,7,259504,3.64,7,-7758,-5677,36.66
1991,Canada,127163,3.62,8,124782,3.44,8,251945,3.53,8,-2381,-4385,-45.7
1991,Belgium-Luxembourg,118199,3.37,9,120182,3.31,9,238381,3.34,9,1983,1999,-0.8
1991,"Hong Kong, China",98659,2.81,10,103883,2.86,10,202542,2.84,10,5224,2335,123.73
1991,Spain,60177,1.71,15,93306,2.57,11,153483,2.15,11,33129,32073,3.29
1991,"Korea, Republic of",71870,2.05,13,81525,2.25,12,153395,2.15,12,9655,4828,99.98
1991,Chinese Taipei,76489,2.18,11,63053,1.74,16,139542,1.95,13,-13436,-12463,7.81
1991,China,71910,2.05,12,63791,1.76,15,135701,1.9,14,-8119,-8746,-7.17
1991,Switzerland,61517,1.75,14,66485,1.83,13,128002,1.79,15,4968,5897,-15.75
1991,Singapore,58966,1.68,16,66293,1.83,14,125259,1.75,16,7327,8169,-10.31
1991,Sweden,55217,1.57,17,49990,1.38,19,105207,1.47,17,-5227,-3276,59.55
1991,Mexico,42688,1.22,20,51725,1.43,17,94413,1.32,18,9037,2837,218.54
1991,Austria,41111,1.17,22,50815,1.4,18,91926,1.29,19,9704,7881,23.13
1991,U.S.S.R.,46274,1.32,19,43458,1.2,20,89732,1.26,20,-2816,17040,-116.53
1991,Australia,41854,1.19,21,41648,1.15,21,83502,1.17,21,-206,2233,-109.23
1991,"Saudi Arabia, Kingdom of",47797,1.36,18,29079,0.8,25,76876,1.08,22,-18718,-20348,-8.01
1991,Denmark,37824,1.08,23,34190,0.94,24,72014,1.01,23,-3634,-3537,2.74
1991,Malaysia,34350,0.98,24,36649,1.01,23,70999,0.99,24,2299,-194,-1285.05
1991,Thailand,28428,0.81,28,37569,1.04,22,65997,0.92,25,9141,9977,-8.38
1991,Norway,34107,0.97,25,25572,0.71,29,59679,0.84,26,-8535,-6816,25.22
1991,Indonesia,29142,0.83,27,25869,0.71,28,55011,0.77,27,-3273,-3838,-14.72
1991,Brazil,31620,0.9,26,22947,0.63,30,54567,0.76,28,-8673,-8892,-2.46
1991,Iran,18661,0.53,33,27927,0.77,26,46588,0.65,29,9266,1017,811.11
1991,Ireland,24224,0.69,30,20771,0.57,34,44995,0.63,30,-3453,-3074,12.33
1991,Finland,23080,0.66,32,21809,0.6,31,44889,0.63,31,-1271,430,-395.58
1991,Portugal,16280,0.46,35,26113,0.72,27,42393,0.59,32,9833,8846,11.16
1991,South Africa,23279,0.66,31,18829,0.52,36,42108,0.59,33,-4450,-5150,-13.59
1991,United Arab Emirates,24436,0.7,29,13746,0.38,40,38182,0.53,34,-10690,-12345,-13.41
1991,India,17727,0.5,34,20448,0.56,35,38175,0.53,35,2721,5611,-51.51
1991,Türkiye,13595,0.39,39,21047,0.58,33,34642,0.49,36,7452,9344,-20.25
1991,Poland,13800,0.39,38,18390,0.51,38,32190,0.45,37,4590,-2750,-266.91
1991,Israel,11921,0.34,43,18658,0.51,37,30579,0.43,38,6737,4714,42.91
1991,Greece,8666,0.25,50,21580,0.59,32,30246,0.42,39,12914,11672,10.64
1991,"Yugoslavia, Socialist Federal Republic of",13947,0.4,37,14738,0.41,39,28685,0.4,40,791,4563,-82.66
1991,"Venezuela, Bolivarian Republic of",15155,0.43,36,11147,0.31,43,26302,0.37,41,-4008,-10162,-60.56
1991,Czech and Slovak Federal Republic,11460,0.33,44,10680,0.29,44,22140,0.31,42,-780,580,-234.48
1991,Philippines,8801,0.25,49,12862,0.35,41,21663,0.3,43,4061,4887,-16.9
1991,Hungary,10185,0.29,46,11370,0.31,42,21555,0.3,44,1185,340,248.53
1991,Nigeria,12264,0.35,41,8986,0.25,45,21250,0.3,45,-3278,-7969,-58.87
1991,Argentina,11978,0.34,42,8275,0.23,48,20253,0.28,46,-3703,-8277,-55.26
1991,Algeria,12440,0.35,40,7770,0.21,51,20210,0.28,47,-4670,-3110,50.16
1991,New Zealand,9619,0.27,47,8381,0.23,47,18000,0.25,48,-1238,107,-1257.01
1991,Chile,8942,0.25,48,8171,0.23,49,17113,0.24,49,-771,-433,78.06
1991,Libya,11212,0.32,45,5339,0.15,54,16551,0.23,50,-5873,-8215,-28.51
1991,Pakistan,6528,0.19,52,8439,0.23,46,14967,0.21,51,1911,1787,6.94
1991,Colombia,7114,0.2,51,4959,0.14,56,12073,0.17,52,-2155,-1132,90.37
1991,Egypt,3659,0.1,58,7862,0.22,50,11521,0.16,53,4203,6631,-36.62
1991,Morocco,4284,0.12,55,6873,0.19,52,11157,0.16,54,2589,2657,-2.56
1991,Romania,4400,0.13,54,5793,0.16,53,10193,0.14,55,1393,2640,-47.23
1991,Tunisia,3699,0.11,57,5189,0.14,55,8888,0.12,56,1490,1987,-25.01
1991,Oman,4871,0.14,53,3327,0.09,62,8198,0.11,57,-1544,-2710,-43.03
1991,"Bahrain, Kingdom of",3511,0.1,59,4115,0.11,58,7626,0.11,58,604,-49,-1332.65
1991,Bulgaria,3760,0.11,56,3790,0.1,59,7550,0.11,59,30,70,-57.14
1991,Peru,3393,0.1,62,2813,0.08,65,6206,0.09,60,-580,-646,-10.22
1991,Syrian Arab Republic,3429,0.1,60,2767,0.08,66,6196,0.09,61,-662,-1812,-63.47
1991,"Kuwait, the State of",1088,0.03,92,4761,0.13,57,5849,0.08,62,3673,-3070,-219.64
1991,Dominican Republic,2449,0.07,68,3054,0.08,63,5503,0.08,63,605,836,-27.63
1991,Cuba,2800,0.08,65,2600,0.07,69,5400,0.08,64,-200,-500,-60.0
1991,Ecuador,2852,0.08,64,2397,0.07,71,5249,0.07,65,-455,-852,-46.6
1991,Bangladesh,1689,0.05,76,3412,0.09,61,5101,0.07,66,1723,1947,-11.5
1991,Sri Lanka,1987,0.06,71,3054,0.08,63,5041,0.07,67,1067,773,38.03
1991,Qatar,3210,0.09,63,1720,0.05,86,4930,0.07,68,-1490,-1946,-23.43
1991,Côte d'Ivoire,2686,0.08,66,2103,0.06,76,4789,0.07,69,-583,-975,-40.21
1991,Angola,3410,0.1,61,1347,0.04,98,4757,0.07,70,-2063,-2332,-11.54
1991,"Korea, Democratic People's Republic of",1960,0.06,73,2760,0.08,67,4720,0.07,71,800,1073,-25.44
1991,Viet Nam,2087,0.06,70,2338,0.06,72,4425,0.06,72,251,348,-27.87
1991,Lebanese Republic,539,0.02,106,3743,0.1,60,4282,0.06,73,3204,2031,57.75
1991,Brunei Darussalam,2682,0.08,67,1208,0.03,100,3890,0.05,74,-1474,-1212,21.62
1991,Botswana,1849,0.05,74,1947,0.05,79,3796,0.05,75,98,162,-39.51
1991,Netherlands Antilles,1599,0.05,80,2139,0.06,73,3738,0.05,76,540,351,53.85
1991,Trinidad and Tobago,1985,0.06,72,1667,0.05,89,3652,0.05,77,-318,-851,-62.63
1991,Jordan,1130,0.03,89,2508,0.07,70,3638,0.05,78,1378,1536,-10.29
1991,Zimbabwe,1532,0.04,83,2055,0.06,77,3587,0.05,79,523,121,332.23
1991,Cyprus,952,0.03,95,2620,0.07,68,3572,0.05,80,1668,1617,3.15
1991,"Macao, China",1665,0.05,77,1852,0.05,82,3517,0.05,81,187,-162,-215.43
1991,Costa Rica,1598,0.05,81,1877,0.05,81,3475,0.05,82,279,542,-48.52
1991,Malta,1234,0.04,85,2130,0.06,75,3364,0.05,83,896,831,7.82
1991,Iceland,1549,0.04,82,1760,0.05,84,3309,0.05,84,211,88,139.77
1991,Uruguay,1605,0.05,79,1637,0.05,91,3242,0.05,85,32,-350,-109.14
1991,Gabon,2243,0.06,69,834,0.02,112,3077,0.04,86,-1409,-1286,9.56
1991,Papua New Guinea,1460,0.04,84,1614,0.04,92,3074,0.04,87,154,16,862.5
1991,Guatemala,1202,0.03,87,1851,0.05,83,3053,0.04,88,649,486,33.54
1991,Kenya,1108,0.03,91,1935,0.05,80,3043,0.04,89,827,1191,-30.56
1991,Cameroon,1834,0.05,75,1173,0.03,101,3007,0.04,90,-661,-602,9.8
1991,Democratic Republic of the Congo,1649,0.05,78,1304,0.04,99,2953,0.04,91,-345,-587,-41.23
1991,Jamaica,1118,0.03,90,1736,0.05,85,2854,0.04,92,618,770,-19.74
1991,Mauritius,1195,0.03,88,1558,0.04,93,2753,0.04,93,363,424,-14.39
1991,Yemen,659,0.02,102,2025,0.06,78,2684,0.04,94,1366,879,55.4
1991,Namibia,1213,0.03,86,1149,0.03,103,2362,0.03,95,-64,78,-182.05
1991,Reunion,150,0.0,139,2133,0.06,74,2283,0.03,96,1983,1974,0.46
1991,"Aruba, Netherlands with respect to",879,0.03,97,1403,0.04,97,2282,0.03,97,524,426,23.0
1991,Paraguay,737,0.02,99,1460,0.04,96,2197,0.03,98,723,393,83.97
1991,El Salvador,588,0.02,105,1516,0.04,95,2104,0.03,99,928,681,36.27
1991,Panama,358,0.01,114,1695,0.05,88,2053,0.03,100,1337,1199,11.51
1991,Honduras,949,0.03,96,985,0.03,106,1934,0.03,101,36,4,800.0
1991,Martinique,216,0.01,130,1700,0.05,87,1916,0.03,102,1484,1464,1.37
1991,Zambia,1083,0.03,93,818,0.02,113,1901,0.03,103,-265,-89,197.75
1991,Tanzania,342,0.01,116,1533,0.04,94,1875,0.03,104,1191,696,71.12
1991,Senegal,701,0.02,100,1173,0.03,101,1874,0.03,105,472,458,3.06
1991,"Bolivia, Plurinational State of",849,0.02,98,970,0.03,107,1819,0.03,106,121,-239,-150.63
1991,Guadeloupe,147,0.0,140,1649,0.05,90,1796,0.03,107,1502,1559,-3.66
1991,Ghana,617,0.02,103,1055,0.03,105,1672,0.02,108,438,308,42.21
1991,Congo,1029,0.03,94,594,0.02,125,1623,0.02,109,-435,-360,20.83
1991,Guinea,687,0.02,101,735,0.02,118,1422,0.02,110,48,52,-7.69
1991,Bahamas,225,0.01,129,1091,0.03,104,1316,0.02,111,866,874,-0.92
1991,Eswatini,591,0.02,104,718,0.02,119,1309,0.02,112,127,107,18.69
1991,New Caledonia,444,0.01,109,863,0.02,111,1307,0.02,113,419,434,-3.46
1991,Sudan,305,0.01,124,890,0.02,110,1195,0.02,114,585,245,138.78
1991,Malawi,469,0.01,107,703,0.02,120,1172,0.02,115,234,158,48.1
1991,Fiji,450,0.01,108,652,0.02,123,1102,0.02,116,202,257,-21.4
1991,Myanmar,419,0.01,111,646,0.02,124,1065,0.01,117,227,-55,-512.73
1991,Mozambique,162,0.0,138,899,0.02,109,1061,0.01,118,737,752,-1.99
1991,French Polynesia,128,0.0,142,913,0.03,108,1041,0.01,119,785,819,-4.15
1991,Nicaragua,272,0.01,125,751,0.02,116,1023,0.01,120,479,308,55.52
1991,Nepal,257,0.01,126,737,0.02,117,994,0.01,121,480,468,2.56
1991,Mali,312,0.01,121,671,0.02,122,983,0.01,122,359,243,47.74
1991,Barbados,207,0.01,132,699,0.02,121,906,0.01,123,492,488,0.82
1991,Lesotho,67,0.0,156,813,0.02,114,880,0.01,124,746,610,22.3
1991,Suriname,359,0.01,113,509,0.01,128,868,0.01,125,150,0,
1991,Mauritania,439,0.01,110,425,0.01,133,864,0.01,126,-14,-81,-82.72
1991,French Guiana,70,0.0,155,770,0.02,115,840,0.01,127,700,696,0.57
1991,Iraq,377,0.01,112,423,0.01,134,800,0.01,128,46,-3788,-101.21
1991,Madagascar,335,0.01,118,446,0.01,130,781,0.01,129,111,332,-66.57
1991,Greenland,341,0.01,117,408,0.01,137,749,0.01,130,67,-7,-1057.14
1991,Liberia,311,0.01,122,420,0.01,135,731,0.01,131,109,-298,-136.58
1991,Mongolia,348,0.01,115,361,0.01,140,709,0.01,132,13,263,-95.06
1991,American Samoa,327,0.01,120,372,0.01,139,699,0.01,133,45,49,-8.16
1991,Togo,253,0.01,127,443,0.01,131,696,0.01,134,190,313,-39.3
1991,Niger,307,0.01,123,355,0.01,141,662,0.01,135,48,106,-54.72
1991,Ethiopia,189,0.01,135,472,0.01,129,661,0.01,136,283,783,-63.86
1991,Burkina Faso,106,0.0,146,533,0.01,126,639,0.01,137,427,384,11.2
1991,Afghanistan,189,0.01,135,443,0.01,131,632,0.01,138,254,701,-63.77
1991,Benin,330,0.01,119,241,0.01,150,571,0.01,139,-89,-23,286.96
1991,Haiti,166,0.0,137,400,0.01,138,566,0.01,140,234,172,36.05
1991,Bermuda,55,0.0,159,510,0.01,127,565,0.01,141,455,535,-14.95
1991,Guyana,248,0.01,128,307,0.01,142,555,0.01,142,59,54,9.26
1991,Albania,100,0.0,147,410,0.01,136,510,0.01,143,310,150,106.67
1991,Cambodia,213,0.01,131,245,0.01,149,458,0.01,144,32,78,-58.97
1991,Chad,194,0.01,134,249,0.01,148,443,0.01,145,55,97,-43.3
1991,Saint Lucia,110,0.0,145,295,0.01,144,405,0.01,146,185,144,28.47
1991,Rwanda,93,0.0,150,306,0.01,143,399,0.01,147,213,178,19.66
1991,Uganda,200,0.01,133,196,0.01,153,396,0.01,148,-4,136,-102.94
1991,Belize,120,0.0,144,256,0.01,146,376,0.01,149,136,82,65.85
1991,Antigua and Barbuda,50,0.0,161,295,0.01,144,345,0.0,150,245,234,4.7
1991,Burundi,90,0.0,151,255,0.01,147,345,0.0,150,165,156,5.77
1991,Sierra Leone,145,0.0,141,163,0.0,156,308,0.0,152,18,11,63.64
1991,Lao People's Democratic Republic,97,0.0,149,170,0.0,155,267,0.0,153,73,106,-31.13
1991,Somalia,98,0.0,148,161,0.0,157,259,0.0,154,63,244,-74.18
1991,The Gambia,38,0.0,163,204,0.01,152,242,0.0,155,166,157,5.73
1991,Maldives,76,0.0,153,161,0.0,157,237,0.0,156,85,60,41.67
1991,Djibouti,17,0.0,171,214,0.01,151,231,0.0,157,197,190,3.68
1991,Seychelles,49,0.0,162,172,0.0,154,221,0.0,158,123,130,-5.38
1991,Central African Republic,126,0.0,143,92,0.0,166,218,0.0,159,-34,34,-200.0
1991,Saint Vincent and the Grenadines,67,0.0,156,140,0.0,160,207,0.0,160,73,53,37.74
1991,Solomon Islands,84,0.0,152,112,0.0,162,196,0.0,161,28,21,33.33
1991,Dominica,54,0.0,160,110,0.0,163,164,0.0,162,56,63,-11.11
1991,Cabo Verde,6,0.0,175,147,0.0,159,153,0.0,163,141,130,8.46
1991,Bhutan,63,0.0,158,83,0.0,168,146,0.0,164,20,11,81.82
1991,Grenada,23,0.0,168,121,0.0,161,144,0.0,165,98,78,25.64
1991,Saint Kitts and Nevis,27,0.0,166,110,0.0,163,137,0.0,166,83,82,1.22
1991,Saint Pierre and Miquelon,30,0.0,165,81,0.0,170,111,0.0,167,51,60,-15.0
1991,Equatorial Guinea,37,0.0,164,67,0.0,172,104,0.0,168,30,-1,-3100.0
1991,Vanuatu,18,0.0,170,83,0.0,168,101,0.0,169,65,77,-15.58
1991,Samoa,6,0.0,175,94,0.0,165,100,0.0,170,88,72,22.22
1991,"Micronesia, Federated States of",10,0.0,174,89,0.0,167,99,0.0,171,79,80,-1.25
1991,Guinea-Bissau,20,0.0,169,76,0.0,171,96,0.0,172,56,67,-16.42
1991,Comoros,24,0.0,167,58,0.0,174,82,0.0,173,34,34,0.0
1991,Guam,73,0.0,154,0,0.0,182,73,0.0,174,-73,-82,-10.98
1991,Tonga,13,0.0,172,59,0.0,173,72,0.0,175,46,51,-9.8
1991,Marshall Islands,11,0.0,173,56,0.0,175,67,0.0,176,45,53,-15.09
1991,Cook Islands,5,0.0,179,40,0.0,176,45,0.0,177,35,47,-25.53
1991,Montserrat,2,0.0,180,39,0.0,177,41,0.0,178,37,42,-11.9
1991,Sao Tomé and Principe,6,0.0,175,31,0.0,178,37,0.0,179,25,17,47.06
1991,Kiribati,6,0.0,175,26,0.0,179,32,0.0,180,20,24,-16.67
1991,Tuvalu,0,0.0,181,4,0.0,180,4,0.0,181,4,5,-20.0
1991,Niue,0,0.0,181,3,0.0,181,3,0.0,182,3,4,-25.0
1990,United States of America,393592,11.28,2,516987,14.36,1,910579,12.85,1,123395,129110,-4.43
1990,Germany,421100,12.07,1,355686,9.88,2,776786,10.96,2,-65414,-71529,-8.55
1990,Japan,287581,8.24,3,235368,6.54,3,522949,7.38,3,-52213,-64217,-18.69
1990,France,216588,6.21,4,234436,6.51,4,451024,6.36,4,17848,13589,31.34
1990,United Kingdom,185172,5.31,5,222977,6.2,5,408149,5.76,5,37805,45386,-16.7
1990,Italy,170304,4.88,6,181968,5.06,6,352272,4.97,6,11664,12455,-6.35
1990,Netherlands,131775,3.78,7,126098,3.5,7,257873,3.64,7,-5677,-3931,44.42
1990,Canada,127629,3.66,8,123244,3.42,8,250873,3.54,8,-4385,-2040,114.95
1990,Belgium-Luxembourg,117703,3.37,9,119702,3.33,10,237405,3.35,9,1999,-1539,-229.89
1990,U.S.S.R.,103840,2.98,10,120880,3.36,9,224720,3.17,10,17040,5390,216.14
1990,"Hong Kong, China",82390,2.36,11,84725,2.35,12,167115,2.36,11,2335,4326,-46.02
1990,Spain,55642,1.59,17,87715,2.44,11,143357,2.02,12,32073,26977,18.89
1990,"Korea, Republic of",65016,1.86,13,69844,1.94,13,134860,1.9,13,4828,-912,-629.39
1990,Switzerland,63784,1.83,14,69681,1.94,14,133465,1.88,14,5897,6669,-11.58
1990,Chinese Taipei,67245,1.93,12,54782,1.52,16,122027,1.72,15,-12463,-13842,-9.96
1990,China,62091,1.78,15,53345,1.48,18,115436,1.63,16,-8746,6604,-232.43
1990,Singapore,52730,1.51,18,60899,1.69,15,113629,1.6,17,8169,4991,63.67
1990,Sweden,57540,1.65,16,54264,1.51,17,111804,1.58,18,-3276,-2572,27.37
1990,Austria,41265,1.18,20,49146,1.37,19,90411,1.28,19,7881,7074,11.41
1990,Mexico,40711,1.17,21,43548,1.21,20,84259,1.19,20,2837,1229,130.84
1990,Australia,39752,1.14,22,41985,1.17,21,81737,1.15,21,2233,7808,-71.4
1990,Denmark,36870,1.06,23,33333,0.93,22,70203,0.99,22,-3537,-1555,127.46
1990,"Saudi Arabia, Kingdom of",44417,1.27,19,24069,0.67,28,68486,0.97,23,-20348,-7228,181.52
1990,Norway,34047,0.98,24,27231,0.76,25,61278,0.86,24,-6816,-3432,98.6
1990,Malaysia,29452,0.84,26,29258,0.81,24,58710,0.83,25,-194,-2567,-92.44
1990,Thailand,23068,0.66,32,33045,0.92,23,56113,0.79,26,9977,5692,75.28
1990,Brazil,31414,0.9,25,22522,0.63,30,53936,0.76,27,-8892,-14498,-38.67
1990,Finland,26571,0.76,27,27001,0.75,26,53572,0.76,28,430,1138,-62.21
1990,Indonesia,25675,0.74,28,21837,0.61,32,47512,0.67,29,-3838,-5716,-32.86
1990,Ireland,23743,0.68,29,20669,0.57,33,44412,0.63,30,-3074,-3247,-5.33
1990,South Africa,23549,0.67,30,18399,0.51,37,41948,0.59,31,-5150,-3693,39.45
1990,Portugal,16417,0.47,36,25263,0.7,27,41680,0.59,32,8846,6273,41.02
1990,India,17969,0.51,34,23580,0.66,29,41549,0.59,33,5611,4677,19.97
1990,Iran,19305,0.55,33,20322,0.56,34,39627,0.56,34,1017,1713,-40.63
1990,Türkiye,12959,0.37,41,22303,0.62,31,35262,0.5,35,9344,4167,124.24
1990,United Arab Emirates,23544,0.67,31,11199,0.31,42,34743,0.49,36,-12345,-7586,62.73
1990,"Yugoslavia, Socialist Federal Republic of",14308,0.41,38,18871,0.52,36,33179,0.47,37,4563,1369,233.31
1990,Israel,12080,0.35,44,16794,0.47,38,28874,0.41,38,4714,3275,43.94
1990,Greece,8105,0.23,51,19777,0.55,35,27882,0.39,39,11672,8606,35.63
1990,Poland,14320,0.41,37,11570,0.32,41,25890,0.37,40,-2750,-3200,-14.06
1990,"Venezuela, Bolivarian Republic of",17497,0.5,35,7335,0.2,50,24832,0.35,41,-10162,-5507,84.53
1990,Czech and Slovak Federal Republic,11880,0.34,45,12460,0.35,40,24340,0.34,42,580,-190,-405.26
1990,Algeria,12880,0.37,42,9770,0.27,44,22650,0.32,43,-3110,-100,3010.0
1990,Philippines,8117,0.23,50,13004,0.36,39,21121,0.3,44,4887,3404,43.57
1990,Hungary,10000,0.29,47,10340,0.29,43,20340,0.29,45,340,-805,-142.24
1990,Libya,13878,0.4,39,5663,0.16,53,19541,0.28,46,-8215,-4224,94.48
1990,Nigeria,13596,0.39,40,5627,0.16,54,19223,0.27,47,-7969,-5813,37.09
1990,New Zealand,9394,0.27,48,9501,0.26,45,18895,0.27,48,107,-92,-216.3
1990,Iraq,10314,0.3,46,6526,0.18,52,16840,0.24,49,-3788,-2385,58.83
1990,Argentina,12353,0.35,43,4076,0.11,59,16429,0.23,50,-8277,-5376,53.96
1990,Chile,8373,0.24,49,7940,0.22,47,16313,0.23,51,-433,-845,-48.76
1990,Pakistan,5589,0.16,54,7376,0.2,49,12965,0.18,52,1787,2434,-26.58
1990,Romania,4960,0.14,58,7600,0.21,48,12560,0.18,53,2640,-2055,-228.47
1990,Colombia,6721,0.19,53,5589,0.16,55,12310,0.17,54,-1132,-713,58.77
1990,Egypt,2585,0.07,68,9216,0.26,46,11801,0.17,55,6631,12010,-44.79
1990,Morocco,4265,0.12,59,6922,0.19,51,11187,0.16,56,2657,2156,23.24
1990,"Kuwait, the State of",7042,0.2,52,3972,0.11,60,11014,0.16,57,-3070,-5181,-40.75
1990,Bulgaria,5030,0.14,57,5100,0.14,57,10130,0.14,58,70,-1040,-106.73
1990,Cuba,5100,0.15,56,4600,0.13,58,9700,0.14,59,-500,2173,-123.01
1990,Tunisia,3526,0.1,64,5513,0.15,56,9039,0.13,60,1987,1444,37.6
1990,Oman,5508,0.16,55,2798,0.08,65,8306,0.12,61,-2710,-1569,72.72
1990,"Bahrain, Kingdom of",3761,0.11,62,3712,0.1,61,7473,0.11,62,-49,303,-116.17
1990,Syrian Arab Republic,4212,0.12,60,2400,0.07,72,6612,0.09,63,-1812,-902,100.89
1990,Peru,3280,0.09,65,2634,0.07,68,5914,0.08,64,-646,-1479,-56.32
1990,Angola,3910,0.11,61,1578,0.04,90,5488,0.08,65,-2332,-1677,39.06
1990,Qatar,3641,0.1,63,1695,0.05,85,5336,0.08,66,-1946,-1361,42.98
1990,Bangladesh,1671,0.05,83,3618,0.1,62,5289,0.07,67,1947,2345,-16.97
1990,Dominican Republic,2170,0.06,73,3006,0.08,63,5176,0.07,68,836,975,-14.26
1990,Côte d'Ivoire,3072,0.09,66,2097,0.06,76,5169,0.07,69,-975,-696,40.09
1990,Viet Nam,2404,0.07,69,2752,0.08,66,5156,0.07,70,348,619,-43.78
1990,"Korea, Democratic People's Republic of",1857,0.05,77,2930,0.08,64,4787,0.07,71,1073,1219,-11.98
1990,Sri Lanka,1912,0.05,76,2685,0.07,67,4597,0.06,72,773,643,20.22
1990,Ecuador,2714,0.08,67,1862,0.05,81,4576,0.06,73,-852,-499,70.74
1990,Democratic Republic of the Congo,2326,0.07,70,1739,0.05,84,4065,0.06,74,-587,-492,19.31
1990,Netherlands Antilles,1790,0.05,78,2141,0.06,75,3931,0.06,75,351,156,125.0
1990,Botswana,1784,0.05,79,1946,0.05,79,3730,0.05,76,162,-357,-145.38
1990,Jordan,1064,0.03,93,2600,0.07,69,3664,0.05,77,1536,1019,50.74
1990,Zimbabwe,1726,0.05,80,1847,0.05,82,3573,0.05,78,121,82,47.56
1990,Cyprus,951,0.03,97,2568,0.07,70,3519,0.05,79,1617,1497,8.02
1990,Costa Rica,1448,0.04,85,1990,0.06,77,3438,0.05,80,542,302,79.47
1990,Cameroon,2002,0.06,74,1400,0.04,94,3402,0.05,81,-602,-421,42.99
1990,Iceland,1592,0.05,84,1680,0.05,87,3272,0.05,82,88,16,450.0
1990,Kenya,1032,0.03,94,2223,0.06,73,3255,0.05,83,1191,1223,-2.62
1990,"Macao, China",1701,0.05,81,1539,0.04,92,3240,0.05,84,-162,-163,-0.61
1990,Brunei Darussalam,2213,0.06,71,1001,0.03,107,3214,0.05,85,-1212,-1024,18.36
1990,Gabon,2204,0.06,72,918,0.03,112,3122,0.04,86,-1286,-831,54.75
1990,Malta,1133,0.03,91,1964,0.05,78,3097,0.04,87,831,635,30.87
1990,Jamaica,1158,0.03,90,1928,0.05,80,3086,0.04,88,770,854,-9.84
1990,Trinidad and Tobago,1960,0.06,75,1109,0.03,104,3069,0.04,89,-851,-357,138.38
1990,Uruguay,1693,0.05,82,1343,0.04,96,3036,0.04,90,-350,-396,-11.62
1990,Lebanese Republic,494,0.01,109,2525,0.07,71,3019,0.04,91,2031,1750,16.06
1990,Guatemala,1163,0.03,89,1649,0.05,88,2812,0.04,92,486,546,-10.99
1990,Mauritius,1194,0.03,87,1618,0.04,89,2812,0.04,92,424,339,25.07
1990,Zambia,1309,0.04,86,1220,0.03,98,2529,0.04,94,-89,-441,-79.82
1990,Papua New Guinea,1177,0.03,88,1193,0.03,101,2370,0.03,95,16,126,-87.3
1990,Reunion,186,0.01,135,2160,0.06,74,2346,0.03,96,1974,1571,25.65
1990,Paraguay,959,0.03,96,1352,0.04,95,2311,0.03,97,393,-246,-259.76
1990,Yemen,692,0.02,103,1571,0.04,91,2263,0.03,98,879,750,17.2
1990,Namibia,1085,0.03,92,1163,0.03,102,2248,0.03,99,78,137,-43.07
1990,Ghana,897,0.03,100,1205,0.03,100,2102,0.03,100,308,255,20.78
1990,Martinique,276,0.01,126,1740,0.05,83,2016,0.03,101,1464,1121,30.6
1990,Senegal,761,0.02,102,1219,0.03,99,1980,0.03,102,458,528,-13.26
1990,Panama,340,0.01,117,1539,0.04,92,1879,0.03,103,1199,668,79.49
1990,Honduras,934,0.03,98,938,0.03,108,1872,0.03,104,4,110,-96.36
1990,El Salvador,582,0.02,106,1263,0.04,97,1845,0.03,105,681,663,2.71
1990,Guadeloupe,122,0.0,145,1681,0.05,86,1803,0.03,106,1559,1135,37.36
1990,"Bolivia, Plurinational State of",926,0.03,99,687,0.02,119,1613,0.02,107,-239,-211,13.27
1990,Congo,981,0.03,95,621,0.02,125,1602,0.02,108,-360,-729,-50.62
1990,Mongolia,661,0.02,105,924,0.03,111,1585,0.02,109,263,242,8.68
1990,Liberia,868,0.02,101,570,0.02,132,1438,0.02,110,-298,165,-280.61
1990,Guinea,671,0.02,104,723,0.02,117,1394,0.02,111,52,-6,-966.67
1990,Ethiopia,298,0.01,123,1081,0.03,105,1379,0.02,112,783,478,63.81
1990,Tanzania,331,0.01,118,1027,0.03,106,1358,0.02,113,696,625,11.36
1990,Bahamas,238,0.01,129,1112,0.03,103,1350,0.02,114,874,650,34.46
1990,New Caledonia,449,0.01,113,883,0.02,113,1332,0.02,115,434,91,376.92
1990,Fiji,497,0.01,108,754,0.02,116,1251,0.02,116,257,87,195.4
1990,Eswatini,556,0.02,107,663,0.02,122,1219,0.02,117,107,81,32.1
1990,Afghanistan,235,0.01,130,936,0.03,109,1171,0.02,118,701,586,19.62
1990,French Polynesia,111,0.0,147,930,0.03,110,1041,0.01,119,819,701,16.83
1990,Mozambique,126,0.0,144,878,0.02,114,1004,0.01,120,752,703,6.97
1990,Sudan,374,0.01,115,619,0.02,126,993,0.01,121,245,663,-63.05
1990,Malawi,417,0.01,114,575,0.02,131,992,0.01,122,158,236,-33.05
1990,Madagascar,319,0.01,121,651,0.02,123,970,0.01,123,332,26,1176.92
1990,Nicaragua,330,0.01,119,638,0.02,124,968,0.01,124,308,304,1.32
1990,Mali,359,0.01,116,602,0.02,127,961,0.01,125,243,256,-5.08
1990,Suriname,472,0.01,110,472,0.01,134,944,0.01,126,0,-99,-100.0
1990,Barbados,216,0.01,132,704,0.02,118,920,0.01,127,488,487,0.21
1990,Greenland,452,0.01,112,445,0.01,135,897,0.01,128,-7,-19,-63.16
1990,Nepal,204,0.01,133,672,0.02,120,876,0.01,129,468,423,10.64
1990,French Guiana,90,0.0,149,786,0.02,115,876,0.01,129,696,510,36.47
1990,Mauritania,469,0.01,111,388,0.01,137,857,0.01,131,-81,-215,-62.33
1990,Togo,268,0.01,127,581,0.02,129,849,0.01,132,313,227,37.89
1990,"Aruba, Netherlands with respect to",155,0.0,137,581,0.02,129,736,0.01,133,426,295,44.41
1990,Lesotho,62,0.0,158,672,0.02,120,734,0.01,134,610,551,10.71
1990,Burkina Faso,152,0.0,138,536,0.01,133,688,0.01,135,384,296,29.73
1990,American Samoa,311,0.01,122,360,0.01,140,671,0.01,136,49,70,-30.0
1990,Niger,282,0.01,125,388,0.01,137,670,0.01,137,106,119,-10.92
1990,Bermuda,60,0.0,160,595,0.02,128,655,0.01,138,535,485,10.31
1990,Albania,230,0.01,131,380,0.01,139,610,0.01,139,150,82,82.93
1990,Myanmar,325,0.01,120,270,0.01,147,595,0.01,140,-55,-19,189.47
1990,Guyana,257,0.01,128,311,0.01,142,568,0.01,141,54,31,74.19
1990,Benin,288,0.01,124,265,0.01,148,553,0.01,142,-23,203,-111.33
1990,Somalia,150,0.0,140,394,0.01,136,544,0.01,143,244,279,-12.54
1990,Haiti,160,0.0,136,332,0.01,141,492,0.01,144,172,147,17.01
1990,Chad,188,0.01,134,285,0.01,145,473,0.01,145,97,85,14.12
1990,Uganda,152,0.0,138,288,0.01,143,440,0.01,146,136,-3,-4633.33
1990,Rwanda,110,0.0,148,288,0.01,143,398,0.01,147,178,245,-27.35
1990,Saint Lucia,127,0.0,143,271,0.01,146,398,0.01,147,144,165,-12.73
1990,Belize,129,0.0,142,211,0.01,152,340,0.0,149,82,91,-9.89
1990,Burundi,75,0.0,155,231,0.01,150,306,0.0,150,156,109,43.12
1990,Sierra Leone,138,0.0,141,149,0.0,158,287,0.0,151,11,45,-75.56
1990,Antigua and Barbuda,21,0.0,168,255,0.01,149,276,0.0,152,234,176,32.95
1990,Central African Republic,120,0.0,146,154,0.0,157,274,0.0,153,34,16,112.5
1990,Lao People's Democratic Republic,79,0.0,153,185,0.01,155,264,0.0,154,106,122,-13.11
1990,Cambodia,86,0.0,150,164,0.0,156,250,0.0,155,78,91,-14.29
1990,Seychelles,56,0.0,161,186,0.01,154,242,0.0,156,130,131,-0.76
1990,Djibouti,25,0.0,167,215,0.01,151,240,0.0,157,190,172,10.47
1990,Saint Vincent and the Grenadines,83,0.0,151,136,0.0,160,219,0.0,158,53,52,1.92
1990,The Gambia,31,0.0,163,188,0.01,153,219,0.0,158,157,134,17.16
1990,Maldives,78,0.0,154,138,0.0,159,216,0.0,160,60,68,-11.76
1990,Dominica,55,0.0,162,118,0.0,162,173,0.0,161,63,62,1.61
1990,Solomon Islands,70,0.0,156,91,0.0,166,161,0.0,162,21,39,-46.15
1990,Bhutan,70,0.0,156,81,0.0,170,151,0.0,163,11,20,-45.0
1990,Cabo Verde,6,0.0,174,136,0.0,160,142,0.0,164,130,105,23.81
1990,Saint Kitts and Nevis,28,0.0,164,110,0.0,163,138,0.0,165,82,77,6.49
1990,Grenada,27,0.0,165,105,0.0,164,132,0.0,166,78,71,9.86
1990,Equatorial Guinea,62,0.0,158,61,0.0,173,123,0.0,167,-1,10,-110.0
1990,Vanuatu,19,0.0,169,96,0.0,165,115,0.0,168,77,49,57.14
1990,Saint Pierre and Miquelon,26,0.0,166,86,0.0,167,112,0.0,169,60,54,11.11
1990,Guinea-Bissau,19,0.0,169,86,0.0,167,105,0.0,170,67,55,21.82
1990,Samoa,9,0.0,173,81,0.0,170,90,0.0,171,72,62,16.13
1990,"Micronesia, Federated States of",4,0.0,176,84,0.0,169,88,0.0,172,80,71,12.68
1990,Guam,82,0.0,152,0,0.0,182,82,0.0,173,-82,-63,30.16
1990,Tonga,11,0.0,172,62,0.0,172,73,0.0,174,51,45,13.33
1990,Comoros,18,0.0,171,52,0.0,175,70,0.0,175,34,25,36.0
1990,Marshall Islands,3,0.0,178,56,0.0,174,59,0.0,176,53,42,26.19
1990,Cook Islands,5,0.0,175,52,0.0,175,57,0.0,177,47,41,14.63
1990,Montserrat,2,0.0,180,44,0.0,177,46,0.0,178,42,30,40.0
1990,Kiribati,3,0.0,178,27,0.0,178,30,0.0,179,24,18,33.33
1990,Sao Tomé and Principe,4,0.0,176,21,0.0,179,25,0.0,180,17,12,41.67
1990,Tuvalu,0,0.0,181,5,0.0,180,5,0.0,181,5,5,0.0
1990,Niue,0,0.0,181,4,0.0,181,4,0.0,182,4,3,33.33
1989,United States of America,363812,11.74,1,492922,15.38,1,856734,13.59,1,129110,137116,-5.84
1989,Germany,341231,11.01,2,269702,8.42,2,610933,9.69,2,-71529,-72856,-1.82
1989,Japan,273932,8.84,3,209715,6.55,3,483647,7.67,3,-64217,-77478,-17.12
1989,France,179397,5.79,4,192986,6.02,5,372383,5.91,4,13589,11070,22.76
1989,United Kingdom,152345,4.92,5,197731,6.17,4,350076,5.55,5,45386,44175,2.74
1989,Italy,140556,4.54,6,153011,4.78,6,293567,4.66,6,12455,10692,16.49
1989,Canada,121832,3.93,7,119792,3.74,7,241624,3.83,7,-2040,-4394,-53.57
1989,U.S.S.R.,109120,3.52,8,114510,3.57,8,223630,3.55,8,5390,-3415,-257.83
1989,Netherlands,108261,3.49,9,104330,3.26,9,212591,3.37,9,-3931,-3739,5.14
1989,Belgium-Luxembourg,100012,3.23,10,98473,3.07,10,198485,3.15,10,-1539,301,-611.3
1989,"Hong Kong, China",73336,2.37,11,77662,2.42,11,150998,2.4,11,4326,6832,-36.68
1989,"Korea, Republic of",62377,2.01,13,61465,1.92,13,123842,1.96,12,-912,-8885,-89.74
1989,Chinese Taipei,66317,2.14,12,52475,1.64,16,118792,1.88,13,-13842,-10915,26.82
1989,Spain,44492,1.44,18,71469,2.23,12,115961,1.84,14,26977,19302,39.76
1989,China,52538,1.7,14,59142,1.85,14,111680,1.77,15,6604,7752,-14.81
1989,Switzerland,51525,1.66,16,58194,1.82,15,109719,1.74,16,6669,5659,17.85
1989,Sweden,51547,1.66,15,48975,1.53,18,100522,1.59,17,-2572,-4120,-37.57
1989,Singapore,44665,1.44,17,49656,1.55,17,94321,1.5,18,4991,4558,9.5
1989,Australia,37125,1.2,19,44933,1.4,19,82058,1.3,19,7808,2862,172.82
1989,Mexico,35171,1.13,20,36400,1.14,21,71571,1.14,20,1229,-1289,-195.35
1989,Austria,31906,1.03,22,38980,1.22,20,70886,1.12,21,7074,5196,36.14
1989,Denmark,29570,0.95,23,28015,0.87,22,57585,0.91,22,-1555,-1286,20.92
1989,Brazil,34383,1.11,21,19885,0.62,30,54268,0.86,23,-14498,-17439,-16.86
1989,Norway,27108,0.87,25,23676,0.74,25,50784,0.81,24,-3432,784,-537.76
1989,"Saudi Arabia, Kingdom of",28382,0.92,24,21154,0.66,28,49536,0.79,25,-7228,-2593,178.75
1989,Finland,23298,0.75,27,24436,0.76,24,47734,0.76,26,1138,-618,-284.14
1989,Malaysia,25047,0.81,26,22480,0.7,26,47527,0.75,27,-2567,-4575,-43.89
1989,Thailand,20078,0.65,32,25770,0.8,23,45848,0.73,28,5692,4332,31.39
1989,German Democratic Republic,22200,0.72,28,22200,0.69,27,44400,0.7,29,0,900,-100.0
1989,South Africa,22191,0.72,29,18498,0.58,33,40689,0.65,30,-3693,-3148,17.31
1989,Indonesia,22160,0.72,30,16444,0.51,35,38604,0.61,31,-5716,-6216,-8.04
1989,Ireland,20667,0.67,31,17420,0.54,34,38087,0.6,32,-3247,-3156,2.88
1989,India,15872,0.51,35,20549,0.64,29,36421,0.58,33,4677,5868,-20.3
1989,Portugal,12799,0.41,41,19072,0.6,31,31871,0.51,34,6273,6877,-8.78
1989,Bulgaria,16220,0.52,34,15180,0.47,38,31400,0.5,35,-1040,-590,76.27
1989,Czech and Slovak Federal Republic,14450,0.47,36,14260,0.45,42,28710,0.46,36,-190,-300,-36.67
1989,"Yugoslavia, Socialist Federal Republic of",13460,0.43,38,14829,0.46,39,28289,0.45,37,1369,508,169.49
1989,Iran,13081,0.42,40,14794,0.46,40,27875,0.44,38,1713,-1255,-236.49
1989,United Arab Emirates,17596,0.57,33,10010,0.31,45,27606,0.44,39,-7586,-3518,115.63
1989,Türkiye,11625,0.38,43,15792,0.49,37,27417,0.43,40,4167,2673,55.89
1989,Egypt,6764,0.22,56,18774,0.59,32,25538,0.41,41,12010,17592,-31.73
1989,Israel,11072,0.36,45,14347,0.45,41,25419,0.4,42,3275,5266,-37.81
1989,Poland,13470,0.43,37,10270,0.32,44,23740,0.38,43,-3200,-1715,86.59
1989,Greece,7545,0.24,55,16151,0.5,36,23696,0.38,44,8606,6894,24.83
1989,Iraq,12284,0.4,42,9899,0.31,46,22183,0.35,45,-2385,659,-461.91
1989,"Venezuela, Bolivarian Republic of",13310,0.43,39,7803,0.24,51,21113,0.33,46,-5507,2482,-321.88
1989,Algeria,9570,0.31,50,9470,0.3,47,19040,0.3,47,-100,-120,-16.67
1989,Philippines,7767,0.25,54,11171,0.35,43,18938,0.3,48,3404,1709,99.18
1989,Romania,10490,0.34,46,8435,0.26,50,18925,0.3,49,-2055,-3750,-45.2
1989,Hungary,9670,0.31,48,8865,0.28,48,18535,0.29,50,-805,-630,27.78
1989,"Kuwait, the State of",11476,0.37,44,6295,0.2,55,17771,0.28,51,-5181,-1518,241.3
1989,New Zealand,8876,0.29,51,8784,0.27,49,17660,0.28,52,-92,-1508,-93.9
1989,Chile,8078,0.26,53,7233,0.23,53,15311,0.24,53,-845,-1760,-51.99
1989,Nigeria,10000,0.32,47,4187,0.13,61,14187,0.23,54,-5813,-2158,169.37
1989,Argentina,9579,0.31,49,4203,0.13,60,13782,0.22,55,-5376,-3813,40.99
1989,Libya,8617,0.28,52,4393,0.14,58,13010,0.21,56,-4224,-804,425.37
1989,Cuba,5353,0.17,58,7526,0.23,52,12879,0.2,57,2173,2061,5.43
1989,Pakistan,4709,0.15,59,7143,0.22,54,11852,0.19,58,2434,2068,17.7
1989,Colombia,5717,0.18,57,5004,0.16,57,10721,0.17,59,-713,-35,1937.14
1989,Morocco,3337,0.11,62,5493,0.17,56,8830,0.14,60,2156,1147,87.97
1989,Tunisia,2930,0.09,65,4374,0.14,59,7304,0.12,61,1444,1294,11.59
1989,Oman,3933,0.13,60,2364,0.07,68,6297,0.1,62,-1569,-926,69.44
1989,"Bahrain, Kingdom of",2831,0.09,66,3134,0.1,65,5965,0.09,63,303,182,66.48
1989,Bahamas,2487,0.08,69,3137,0.1,64,5624,0.09,64,650,138,371.01
1989,Peru,3488,0.11,61,2009,0.06,76,5497,0.09,65,-1479,408,-462.5
1989,Dominican Republic,2241,0.07,72,3216,0.1,63,5457,0.09,66,975,667,46.18
1989,Syrian Arab Republic,2986,0.1,64,2084,0.07,75,5070,0.08,67,-902,880,-202.5
1989,Bangladesh,1305,0.04,89,3650,0.11,62,4955,0.08,68,2345,1750,34.0
1989,Côte d'Ivoire,2807,0.09,67,2111,0.07,74,4918,0.08,69,-696,-690,0.87
1989,"Korea, Democratic People's Republic of",1686,0.05,76,2905,0.09,66,4591,0.07,70,1219,1165,4.64
1989,Viet Nam,1946,0.06,73,2565,0.08,67,4511,0.07,71,619,1718,-63.97
1989,Angola,3015,0.1,63,1338,0.04,91,4353,0.07,72,-1677,-1144,46.59
1989,Democratic Republic of the Congo,2417,0.08,70,1925,0.06,77,4342,0.07,73,-492,-850,-42.12
1989,Ecuador,2354,0.08,71,1855,0.06,78,4209,0.07,74,-499,-478,4.39
1989,Qatar,2687,0.09,68,1326,0.04,93,4013,0.06,75,-1361,-943,44.33
1989,Sri Lanka,1545,0.05,82,2188,0.07,71,3733,0.06,76,643,786,-18.19
1989,Botswana,1857,0.06,75,1500,0.05,86,3357,0.05,77,-357,-269,32.71
1989,Jordan,1107,0.04,93,2126,0.07,73,3233,0.05,78,1019,1713,-40.51
1989,Zimbabwe,1541,0.05,83,1623,0.05,83,3164,0.05,79,82,-341,-124.05
1989,Costa Rica,1415,0.05,85,1717,0.05,81,3132,0.05,80,302,164,84.15
1989,Kenya,951,0.03,98,2174,0.07,72,3125,0.05,81,1223,921,32.79
1989,"Macao, China",1643,0.05,78,1480,0.05,87,3123,0.05,82,-163,-217,-24.88
1989,Cyprus,791,0.03,102,2288,0.07,69,3079,0.05,83,1497,1154,29.72
1989,Netherlands Antilles,1454,0.05,84,1610,0.05,84,3064,0.05,84,156,269,-42.01
1989,Cameroon,1682,0.05,77,1261,0.04,97,2943,0.05,85,-421,347,-221.33
1989,Papua New Guinea,1404,0.05,86,1530,0.05,85,2934,0.05,86,126,-6,-2200.0
1989,Jamaica,998,0.03,96,1852,0.06,79,2850,0.05,87,854,574,48.78
1989,Uruguay,1598,0.05,79,1202,0.04,102,2800,0.04,88,-396,-248,59.68
1989,Trinidad and Tobago,1578,0.05,81,1221,0.04,100,2799,0.04,89,-357,-285,25.26
1989,Iceland,1385,0.04,87,1401,0.04,89,2786,0.04,90,16,173,-90.75
1989,Guatemala,1108,0.04,92,1654,0.05,82,2762,0.04,91,546,535,2.06
1989,Brunei Darussalam,1883,0.06,74,859,0.03,110,2742,0.04,92,-1024,-964,6.22
1989,Lebanese Republic,485,0.02,113,2235,0.07,70,2720,0.04,93,1750,1677,4.35
1989,Namibia,1122,0.04,91,1259,0.04,98,2381,0.04,94,137,217,-36.87
1989,Gabon,1598,0.05,79,767,0.02,114,2365,0.04,95,-831,-405,105.19
1989,Malta,844,0.03,100,1479,0.05,88,2323,0.04,96,635,639,-0.63
1989,Mauritius,986,0.03,97,1325,0.04,94,2311,0.04,97,339,267,26.97
1989,Ghana,1018,0.03,94,1273,0.04,96,2291,0.04,98,255,-104,-345.19
1989,Zambia,1347,0.04,88,906,0.03,109,2253,0.04,99,-441,-344,28.2
1989,Sudan,672,0.02,106,1335,0.04,92,2007,0.03,100,663,551,20.33
1989,Yemen,606,0.02,107,1356,0.04,90,1962,0.03,101,750,937,-19.96
1989,Senegal,693,0.02,104,1221,0.04,100,1914,0.03,102,528,489,7.98
1989,Reunion,161,0.01,135,1732,0.05,80,1893,0.03,103,1571,1504,4.45
1989,Honduras,859,0.03,99,969,0.03,106,1828,0.03,104,110,98,12.24
1989,Paraguay,1006,0.03,95,760,0.02,116,1766,0.03,105,-246,64,-484.38
1989,Congo,1247,0.04,90,518,0.02,129,1765,0.03,106,-729,-373,95.44
1989,Mongolia,721,0.02,103,963,0.03,107,1684,0.03,107,242,374,-35.29
1989,El Salvador,498,0.02,111,1161,0.04,103,1659,0.03,108,663,398,66.58
1989,Martinique,200,0.01,133,1321,0.04,95,1521,0.02,109,1121,1087,3.13
1989,New Caledonia,675,0.02,105,766,0.02,115,1441,0.02,110,91,140,-35.0
1989,"Bolivia, Plurinational State of",822,0.03,101,611,0.02,121,1433,0.02,111,-211,-9,2244.44
1989,Ethiopia,465,0.02,114,943,0.03,108,1408,0.02,112,478,700,-31.71
1989,Guadeloupe,111,0.0,144,1246,0.04,99,1357,0.02,113,1135,1056,7.48
1989,Tanzania,365,0.01,118,990,0.03,104,1355,0.02,114,625,548,14.05
1989,Panama,318,0.01,119,986,0.03,105,1304,0.02,115,668,444,50.45
1989,Guinea,595,0.02,108,589,0.02,123,1184,0.02,116,-6,94,-106.38
1989,Liberia,460,0.01,115,625,0.02,118,1085,0.02,117,165,-124,-233.06
1989,Eswatini,502,0.02,110,583,0.02,124,1085,0.02,117,81,48,68.75
1989,Fiji,494,0.02,112,581,0.02,126,1075,0.02,119,87,31,180.65
1989,Afghanistan,236,0.01,129,822,0.03,111,1058,0.02,120,586,505,16.04
1989,Suriname,542,0.02,109,443,0.01,133,985,0.02,121,-99,-59,67.8
1989,Nicaragua,311,0.01,121,615,0.02,120,926,0.01,122,304,572,-46.85
1989,Mozambique,105,0.0,147,808,0.03,112,913,0.01,123,703,633,11.06
1989,French Polynesia,89,0.0,149,790,0.02,113,879,0.01,124,701,733,-4.37
1989,Barbados,186,0.01,134,673,0.02,117,859,0.01,125,487,409,19.07
1989,Greenland,418,0.01,117,399,0.01,136,817,0.01,126,-19,128,-114.84
1989,Malawi,267,0.01,125,503,0.02,130,770,0.01,127,236,118,100.0
1989,Mali,246,0.01,126,502,0.02,131,748,0.01,128,256,290,-11.72
1989,Nepal,159,0.01,136,582,0.02,125,741,0.01,129,423,487,-13.14
1989,Togo,245,0.01,127,472,0.01,132,717,0.01,130,227,245,-7.35
1989,"Yemen, People's Democratic Republic",114,0.0,143,601,0.02,122,715,0.01,131,487,565,-13.81
1989,Albania,305,0.01,123,387,0.01,139,692,0.01,132,82,60,36.67
1989,American Samoa,308,0.01,122,378,0.01,140,686,0.01,133,70,-29,-341.38
1989,Lesotho,66,0.0,155,617,0.02,119,683,0.01,134,551,523,5.35
1989,Mauritania,437,0.01,116,222,0.01,149,659,0.01,135,-215,-114,88.6
1989,Madagascar,316,0.01,120,342,0.01,142,658,0.01,136,26,86,-69.77
1989,Benin,218,0.01,131,421,0.01,134,639,0.01,137,203,342,-40.64
1989,French Guiana,57,0.0,158,567,0.02,127,624,0.01,138,510,465,9.68
1989,Niger,244,0.01,128,363,0.01,141,607,0.01,139,119,98,21.43
1989,Bermuda,50,0.0,159,535,0.02,128,585,0.01,140,485,457,6.13
1989,Uganda,274,0.01,124,271,0.01,146,545,0.01,141,-3,616,-100.49
1989,Somalia,120,0.0,142,399,0.01,136,519,0.01,142,279,,
1989,"Aruba, Netherlands with respect to",107,0.0,146,402,0.01,135,509,0.01,143,295,271,8.86
1989,Burkina Faso,95,0.0,148,391,0.01,138,486,0.01,144,296,312,-5.13
1989,Guyana,227,0.01,130,258,0.01,147,485,0.01,145,31,-14,-321.43
1989,Haiti,144,0.0,138,291,0.01,144,435,0.01,146,147,165,-10.91
1989,Rwanda,88,0.0,150,333,0.01,143,421,0.01,147,245,262,-6.49
1989,Myanmar,212,0.01,132,193,0.01,152,405,0.01,148,-19,79,-124.05
1989,Chad,155,0.01,137,240,0.01,148,395,0.01,149,85,84,1.19
1989,Saint Lucia,109,0.0,145,274,0.01,145,383,0.01,150,165,105,57.14
1989,Belize,125,0.0,141,216,0.01,150,341,0.01,151,91,65,40.0
1989,Sierra Leone,138,0.0,139,183,0.01,156,321,0.01,152,45,50,-10.0
1989,Central African Republic,134,0.0,140,150,0.0,159,284,0.0,153,16,71,-77.46
1989,Burundi,78,0.0,151,187,0.01,154,265,0.0,154,109,71,53.52
1989,Lao People's Democratic Republic,63,0.0,156,185,0.01,155,248,0.0,155,122,130,-6.15
1989,Djibouti,25,0.0,168,197,0.01,151,222,0.0,156,172,178,-3.37
1989,Antigua and Barbuda,16,0.0,172,192,0.01,153,208,0.0,157,176,233,-24.46
1989,Saint Vincent and the Grenadines,75,0.0,152,127,0.0,161,202,0.0,158,52,37,40.54
1989,Seychelles,34,0.0,164,165,0.01,157,199,0.0,159,131,127,3.15
1989,Solomon Islands,75,0.0,152,114,0.0,162,189,0.0,160,39,16,143.75
1989,The Gambia,27,0.0,167,161,0.01,158,188,0.0,161,134,80,67.5
1989,Cambodia,44,0.0,162,135,0.0,160,179,0.0,162,91,95,-4.21
1989,Bhutan,70,0.0,154,90,0.0,168,160,0.0,163,20,52,-61.54
1989,Maldives,45,0.0,160,113,0.0,163,158,0.0,164,68,50,36.0
1989,Dominica,45,0.0,160,107,0.0,165,152,0.0,165,62,34,82.35
1989,Saint Kitts and Nevis,25,0.0,168,102,0.0,166,127,0.0,166,77,67,14.93
1989,Grenada,28,0.0,166,99,0.0,167,127,0.0,166,71,59,20.34
1989,Cabo Verde,7,0.0,176,112,0.0,164,119,0.0,168,105,103,1.94
1989,Saint Pierre and Miquelon,30,0.0,165,84,0.0,169,114,0.0,169,54,49,10.2
1989,Vanuatu,22,0.0,170,71,0.0,172,93,0.0,170,49,50,-2.0
1989,Equatorial Guinea,41,0.0,163,51,0.0,175,92,0.0,171,10,12,-16.67
1989,Samoa,13,0.0,174,75,0.0,170,88,0.0,172,62,61,1.64
1989,Guinea-Bissau,14,0.0,173,69,0.0,173,83,0.0,173,55,50,10.0
1989,"Micronesia, Federated States of",2,0.0,180,73,0.0,171,75,0.0,174,71,65,9.23
1989,Guam,63,0.0,156,0,0.0,184,63,0.0,175,-63,-45,40.0
1989,Tonga,9,0.0,175,54,0.0,174,63,0.0,175,45,48,-6.25
1989,Comoros,18,0.0,171,43,0.0,178,61,0.0,177,25,32,-21.88
1989,Cook Islands,3,0.0,179,44,0.0,176,47,0.0,178,41,38,7.89
1989,Marshall Islands,2,0.0,180,44,0.0,176,46,0.0,179,42,32,31.25
1989,Montserrat,2,0.0,180,32,0.0,179,34,0.0,180,30,25,20.0
1989,Kiribati,5,0.0,178,23,0.0,180,28,0.0,181,18,17,5.88
1989,Sao Tomé and Principe,6,0.0,177,18,0.0,181,24,0.0,182,12,10,20.0
1989,Tuvalu,0,0.0,183,5,0.0,182,5,0.0,183,5,6,-16.67
1989,Niue,0,0.0,183,3,0.0,183,3,0.0,184,3,2,50.0
1988,United States of America,322427,11.24,2,459543,15.5,1,781970,13.41,1,137116,170321,-19.5
1988,Germany,323323,11.27,1,250467,8.45,2,573790,9.84,2,-72856,-65928,10.51
1988,Japan,264856,9.23,3,187378,6.32,4,452234,7.75,3,-77478,-80253,-3.46
1988,France,167787,5.85,4,178857,6.03,5,346644,5.94,4,11070,10094,9.67
1988,United Kingdom,145165,5.06,5,189340,6.39,3,334505,5.74,5,44175,23150,90.82
1988,Italy,127859,4.46,6,138551,4.67,6,266410,4.57,6,10692,8950,19.46
1988,Canada,117105,4.08,7,112711,3.8,7,229816,3.94,7,-4394,-5575,-21.18
1988,U.S.S.R.,110500,3.85,8,107085,3.61,8,217585,3.73,8,-3415,-11690,-70.79
1988,Netherlands,103213,3.6,9,99474,3.36,9,202687,3.48,9,-3739,-1801,107.61
1988,Belgium-Luxembourg,92135,3.21,10,92436,3.12,10,184571,3.16,10,301,135,122.96
1988,"Hong Kong, China",63493,2.21,11,70325,2.37,11,133818,2.29,11,6832,1979,245.22
1988,"Korea, Republic of",60696,2.12,12,51811,1.75,15,112507,1.93,12,-8885,-6261,41.91
1988,Chinese Taipei,60695,2.12,13,49780,1.68,16,110475,1.89,13,-10915,-18781,-41.88
1988,Switzerland,50704,1.77,14,56363,1.9,13,107067,1.84,14,5659,5137,10.16
1988,China,47516,1.66,16,55268,1.86,14,102784,1.76,15,7752,3779,105.13
1988,Spain,40341,1.41,17,59643,2.01,12,99984,1.71,16,19302,14921,29.36
1988,Sweden,49747,1.73,15,45627,1.54,17,95374,1.64,17,-4120,-3800,8.42
1988,Singapore,39306,1.37,18,43864,1.48,18,83170,1.43,18,4558,3872,17.72
1988,Australia,33233,1.16,20,36095,1.22,20,69328,1.19,19,2862,2697,6.12
1988,Austria,31027,1.08,21,36223,1.22,19,67250,1.15,20,5196,5556,-6.48
1988,Mexico,30691,1.07,22,29402,0.99,21,60093,1.03,21,-1289,-7903,-83.69
1988,Denmark,28514,0.99,23,27228,0.92,22,55742,0.96,22,-1286,-176,630.68
1988,Brazil,33494,1.17,19,16055,0.54,34,49549,0.85,23,-17439,-9643,80.85
1988,"Saudi Arabia, Kingdom of",24377,0.85,24,21784,0.73,26,46161,0.79,24,-2593,-3116,-16.78
1988,Norway,22436,0.78,25,23220,0.78,24,45656,0.78,25,784,1149,-31.77
1988,German Democratic Republic,21700,0.76,28,22600,0.76,25,44300,0.76,26,900,600,50.0
1988,Finland,21748,0.76,27,21130,0.71,27,42878,0.74,27,-618,-403,53.35
1988,South Africa,21871,0.76,26,18723,0.63,30,40594,0.7,28,-3148,-5942,-47.02
1988,Malaysia,21082,0.74,29,16507,0.56,33,37589,0.64,29,-4575,-5277,-13.3
1988,Thailand,15953,0.56,33,20285,0.68,28,36238,0.62,30,4332,1273,240.3
1988,Ireland,18723,0.65,31,15567,0.53,35,34290,0.59,31,-3156,-2357,33.9
1988,Bulgaria,17290,0.6,32,16700,0.56,32,33990,0.58,32,-590,310,-290.32
1988,Indonesia,19465,0.68,30,13249,0.45,39,32714,0.56,33,-6216,-4244,46.47
1988,India,13234,0.46,36,19102,0.64,29,32336,0.55,34,5868,5377,9.13
1988,Czech and Slovak Federal Republic,14880,0.52,34,14580,0.49,37,29460,0.51,35,-300,150,-300.0
1988,Egypt,5706,0.2,55,23298,0.79,23,29004,0.5,36,17592,11874,48.16
1988,Portugal,10989,0.38,41,17866,0.6,31,28855,0.49,37,6877,4647,47.99
1988,Poland,13960,0.49,35,12245,0.41,43,26205,0.45,38,-1715,-1360,26.1
1988,Türkiye,11662,0.41,39,14335,0.48,38,25997,0.45,39,2673,3968,-32.64
1988,"Yugoslavia, Socialist Federal Republic of",12663,0.44,37,13171,0.44,40,25834,0.44,40,508,1189,-57.28
1988,Israel,9752,0.34,45,15018,0.51,36,24770,0.42,41,5266,5894,-10.65
1988,"Venezuela, Bolivarian Republic of",10244,0.36,43,12726,0.43,41,22970,0.39,42,2482,-918,-370.37
1988,United Arab Emirates,12040,0.42,38,8522,0.29,48,20562,0.35,43,-3518,-5154,-31.74
1988,Iran,10709,0.37,42,9454,0.32,45,20163,0.35,44,-1255,-2346,-46.5
1988,Iraq,9609,0.34,46,10268,0.35,44,19877,0.34,45,659,-2290,-128.78
1988,Hungary,10000,0.35,44,9370,0.32,46,19370,0.33,46,-630,280,-325.0
1988,Romania,11390,0.4,40,7640,0.26,50,19030,0.33,47,-3750,-2180,72.02
1988,Greece,5429,0.19,57,12323,0.42,42,17752,0.3,48,6894,6635,3.9
1988,New Zealand,8850,0.31,48,7342,0.25,52,16192,0.28,49,-1508,81,-1961.73
1988,Philippines,7022,0.24,52,8731,0.29,47,15753,0.27,50,1709,1510,13.18
1988,Algeria,7810,0.27,49,7690,0.26,49,15500,0.27,51,-120,-1183,-89.86
1988,Argentina,9135,0.32,47,5322,0.18,56,14457,0.25,52,-3813,-542,603.51
1988,"Kuwait, the State of",7661,0.27,50,6143,0.21,54,13804,0.24,53,-1518,-2771,-45.22
1988,Cuba,5518,0.19,56,7579,0.26,51,13097,0.22,54,2061,2211,-6.78
1988,Libya,6673,0.23,54,5869,0.2,55,12542,0.22,55,-804,-3359,-76.06
1988,Chile,7052,0.25,51,5292,0.18,57,12344,0.21,56,-1760,-828,112.56
1988,Nigeria,6875,0.24,53,4717,0.16,60,11592,0.2,57,-2158,-3453,-37.5
1988,Pakistan,4522,0.16,59,6590,0.22,53,11112,0.19,58,2068,1650,25.33
1988,Colombia,5037,0.18,58,5002,0.17,58,10039,0.17,59,-35,-320,-89.06
1988,Morocco,3626,0.13,60,4773,0.16,59,8399,0.14,60,1147,1422,-19.34
1988,Tunisia,2395,0.08,67,3689,0.12,61,6084,0.1,61,1294,900,43.78
1988,Peru,2701,0.09,63,3109,0.1,62,5810,0.1,62,408,342,19.3
1988,Oman,3268,0.11,61,2342,0.08,70,5610,0.1,63,-926,-1811,-48.87
1988,"Bahrain, Kingdom of",2411,0.08,66,2593,0.09,68,5004,0.09,64,182,284,-35.92
1988,Côte d'Ivoire,2769,0.1,62,2079,0.07,74,4848,0.08,65,-690,-739,-6.63
1988,Dominican Republic,1963,0.07,71,2630,0.09,67,4593,0.08,66,667,921,-27.58
1988,"Korea, Democratic People's Republic of",1674,0.06,73,2839,0.1,64,4513,0.08,67,1165,853,36.58
1988,Bahamas,2153,0.08,70,2291,0.08,71,4444,0.08,68,138,358,-61.45
1988,Bangladesh,1291,0.05,83,3041,0.1,63,4332,0.07,69,1750,1648,6.19
1988,Democratic Republic of the Congo,2460,0.09,65,1610,0.05,79,4070,0.07,70,-850,-39,2079.49
1988,Ecuador,2192,0.08,69,1714,0.06,77,3906,0.07,71,-478,324,-247.53
1988,Angola,2516,0.09,64,1372,0.05,87,3888,0.07,72,-1144,-865,32.25
1988,Viet Nam,1038,0.04,90,2756,0.09,65,3794,0.07,73,1718,1601,7.31
1988,Jordan,1019,0.04,92,2732,0.09,66,3751,0.06,74,1713,1780,-3.76
1988,Sri Lanka,1476,0.05,76,2262,0.08,72,3738,0.06,75,786,665,18.2
1988,Syrian Arab Republic,1336,0.05,82,2216,0.07,73,3552,0.06,76,880,1126,-21.85
1988,Qatar,2210,0.08,68,1267,0.04,94,3477,0.06,77,-943,-824,14.44
1988,Lebanese Republic,780,0.03,99,2457,0.08,69,3237,0.06,78,1677,1230,36.34
1988,Kenya,1067,0.04,88,1988,0.07,75,3055,0.05,79,921,777,18.53
1988,Iceland,1424,0.05,78,1597,0.05,80,3021,0.05,80,173,215,-19.53
1988,Zimbabwe,1642,0.06,74,1301,0.04,89,2943,0.05,81,-341,-222,53.6
1988,"Macao, China",1505,0.05,75,1288,0.04,90,2793,0.05,82,-217,-282,-23.05
1988,Papua New Guinea,1399,0.05,81,1393,0.05,85,2792,0.05,83,-6,4,-250.0
1988,Botswana,1465,0.05,77,1196,0.04,97,2661,0.05,84,-269,-650,-58.62
1988,Costa Rica,1246,0.04,84,1410,0.05,83,2656,0.05,85,164,225,-27.11
1988,Guatemala,1022,0.04,91,1557,0.05,81,2579,0.04,86,535,460,16.3
1988,Cyprus,705,0.02,102,1859,0.06,76,2564,0.04,87,1154,916,25.98
1988,Uruguay,1405,0.05,80,1157,0.04,98,2562,0.04,88,-248,-47,427.66
1988,Trinidad and Tobago,1412,0.05,79,1127,0.04,100,2539,0.04,89,-285,-243,17.28
1988,Netherlands Antilles,1134,0.04,87,1403,0.05,84,2537,0.04,90,269,194,38.66
1988,Brunei Darussalam,1708,0.06,72,744,0.03,115,2452,0.04,91,-964,-1261,-23.55
1988,Jamaica,880,0.03,97,1454,0.05,82,2334,0.04,92,574,532,7.89
1988,Namibia,1055,0.04,89,1272,0.04,93,2327,0.04,93,217,218,-0.46
1988,Mauritius,994,0.03,94,1261,0.04,95,2255,0.04,94,267,109,144.95
1988,Cameroon,927,0.03,96,1274,0.04,92,2201,0.04,95,347,917,-62.16
1988,Malta,714,0.02,101,1353,0.05,88,2067,0.04,96,639,534,19.66
1988,Zambia,1179,0.04,86,835,0.03,109,2014,0.03,97,-344,-57,503.51
1988,Gabon,1196,0.04,85,791,0.03,113,1987,0.03,98,-405,-554,-26.9
1988,Ghana,1009,0.04,93,905,0.03,106,1914,0.03,99,-104,179,-158.1
1988,Mongolia,739,0.03,100,1113,0.04,101,1852,0.03,100,374,387,-3.36
1988,Yemen,447,0.02,111,1384,0.05,86,1831,0.03,101,937,835,12.22
1988,Reunion,158,0.01,137,1662,0.06,78,1820,0.03,102,1504,1295,16.14
1988,Honduras,842,0.03,98,940,0.03,105,1782,0.03,103,98,36,172.22
1988,Senegal,591,0.02,105,1080,0.04,102,1671,0.03,104,489,418,16.99
1988,El Salvador,609,0.02,103,1007,0.03,104,1616,0.03,105,398,403,-1.24
1988,Sudan,509,0.02,108,1060,0.04,103,1569,0.03,106,551,367,50.14
1988,Ethiopia,429,0.01,113,1129,0.04,99,1558,0.03,107,700,711,-1.55
1988,Congo,937,0.03,95,564,0.02,126,1501,0.03,108,-373,-444,-15.99
1988,Martinique,196,0.01,132,1283,0.04,91,1479,0.03,109,1087,926,17.39
1988,Guadeloupe,154,0.01,138,1210,0.04,96,1364,0.02,110,1056,947,11.51
1988,Afghanistan,395,0.01,116,900,0.03,107,1295,0.02,111,505,484,4.34
1988,"Bolivia, Plurinational State of",600,0.02,104,591,0.02,121,1191,0.02,112,-9,196,-104.59
1988,Uganda,271,0.01,125,887,0.03,108,1158,0.02,113,616,529,16.45
1988,Guinea,511,0.02,106,605,0.02,119,1116,0.02,114,94,-76,-223.68
1988,Tanzania,275,0.01,123,823,0.03,110,1098,0.02,115,548,640,-14.37
1988,Paraguay,510,0.02,107,574,0.02,124,1084,0.02,116,64,242,-73.55
1988,New Caledonia,464,0.02,110,604,0.02,120,1068,0.02,117,140,401,-65.09
1988,Panama,307,0.01,120,751,0.03,114,1058,0.02,118,444,948,-53.16
1988,Nicaragua,233,0.01,128,805,0.03,112,1038,0.02,119,572,554,3.25
1988,Eswatini,468,0.02,109,516,0.02,128,984,0.02,120,48,12,300.0
1988,Greenland,391,0.01,117,519,0.02,127,910,0.02,121,128,161,-20.5
1988,Fiji,431,0.02,112,462,0.02,133,893,0.02,122,31,-1,-3200.0
1988,French Polynesia,75,0.0,152,808,0.03,111,883,0.02,123,733,746,-1.74
1988,Nepal,191,0.01,133,678,0.02,117,869,0.01,124,487,420,15.95
1988,Mozambique,103,0.0,147,736,0.02,116,839,0.01,125,633,545,16.15
1988,Benin,226,0.01,130,568,0.02,125,794,0.01,126,342,89,284.27
1988,Suriname,410,0.01,114,351,0.01,140,761,0.01,127,-59,-12,391.67
1988,Barbados,173,0.01,135,582,0.02,123,755,0.01,128,409,361,13.3
1988,Togo,242,0.01,127,487,0.02,132,729,0.01,129,245,180,36.11
1988,"Yemen, People's Democratic Republic",82,0.0,150,647,0.02,118,729,0.01,129,565,422,33.89
1988,Mali,214,0.01,131,504,0.02,130,718,0.01,131,290,196,47.96
1988,American Samoa,368,0.01,118,339,0.01,142,707,0.01,132,-29,58,-150.0
1988,Malawi,288,0.01,122,406,0.01,135,694,0.01,133,118,18,555.56
1988,Niger,289,0.01,121,387,0.01,136,676,0.01,134,98,-1,-9900.0
1988,Liberia,396,0.01,115,272,0.01,144,668,0.01,135,-124,-74,67.57
1988,Lesotho,64,0.0,154,587,0.02,122,651,0.01,136,523,422,23.93
1988,Madagascar,274,0.01,124,360,0.01,138,634,0.01,137,86,-29,-396.55
1988,Burkina Faso,142,0.0,140,454,0.02,134,596,0.01,138,312,279,11.83
1988,Mauritania,354,0.01,119,240,0.01,147,594,0.01,139,-114,-193,-40.93
1988,Albania,258,0.01,126,318,0.01,143,576,0.01,140,60,38,57.89
1988,French Guiana,50,0.0,158,515,0.02,129,565,0.01,141,465,340,36.76
1988,Haiti,179,0.01,134,344,0.01,141,523,0.01,142,165,185,-10.81
1988,Bermuda,31,0.0,165,488,0.02,131,519,0.01,143,457,391,16.88
1988,Rwanda,108,0.0,145,370,0.01,137,478,0.01,144,262,238,10.08
1988,Guyana,230,0.01,129,216,0.01,150,446,0.01,145,-14,23,-160.87
1988,"Aruba, Netherlands with respect to",84,0.0,149,355,0.01,139,439,0.01,146,271,205,32.2
1988,Myanmar,167,0.01,136,246,0.01,146,413,0.01,147,79,50,58.0
1988,Chad,144,0.01,139,228,0.01,148,372,0.01,148,84,117,-28.21
1988,Burundi,133,0.0,141,204,0.01,151,337,0.01,149,71,121,-41.32
1988,Saint Lucia,115,0.0,144,220,0.01,149,335,0.01,150,105,100,5.0
1988,Central African Republic,130,0.0,142,201,0.01,152,331,0.01,151,71,74,-4.05
1988,Belize,116,0.0,143,181,0.01,155,297,0.01,152,65,40,62.5
1988,Antigua and Barbuda,17,0.0,170,250,0.01,145,267,0.0,153,233,228,2.19
1988,Sierra Leone,106,0.0,146,156,0.01,157,262,0.0,154,50,7,614.29
1988,Lao People's Democratic Republic,63,0.0,155,193,0.01,154,256,0.0,155,130,154,-15.58
1988,Djibouti,23,0.0,167,201,0.01,152,224,0.0,156,178,177,0.56
1988,Saint Vincent and the Grenadines,85,0.0,148,122,0.0,161,207,0.0,157,37,47,-21.28
1988,Bhutan,75,0.0,152,127,0.0,159,202,0.0,158,52,32,62.5
1988,The Gambia,58,0.0,156,138,0.0,158,196,0.0,159,80,87,-8.05
1988,Seychelles,32,0.0,163,159,0.01,156,191,0.0,160,127,91,39.56
1988,Solomon Islands,82,0.0,150,98,0.0,163,180,0.0,161,16,17,-5.88
1988,Cambodia,32,0.0,163,127,0.0,159,159,0.0,162,95,118,-19.49
1988,Dominica,54,0.0,157,88,0.0,167,142,0.0,163,34,18,88.89
1988,Maldives,40,0.0,161,90,0.0,166,130,0.0,164,50,50,0.0
1988,Grenada,33,0.0,162,92,0.0,165,125,0.0,165,59,57,3.51
1988,Saint Kitts and Nevis,26,0.0,166,93,0.0,164,119,0.0,166,67,52,28.85
1988,Equatorial Guinea,49,0.0,159,61,0.0,173,110,0.0,167,12,19,-36.84
1988,Cabo Verde,3,0.0,178,106,0.0,162,109,0.0,168,103,92,11.96
1988,Samoa,15,0.0,172,76,0.0,168,91,0.0,169,61,50,22.0
1988,Vanuatu,20,0.0,169,70,0.0,169,90,0.0,170,50,52,-3.85
1988,Guinea-Bissau,16,0.0,171,66,0.0,171,82,0.0,171,50,53,-5.66
1988,Saint Pierre and Miquelon,13,0.0,173,62,0.0,172,75,0.0,172,49,26,88.46
1988,Comoros,21,0.0,168,53,0.0,175,74,0.0,173,32,40,-20.0
1988,"Micronesia, Federated States of",3,0.0,178,68,0.0,170,71,0.0,174,65,,
1988,Tonga,8,0.0,174,56,0.0,174,64,0.0,175,48,42,14.29
1988,Cook Islands,4,0.0,176,42,0.0,176,46,0.0,176,38,25,52.0
1988,Guam,45,0.0,160,0,0.0,183,45,0.0,177,-45,-32,40.63
1988,Marshall Islands,2,0.0,180,34,0.0,177,36,0.0,178,32,,
1988,Montserrat,2,0.0,180,27,0.0,178,29,0.0,179,25,21,19.05
1988,Kiribati,5,0.0,175,22,0.0,179,27,0.0,180,17,16,6.25
1988,Sao Tomé and Principe,4,0.0,176,14,0.0,180,18,0.0,181,10,10,0.0
1988,Tuvalu,0,0.0,182,6,0.0,181,6,0.0,182,6,4,50.0
1988,Niue,0,0.0,182,2,0.0,182,2,0.0,183,2,2,0.0
1987,United States of America,254122,10.1,2,424443,16.44,1,678565,13.31,1,170321,155136,9.79
1987,Germany,294369,11.7,1,228441,8.85,2,522810,10.26,2,-65928,-52454,25.69
1987,Japan,231286,9.2,3,151033,5.85,5,382319,7.5,3,-80253,-83204,-3.55
1987,France,148382,5.9,4,158476,6.14,3,306858,6.02,4,10094,4453,126.68
1987,United Kingdom,131257,5.22,5,154407,5.98,4,285664,5.6,5,23150,19237,20.34
1987,Italy,116711,4.64,6,125661,4.87,6,242372,4.75,6,8950,2172,312.06
1987,U.S.S.R.,107620,4.28,7,95930,3.71,7,203550,3.99,7,-11690,-8090,44.5
1987,Canada,98168,3.9,8,92593,3.59,8,190761,3.74,8,-5575,-4835,15.31
1987,Netherlands,93108,3.7,9,91307,3.54,9,184415,3.62,9,-1801,-4781,-62.33
1987,Belgium-Luxembourg,83098,3.3,10,83233,3.22,10,166331,3.26,10,135,-215,-162.79
1987,"Hong Kong, China",48712,1.94,12,50691,1.96,11,99403,1.95,11,1979,-139,-1523.74
1987,Switzerland,45515,1.81,14,50652,1.96,12,96167,1.89,12,5137,3596,42.85
1987,Chinese Taipei,53875,2.14,11,35094,1.36,17,88969,1.75,13,-18781,-15661,19.92
1987,"Korea, Republic of",47281,1.88,13,41020,1.59,15,88301,1.73,14,-6261,-3130,100.03
1987,Sweden,44506,1.77,15,40706,1.58,16,85212,1.67,15,-3800,-4570,-16.85
1987,Spain,34192,1.36,17,49113,1.9,13,83305,1.63,16,14921,7851,90.05
1987,China,39437,1.57,16,43216,1.67,14,82653,1.62,17,3779,11962,-68.41
1987,Singapore,28687,1.14,18,32559,1.26,19,61246,1.2,18,3872,3016,28.38
1987,Austria,27168,1.08,20,32724,1.27,18,59892,1.17,19,5556,4355,27.58
1987,Australia,26621,1.06,21,29318,1.14,20,55939,1.1,20,2697,3535,-23.71
1987,Denmark,25675,1.02,23,25499,0.99,21,51174,1.0,21,-176,1592,-111.06
1987,Mexico,27600,1.1,19,19697,0.76,24,47297,0.93,22,-7903,-4231,86.79
1987,Norway,21490,0.85,25,22639,0.88,22,44129,0.87,23,1149,2209,-47.99
1987,"Saudi Arabia, Kingdom of",23199,0.92,24,20083,0.78,23,43282,0.85,24,-3116,-1073,190.4
1987,Brazil,26224,1.04,22,16581,0.64,28,42805,0.84,25,-9643,-6792,41.98
1987,Finland,20037,0.8,27,19634,0.76,25,39671,0.78,26,-403,-1017,-60.37
1987,German Democratic Republic,18100,0.72,28,18700,0.72,26,36800,0.72,27,600,-100,-700.0
1987,South Africa,21219,0.84,26,15277,0.59,31,36496,0.72,28,-5942,-5393,10.18
1987,Bulgaria,15850,0.63,32,16160,0.63,30,32010,0.63,29,310,1060,-70.75
1987,Malaysia,17958,0.71,29,12681,0.49,40,30639,0.6,30,-5277,-2884,82.98
1987,Indonesia,17135,0.68,30,12891,0.5,39,30026,0.59,31,-4244,-5357,-20.78
1987,Ireland,15999,0.64,31,13642,0.53,36,29641,0.58,32,-2357,-1037,127.29
1987,India,11298,0.45,39,16675,0.65,27,27973,0.55,33,5377,6022,-10.71
1987,Czech and Slovak Federal Republic,13630,0.54,33,13780,0.53,35,27410,0.54,34,150,120,25.0
1987,Thailand,11727,0.47,37,13000,0.5,38,24727,0.49,35,1273,302,321.52
1987,Türkiye,10190,0.41,42,14158,0.55,33,24348,0.48,36,3968,3648,8.77
1987,"Yugoslavia, Socialist Federal Republic of",11443,0.46,38,12632,0.49,41,24075,0.47,37,1189,1397,-14.89
1987,Portugal,9320,0.37,45,13967,0.54,34,23287,0.46,38,4647,2407,93.06
1987,Poland,12210,0.49,35,10850,0.42,42,23060,0.45,39,-1360,-865,57.23
1987,Israel,8454,0.34,46,14348,0.56,32,22802,0.45,40,5894,3652,61.39
1987,Iran,11916,0.47,36,9570,0.37,45,21486,0.42,41,-2346,3350,-170.03
1987,Egypt,4351,0.17,58,16225,0.63,29,20576,0.4,42,11874,8568,38.59
1987,"Venezuela, Bolivarian Republic of",10577,0.42,40,9659,0.37,44,20236,0.4,43,-918,-156,488.46
1987,Greece,6533,0.26,52,13168,0.51,37,19701,0.39,44,6635,5702,16.36
1987,United Arab Emirates,12380,0.49,34,7226,0.28,50,19606,0.38,45,-5154,-4218,22.19
1987,Hungary,9580,0.38,44,9860,0.38,43,19440,0.38,46,280,425,-34.12
1987,Romania,10490,0.42,41,8310,0.32,46,18800,0.37,47,-2180,-1680,29.76
1987,Iraq,9705,0.39,43,7415,0.29,48,17120,0.34,48,-2290,2725,-184.04
1987,Algeria,8225,0.33,48,7042,0.27,52,15267,0.3,49,-1183,1396,-184.74
1987,New Zealand,7195,0.29,51,7276,0.28,49,14471,0.28,50,81,183,-55.74
1987,"Kuwait, the State of",8264,0.33,47,5493,0.21,55,13757,0.27,51,-2771,-1666,66.33
1987,Cuba,5401,0.21,55,7612,0.29,47,13013,0.26,52,2211,2875,-23.1
1987,Philippines,5677,0.23,54,7187,0.28,51,12864,0.25,53,1510,455,231.87
1987,Libya,8043,0.32,49,4684,0.18,56,12727,0.25,54,-3359,-3770,-10.9
1987,Argentina,6360,0.25,53,5818,0.23,54,12178,0.24,55,-542,-2128,-74.53
1987,Nigeria,7365,0.29,50,3912,0.15,60,11277,0.22,56,-3453,-1121,208.03
1987,Pakistan,4172,0.17,59,5822,0.23,53,9994,0.2,57,1650,1990,-17.09
1987,Chile,5224,0.21,56,4396,0.17,57,9620,0.19,58,-828,-755,9.67
1987,Colombia,4642,0.18,57,4322,0.17,58,8964,0.18,59,-320,-1240,-74.19
1987,Morocco,2807,0.11,62,4229,0.16,59,7036,0.14,60,1422,1370,3.8
1987,Bahamas,2722,0.11,63,3080,0.12,61,5802,0.11,61,358,587,-39.01
1987,Oman,3776,0.15,60,1965,0.08,74,5741,0.11,62,-1811,-277,553.79
1987,Peru,2661,0.11,64,3003,0.12,63,5664,0.11,63,342,-140,-344.29
1987,Côte d'Ivoire,3109,0.12,61,2370,0.09,70,5479,0.11,64,-739,-1299,-43.11
1987,Tunisia,2139,0.09,67,3039,0.12,62,5178,0.1,65,900,1131,-20.42
1987,"Bahrain, Kingdom of",2430,0.1,65,2714,0.11,65,5144,0.1,66,284,206,37.86
1987,Ecuador,1928,0.08,69,2252,0.09,72,4180,0.08,67,324,-362,-189.5
1987,Dominican Republic,1498,0.06,73,2419,0.09,69,3917,0.08,68,921,697,32.14
1987,Syrian Arab Republic,1344,0.05,80,2470,0.1,67,3814,0.07,69,1126,1403,-19.74
1987,Bangladesh,1067,0.04,86,2715,0.11,64,3782,0.07,70,1648,1666,-1.08
1987,"Korea, Democratic People's Republic of",1407,0.06,76,2260,0.09,71,3667,0.07,71,853,476,79.2
1987,Jordan,930,0.04,92,2710,0.1,66,3640,0.07,72,1780,1699,4.77
1987,Democratic Republic of the Congo,1813,0.07,71,1774,0.07,76,3587,0.07,73,-39,-561,-93.05
1987,Angola,2168,0.09,66,1303,0.05,86,3471,0.07,74,-865,-246,251.63
1987,Sri Lanka,1393,0.06,78,2058,0.08,73,3451,0.07,75,665,642,3.58
1987,Viet Nam,854,0.03,95,2455,0.1,68,3309,0.06,76,1601,1366,17.2
1987,Qatar,1985,0.08,68,1161,0.04,92,3146,0.06,77,-824,-750,9.87
1987,Iceland,1375,0.05,79,1590,0.06,79,2965,0.06,78,215,20,975.0
1987,Netherlands Antilles,1308,0.05,81,1502,0.06,80,2810,0.06,79,194,188,3.19
1987,Kenya,961,0.04,91,1738,0.07,77,2699,0.05,80,777,413,88.14
1987,Trinidad and Tobago,1462,0.06,74,1219,0.05,88,2681,0.05,81,-243,-36,575.0
1987,Zimbabwe,1427,0.06,75,1205,0.05,90,2632,0.05,82,-222,-170,30.59
1987,Brunei Darussalam,1902,0.08,70,641,0.02,117,2543,0.05,83,-1261,-1141,10.52
1987,Costa Rica,1158,0.05,85,1383,0.05,84,2541,0.05,84,225,27,733.33
1987,Lebanese Republic,650,0.03,100,1880,0.07,75,2530,0.05,85,1230,1653,-25.59
1987,Cameroon,806,0.03,96,1723,0.07,78,2529,0.05,86,917,922,-0.54
1987,Botswana,1587,0.06,72,937,0.04,105,2524,0.05,87,-650,-149,336.24
1987,"Macao, China",1402,0.06,77,1120,0.04,96,2522,0.05,88,-282,-167,68.86
1987,Guatemala,987,0.04,88,1447,0.06,83,2434,0.05,89,460,-85,-641.18
1987,Uruguay,1189,0.05,83,1142,0.04,94,2331,0.05,90,-47,-218,-78.44
1987,Papua New Guinea,1161,0.05,84,1165,0.05,91,2326,0.05,91,4,47,-91.49
1987,Namibia,993,0.04,87,1211,0.05,89,2204,0.04,92,218,-91,-339.56
1987,Ghana,977,0.04,89,1156,0.04,93,2133,0.04,93,179,183,-2.19
1987,Cyprus,568,0.02,105,1484,0.06,81,2052,0.04,94,916,821,11.57
1987,Gabon,1286,0.05,82,732,0.03,115,2018,0.04,95,-554,-405,36.79
1987,Jamaica,706,0.03,99,1238,0.05,87,1944,0.04,96,532,383,38.9
1987,Mauritius,884,0.04,93,993,0.04,104,1877,0.04,97,109,14,678.57
1987,Mongolia,717,0.03,98,1104,0.04,98,1821,0.04,98,387,423,-8.51
1987,Malta,605,0.02,102,1139,0.04,95,1744,0.03,99,534,390,36.92
1987,Zambia,873,0.03,94,816,0.03,113,1689,0.03,100,-57,131,-143.51
1987,Panama,358,0.01,113,1306,0.05,85,1664,0.03,101,948,880,7.73
1987,Reunion,169,0.01,133,1464,0.06,82,1633,0.03,102,1295,1002,29.24
1987,Senegal,606,0.02,101,1024,0.04,101,1630,0.03,103,418,336,24.4
1987,Honduras,791,0.03,97,827,0.03,111,1618,0.03,104,36,21,71.43
1987,El Salvador,591,0.02,103,994,0.04,103,1585,0.03,105,403,180,123.89
1987,Afghanistan,512,0.02,107,996,0.04,102,1508,0.03,106,484,852,-43.19
1987,Congo,973,0.04,90,529,0.02,121,1502,0.03,107,-444,-180,146.67
1987,Ethiopia,355,0.01,114,1066,0.04,99,1421,0.03,108,711,647,9.89
1987,Sudan,504,0.02,108,871,0.03,108,1375,0.03,109,367,628,-41.56
1987,"Bolivia, Plurinational State of",570,0.02,104,766,0.03,114,1336,0.03,110,196,36,444.44
1987,Martinique,194,0.01,131,1120,0.04,96,1314,0.03,111,926,670,38.21
1987,Tanzania,289,0.01,121,929,0.04,106,1218,0.02,112,640,576,11.11
1987,Uganda,319,0.01,118,848,0.03,109,1167,0.02,113,529,-129,-510.08
1987,Guadeloupe,93,0.0,143,1040,0.04,100,1133,0.02,114,947,684,38.45
1987,Nicaragua,273,0.01,124,827,0.03,111,1100,0.02,115,554,610,-9.18
1987,Guinea,544,0.02,106,468,0.02,126,1012,0.02,116,-76,-79,-3.8
1987,Paraguay,353,0.01,115,595,0.02,119,948,0.02,117,242,344,-29.65
1987,Yemen,48,0.0,153,883,0.03,107,931,0.02,118,835,1151,-27.45
1987,French Polynesia,83,0.0,145,829,0.03,110,912,0.02,119,746,697,7.03
1987,Eswatini,423,0.02,110,435,0.02,127,858,0.02,120,12,72,-83.33
1987,Greenland,346,0.01,116,507,0.02,123,853,0.02,121,161,100,61.0
1987,New Caledonia,225,0.01,128,626,0.02,118,851,0.02,122,401,267,50.19
1987,Fiji,380,0.02,112,379,0.01,133,759,0.01,123,-1,99,-101.01
1987,Mozambique,97,0.0,142,642,0.02,116,739,0.01,124,545,464,17.46
1987,Nepal,151,0.01,136,571,0.02,120,722,0.01,125,420,318,32.08
1987,Liberia,382,0.02,111,308,0.01,139,690,0.01,126,-74,-149,-50.34
1987,Barbados,154,0.01,135,515,0.02,122,669,0.01,127,361,312,15.71
1987,Togo,244,0.01,126,424,0.02,129,668,0.01,128,180,108,66.67
1987,Mauritania,428,0.02,109,235,0.01,147,663,0.01,129,-193,-139,38.85
1987,American Samoa,288,0.01,122,346,0.01,137,634,0.01,130,58,59,-1.69
1987,Madagascar,331,0.01,117,302,0.01,140,633,0.01,131,-29,38,-176.32
1987,Niger,312,0.01,119,311,0.01,138,623,0.01,132,-1,51,-101.96
1987,Haiti,214,0.01,130,399,0.02,131,613,0.01,133,185,176,5.11
1987,Benin,260,0.01,125,349,0.01,136,609,0.01,134,89,199,-55.28
1987,Suriname,306,0.01,120,294,0.01,142,600,0.01,135,-12,-8,50.0
1987,Burkina Faso,155,0.01,134,434,0.02,128,589,0.01,136,279,322,-13.35
1987,Malawi,277,0.01,123,295,0.01,141,572,0.01,137,18,12,50.0
1987,"Yemen, People's Democratic Republic",71,0.0,147,493,0.02,124,564,0.01,138,422,193,118.65
1987,Mali,178,0.01,132,374,0.01,134,552,0.01,139,196,233,-15.88
1987,Lesotho,47,0.0,155,469,0.02,125,516,0.01,140,422,328,28.66
1987,Guyana,242,0.01,127,265,0.01,144,507,0.01,141,23,27,-14.81
1987,Myanmar,221,0.01,129,271,0.01,143,492,0.01,142,50,16,212.5
1987,Rwanda,114,0.0,139,352,0.01,135,466,0.01,143,238,160,48.75
1987,Bermuda,29,0.0,163,420,0.02,130,449,0.01,144,391,375,4.27
1987,French Guiana,54,0.0,151,394,0.02,132,448,0.01,145,340,261,30.27
1987,Chad,109,0.0,140,226,0.01,148,335,0.01,146,117,113,3.54
1987,Central African Republic,130,0.01,137,204,0.01,152,334,0.01,147,74,101,-26.73
1987,Burundi,91,0.0,144,212,0.01,150,303,0.01,148,121,48,152.08
1987,"Aruba, Netherlands with respect to",45,0.0,156,250,0.01,145,295,0.01,149,205,180,13.89
1987,Lao People's Democratic Republic,62,0.0,149,216,0.01,149,278,0.01,150,154,131,17.56
1987,Sierra Leone,130,0.01,137,137,0.01,156,267,0.01,151,7,-12,-158.33
1987,Antigua and Barbuda,19,0.0,168,247,0.01,146,266,0.01,152,228,187,21.93
1987,Saint Lucia,79,0.0,146,179,0.01,153,258,0.01,153,100,68,47.06
1987,Belize,103,0.0,141,143,0.01,154,246,0.0,154,40,29,37.93
1987,Djibouti,28,0.0,164,205,0.01,151,233,0.0,155,177,164,7.93
1987,The Gambia,40,0.0,157,127,0.0,157,167,0.0,156,87,69,26.09
1987,Cambodia,22,0.0,166,140,0.01,155,162,0.0,157,118,119,-0.84
1987,Saint Vincent and the Grenadines,52,0.0,152,99,0.0,160,151,0.0,158,47,23,104.35
1987,Solomon Islands,64,0.0,148,81,0.0,163,145,0.0,159,17,6,183.33
1987,Bhutan,55,0.0,150,87,0.0,162,142,0.0,160,32,59,-45.76
1987,Seychelles,22,0.0,166,113,0.0,158,135,0.0,161,91,88,3.41
1987,Grenada,32,0.0,159,89,0.0,161,121,0.0,162,57,53,7.55
1987,Dominica,48,0.0,153,66,0.0,168,114,0.0,163,18,13,38.46
1987,Maldives,31,0.0,161,81,0.0,163,112,0.0,164,50,20,150.0
1987,Cabo Verde,8,0.0,173,100,0.0,159,108,0.0,165,92,103,-10.68
1987,Saint Kitts and Nevis,27,0.0,165,79,0.0,165,106,0.0,166,52,39,33.33
1987,Equatorial Guinea,39,0.0,158,58,0.0,170,97,0.0,167,19,28,-32.14
1987,Vanuatu,18,0.0,169,70,0.0,166,88,0.0,168,52,41,26.83
1987,Saint Pierre and Miquelon,31,0.0,161,57,0.0,171,88,0.0,168,26,35,-25.71
1987,Guinea-Bissau,17,0.0,170,70,0.0,166,87,0.0,170,53,50,6.0
1987,Samoa,12,0.0,171,62,0.0,169,74,0.0,171,50,36,38.89
1987,Comoros,12,0.0,171,52,0.0,172,64,0.0,172,40,17,135.29
1987,Tonga,6,0.0,175,48,0.0,173,54,0.0,173,42,35,20.0
1987,Cook Islands,7,0.0,174,32,0.0,174,39,0.0,174,25,21,19.05
1987,Guam,32,0.0,159,0,0.0,180,32,0.0,175,-32,-22,45.45
1987,Montserrat,4,0.0,176,25,0.0,175,29,0.0,176,21,19,10.53
1987,Kiribati,2,0.0,178,18,0.0,176,20,0.0,177,16,12,33.33
1987,Sao Tomé and Principe,4,0.0,176,14,0.0,177,18,0.0,178,10,8,25.0
1987,Tuvalu,0,0.0,179,4,0.0,178,4,0.0,179,4,3,33.33
1987,Niue,0,0.0,179,2,0.0,179,2,0.0,180,2,2,0.0
1986,United States of America,227158,10.62,2,382294,17.33,1,609452,14.03,1,155136,133648,16.08
1986,Germany,243326,11.38,1,190872,8.65,2,434198,9.99,2,-52454,-25445,106.15
1986,Japan,210757,9.86,3,127553,5.78,4,338310,7.79,3,-83204,-46676,78.26
1986,France,124948,5.84,4,129401,5.86,3,254349,5.85,4,4453,6577,-32.29
1986,United Kingdom,107093,5.01,5,126330,5.73,5,233423,5.37,5,19237,7705,149.67
1986,Italy,97204,4.55,6,99376,4.5,6,196580,4.52,6,2172,10975,-80.21
1986,U.S.S.R.,96940,4.53,7,88850,4.03,7,185790,4.28,7,-8090,-3865,109.31
1986,Canada,90329,4.22,8,85494,3.87,8,175823,4.05,8,-4835,-10310,-53.1
1986,Netherlands,80317,3.76,9,75536,3.42,9,155853,3.59,9,-4781,-3060,56.24
1986,Belgium-Luxembourg,68818,3.22,10,68603,3.11,10,137421,3.16,10,-215,2443,-108.8
1986,Switzerland,37455,1.75,12,41051,1.86,12,78506,1.81,11,3596,3263,10.21
1986,China,30942,1.45,16,42904,1.94,11,73846,1.7,12,11962,14902,-19.73
1986,"Hong Kong, China",36081,1.69,14,35942,1.63,13,72023,1.66,13,-139,1118,-112.43
1986,Sweden,37263,1.74,13,32693,1.48,15,69956,1.61,14,-4570,-1913,138.89
1986,"Korea, Republic of",34715,1.62,15,31585,1.43,16,66300,1.53,15,-3130,854,-466.51
1986,Chinese Taipei,39897,1.87,11,24236,1.1,20,64133,1.48,16,-15661,-10662,46.89
1986,Spain,27206,1.27,17,35057,1.59,14,62263,1.43,17,7851,5716,37.35
1986,Austria,22508,1.05,19,26863,1.22,17,49371,1.14,18,4355,3747,16.23
1986,Australia,22569,1.06,18,26104,1.18,18,48673,1.12,19,3535,3285,7.61
1986,Singapore,22495,1.05,20,25511,1.16,19,48006,1.11,20,3016,3473,-13.16
1986,Denmark,21286,1.0,23,22878,1.04,21,44164,1.02,21,1592,1156,37.72
1986,Mexico,21804,1.02,22,17573,0.8,24,39377,0.91,22,-4231,-7641,-44.63
1986,"Saudi Arabia, Kingdom of",20185,0.94,24,19112,0.87,23,39297,0.9,23,-1073,-3859,-72.19
1986,Norway,18092,0.85,26,20301,0.92,22,38393,0.88,24,2209,-4429,-149.88
1986,Brazil,22349,1.05,21,15557,0.71,25,37906,0.87,25,-6792,-11307,-39.93
1986,Finland,16356,0.76,27,15339,0.7,27,31695,0.73,26,-1017,-385,164.16
1986,South Africa,18385,0.86,25,12992,0.59,30,31377,0.72,27,-5393,-4974,8.42
1986,Bulgaria,14140,0.66,30,15200,0.69,28,29340,0.68,28,1060,320,231.25
1986,German Democratic Republic,14300,0.67,29,14200,0.64,29,28500,0.66,29,-100,-1400,-92.86
1986,Indonesia,16075,0.75,28,10718,0.49,40,26793,0.62,30,-5357,-8328,-35.67
1986,India,9399,0.44,38,15421,0.7,26,24820,0.57,31,6022,6788,-11.28
1986,Czech and Slovak Federal Republic,12240,0.57,33,12360,0.56,31,24600,0.57,32,120,-335,-135.82
1986,Malaysia,13690,0.64,31,10806,0.49,38,24496,0.56,33,-2884,-3063,-5.84
1986,Ireland,12658,0.59,32,11621,0.53,33,24279,0.56,34,-1037,-338,206.8
1986,Poland,12070,0.56,34,11205,0.51,36,23275,0.54,35,-865,-650,33.08
1986,"Yugoslavia, Socialist Federal Republic of",10353,0.48,36,11750,0.53,32,22103,0.51,36,1397,1507,-7.3
1986,Hungary,9170,0.43,39,9595,0.43,44,18765,0.43,37,425,-285,-249.12
1986,Türkiye,7457,0.35,45,11105,0.5,37,18562,0.43,38,3648,3386,7.74
1986,Thailand,8876,0.42,40,9178,0.42,46,18054,0.42,39,302,2121,-85.76
1986,Israel,7154,0.33,49,10806,0.49,38,17960,0.41,40,3652,3615,1.02
1986,Romania,9760,0.46,37,8080,0.37,49,17840,0.41,41,-1680,-1775,-5.35
1986,Iran,7171,0.34,48,10521,0.48,41,17692,0.41,42,3350,-2540,-231.89
1986,Iraq,7465,0.35,44,10190,0.46,42,17655,0.41,43,2725,147,1753.74
1986,"Venezuela, Bolivarian Republic of",8660,0.41,41,8504,0.39,48,17164,0.4,44,-156,-6332,-97.54
1986,United Arab Emirates,10640,0.5,35,6422,0.29,50,17062,0.39,45,-4218,-10231,-58.77
1986,Algeria,7832,0.37,43,9228,0.42,45,17060,0.39,46,1396,-3000,-146.53
1986,Greece,5648,0.26,53,11350,0.51,35,16998,0.39,47,5702,5595,1.91
1986,Portugal,7242,0.34,47,9649,0.44,43,16891,0.39,48,2407,1967,22.37
1986,Cuba,6298,0.29,51,9173,0.42,47,15471,0.36,49,2875,2000,43.75
1986,Egypt,2934,0.14,60,11502,0.52,34,14436,0.33,50,8568,7390,15.94
1986,"Kuwait, the State of",7383,0.35,46,5717,0.26,52,13100,0.3,51,-1666,-4592,-63.72
1986,Libya,8215,0.38,42,4445,0.2,56,12660,0.29,52,-3770,-8213,-54.1
1986,New Zealand,5880,0.28,52,6063,0.27,51,11943,0.27,53,183,272,-32.72
1986,Argentina,6852,0.32,50,4724,0.21,55,11576,0.27,54,-2128,-4582,-53.56
1986,Philippines,4806,0.22,56,5261,0.24,54,10067,0.23,55,455,844,-46.09
1986,Nigeria,5155,0.24,54,4034,0.18,57,9189,0.21,56,-1121,-3671,-69.46
1986,Colombia,5102,0.24,55,3862,0.18,58,8964,0.21,57,-1240,589,-310.53
1986,Pakistan,3384,0.16,58,5374,0.24,53,8758,0.2,58,1990,3150,-36.83
1986,Chile,4191,0.2,57,3436,0.16,60,7627,0.18,59,-755,-732,3.14
1986,Morocco,2433,0.11,64,3803,0.17,59,6236,0.14,60,1370,1685,-18.69
1986,Bahamas,2702,0.13,62,3289,0.15,61,5991,0.14,61,587,350,67.71
1986,Côte d'Ivoire,3354,0.16,59,2055,0.09,72,5409,0.12,62,-1299,-1448,-10.29
1986,Oman,2842,0.13,61,2565,0.12,64,5407,0.12,63,-277,-1608,-82.77
1986,Peru,2531,0.12,63,2391,0.11,68,4922,0.11,64,-140,-1212,-88.45
1986,Tunisia,1759,0.08,70,2890,0.13,62,4649,0.11,65,1131,1019,10.99
1986,"Bahrain, Kingdom of",2199,0.1,65,2405,0.11,67,4604,0.11,66,206,210,-1.9
1986,Syrian Arab Republic,1325,0.06,74,2728,0.12,63,4053,0.09,67,1403,2327,-39.71
1986,Ecuador,2172,0.1,66,1810,0.08,75,3982,0.09,68,-362,-1138,-68.19
1986,"Korea, Democratic People's Republic of",1628,0.08,71,2104,0.1,71,3732,0.09,69,476,462,3.03
1986,Bangladesh,880,0.04,88,2546,0.12,65,3426,0.08,70,1666,1543,7.97
1986,Dominican Republic,1312,0.06,75,2009,0.09,73,3321,0.08,71,697,559,24.69
1986,Jordan,733,0.03,96,2432,0.11,66,3165,0.07,72,1699,1944,-12.6
1986,Democratic Republic of the Congo,1844,0.09,68,1283,0.06,80,3127,0.07,73,-561,-606,-7.43
1986,Sri Lanka,1215,0.06,78,1857,0.08,74,3072,0.07,74,642,510,25.88
1986,Qatar,1849,0.09,67,1099,0.05,91,2948,0.07,75,-750,-2280,-67.11
1986,Viet Nam,789,0.04,92,2155,0.1,70,2944,0.07,76,1366,1159,17.86
1986,Kenya,1200,0.06,79,1613,0.07,77,2813,0.06,77,413,478,-13.6
1986,Lebanese Republic,550,0.03,103,2203,0.1,69,2753,0.06,78,1653,1915,-13.68
1986,Trinidad and Tobago,1386,0.06,72,1350,0.06,79,2736,0.06,79,-36,-605,-94.05
1986,Cameroon,782,0.04,93,1704,0.08,76,2486,0.06,80,922,429,114.92
1986,Brunei Darussalam,1797,0.08,69,656,0.03,114,2453,0.06,81,-1141,-2357,-51.59
1986,Zimbabwe,1302,0.06,76,1132,0.05,87,2434,0.06,82,-170,-81,109.88
1986,Angola,1332,0.06,73,1086,0.05,92,2418,0.06,83,-246,-844,-70.85
1986,Costa Rica,1121,0.05,80,1148,0.05,84,2269,0.05,84,27,122,-77.87
1986,Iceland,1099,0.05,81,1119,0.05,88,2218,0.05,85,20,90,-77.78
1986,Gabon,1271,0.06,77,866,0.04,107,2137,0.05,86,-405,-1096,-63.05
1986,Papua New Guinea,1033,0.05,85,1080,0.05,93,2113,0.05,87,47,96,-51.04
1986,Netherlands Antilles,924,0.04,87,1112,0.05,89,2036,0.05,88,188,357,-47.34
1986,Guatemala,1044,0.05,84,959,0.04,98,2003,0.05,89,-85,118,-172.03
1986,Uruguay,1088,0.05,82,870,0.04,106,1958,0.05,90,-218,-201,8.46
1986,Afghanistan,552,0.03,102,1404,0.06,78,1956,0.05,91,852,627,35.89
1986,"Macao, China",1046,0.05,83,879,0.04,103,1925,0.04,92,-167,-128,30.47
1986,Ghana,863,0.04,89,1046,0.05,94,1909,0.04,93,183,249,-26.51
1986,Namibia,977,0.05,86,886,0.04,102,1863,0.04,94,-91,-146,-37.67
1986,Mongolia,716,0.03,97,1139,0.05,85,1855,0.04,95,423,406,4.19
1986,Honduras,854,0.04,91,875,0.04,105,1729,0.04,96,21,108,-80.56
1986,Cyprus,451,0.02,108,1272,0.06,81,1723,0.04,97,821,771,6.49
1986,El Salvador,755,0.04,95,935,0.04,100,1690,0.04,98,180,282,-36.17
1986,Senegal,625,0.03,100,961,0.04,96,1586,0.04,99,336,264,27.27
1986,Panama,349,0.02,113,1229,0.06,82,1578,0.04,100,880,1056,-16.67
1986,Botswana,862,0.04,90,713,0.03,111,1575,0.04,101,-149,-148,0.68
1986,Jamaica,589,0.03,101,972,0.04,95,1561,0.04,102,383,545,-29.72
1986,Ethiopia,455,0.02,107,1102,0.05,90,1557,0.04,103,647,660,-1.97
1986,Malta,497,0.02,106,887,0.04,101,1384,0.03,104,390,359,8.64
1986,Congo,777,0.04,94,597,0.03,116,1374,0.03,105,-180,-489,-63.19
1986,Mauritius,662,0.03,98,676,0.03,112,1338,0.03,106,14,87,-83.91
1986,"Bolivia, Plurinational State of",638,0.03,99,674,0.03,113,1312,0.03,107,36,68,-47.06
1986,Tanzania,361,0.02,111,937,0.04,99,1298,0.03,108,576,1077,-46.52
1986,Sudan,333,0.02,116,961,0.04,96,1294,0.03,109,628,397,58.19
1986,Reunion,135,0.01,139,1137,0.05,86,1272,0.03,110,1002,744,34.68
1986,Yemen,8,0.0,173,1159,0.05,83,1167,0.03,111,1151,1300,-11.46
1986,Zambia,517,0.02,105,648,0.03,115,1165,0.03,112,131,-130,-200.77
1986,Nicaragua,247,0.01,126,857,0.04,108,1104,0.03,113,610,662,-7.85
1986,Martinique,209,0.01,130,879,0.04,103,1088,0.03,114,670,537,24.77
1986,Guinea,530,0.02,104,451,0.02,123,981,0.02,115,-79,-44,79.55
1986,Guadeloupe,109,0.01,140,793,0.04,109,902,0.02,116,684,572,19.58
1986,Barbados,275,0.01,122,587,0.03,117,862,0.02,117,312,255,22.35
1986,Paraguay,234,0.01,127,578,0.03,118,812,0.02,118,344,198,73.74
1986,French Polynesia,41,0.0,152,738,0.03,110,779,0.02,119,697,509,36.94
1986,"Yemen, People's Democratic Republic",290,0.01,120,483,0.02,120,773,0.02,120,193,760,-74.61
1986,Fiji,336,0.02,114,435,0.02,126,771,0.02,121,99,135,-26.67
1986,Uganda,436,0.02,109,307,0.01,139,743,0.02,122,-129,-60,115.0
1986,Niger,317,0.01,117,368,0.02,129,685,0.02,123,51,110,-53.64
1986,Madagascar,315,0.01,118,353,0.02,133,668,0.02,124,38,128,-70.31
1986,Liberia,408,0.02,110,259,0.01,143,667,0.02,125,-149,-152,-1.97
1986,Suriname,335,0.02,115,327,0.01,136,662,0.02,126,-8,-30,-73.33
1986,Mali,211,0.01,129,444,0.02,124,655,0.02,127,233,176,32.39
1986,New Caledonia,191,0.01,132,458,0.02,122,649,0.01,128,267,77,246.75
1986,Eswatini,280,0.01,121,352,0.02,134,632,0.01,129,72,145,-50.34
1986,Mozambique,79,0.0,145,543,0.02,119,622,0.01,130,464,347,33.72
1986,Greenland,260,0.01,123,360,0.02,130,620,0.01,131,100,122,-18.03
1986,Nepal,142,0.01,138,460,0.02,121,602,0.01,132,318,293,8.53
1986,Myanmar,291,0.01,119,307,0.01,139,598,0.01,133,16,-20,-180.0
1986,Mauritania,360,0.02,112,221,0.01,145,581,0.01,134,-139,-140,-0.71
1986,Benin,188,0.01,134,387,0.02,128,575,0.01,135,199,132,50.76
1986,American Samoa,254,0.01,124,313,0.01,137,567,0.01,136,59,95,-37.89
1986,Haiti,184,0.01,135,360,0.02,130,544,0.01,137,176,274,-35.77
1986,Rwanda,189,0.01,133,349,0.02,135,538,0.01,138,160,167,-4.19
1986,Togo,204,0.01,131,312,0.01,138,516,0.01,139,108,98,10.2
1986,Malawi,248,0.01,125,260,0.01,142,508,0.01,140,12,36,-66.67
1986,Bermuda,65,0.0,148,440,0.02,125,505,0.01,141,375,380,-1.32
1986,Burkina Faso,83,0.0,144,405,0.02,127,488,0.01,142,322,261,23.37
1986,Guyana,214,0.01,128,241,0.01,144,455,0.01,143,27,20,35.0
1986,Lesotho,26,0.0,158,354,0.02,132,380,0.01,144,328,320,2.5
1986,Burundi,154,0.01,136,202,0.01,149,356,0.01,145,48,77,-37.66
1986,French Guiana,37,0.0,153,298,0.01,141,335,0.01,146,261,220,18.64
1986,Chad,99,0.0,141,212,0.01,146,311,0.01,147,113,104,8.65
1986,Sierra Leone,144,0.01,137,132,0.01,155,276,0.01,148,-12,21,-157.14
1986,Saint Lucia,87,0.0,143,155,0.01,153,242,0.01,149,68,68,0.0
1986,Lao People's Democratic Republic,55,0.0,150,186,0.01,150,241,0.01,150,131,139,-5.76
1986,"Aruba, Netherlands with respect to",30,0.0,157,210,0.01,147,240,0.01,151,180,,
1986,Central African Republic,66,0.0,146,167,0.01,152,233,0.01,152,101,21,380.95
1986,Antigua and Barbuda,20,0.0,164,207,0.01,148,227,0.01,153,187,149,25.5
1986,Belize,93,0.0,142,122,0.01,156,215,0.0,154,29,38,-23.68
1986,Djibouti,20,0.0,164,184,0.01,151,204,0.0,155,164,187,-12.3
1986,Cambodia,21,0.0,163,140,0.01,154,161,0.0,156,119,100,19.0
1986,Saint Vincent and the Grenadines,64,0.0,149,87,0.0,161,151,0.0,157,23,16,43.75
1986,The Gambia,35,0.0,154,104,0.0,159,139,0.0,158,69,50,38.0
1986,Solomon Islands,66,0.0,146,72,0.0,163,138,0.0,159,6,13,-53.85
1986,Bhutan,34,0.0,155,93,0.0,160,127,0.0,160,59,62,-4.84
1986,Seychelles,18,0.0,167,106,0.0,158,124,0.0,161,88,71,23.94
1986,Grenada,31,0.0,156,84,0.0,162,115,0.0,162,53,46,15.22
1986,Cabo Verde,4,0.0,176,107,0.0,157,111,0.0,163,103,78,32.05
1986,Dominica,43,0.0,151,56,0.0,167,99,0.0,164,13,27,-51.85
1986,Saint Kitts and Nevis,24,0.0,160,63,0.0,164,87,0.0,165,39,33,18.18
1986,Equatorial Guinea,24,0.0,160,52,0.0,168,76,0.0,166,28,3,833.33
1986,Vanuatu,17,0.0,168,58,0.0,166,75,0.0,167,41,39,5.13
1986,Maldives,25,0.0,159,45,0.0,171,70,0.0,168,20,30,-33.33
1986,Guinea-Bissau,10,0.0,171,60,0.0,165,70,0.0,168,50,48,4.17
1986,Saint Pierre and Miquelon,16,0.0,169,51,0.0,169,67,0.0,170,35,33,6.06
1986,Samoa,11,0.0,170,47,0.0,170,58,0.0,171,36,35,2.86
1986,Comoros,20,0.0,164,37,0.0,173,57,0.0,172,17,20,-15.0
1986,Tonga,6,0.0,174,41,0.0,172,47,0.0,173,35,36,-2.78
1986,Cook Islands,5,0.0,175,26,0.0,174,31,0.0,174,21,22,-4.55
1986,Sao Tomé and Principe,9,0.0,172,17,0.0,176,26,0.0,175,8,4,100.0
1986,Montserrat,2,0.0,177,21,0.0,175,23,0.0,176,19,15,26.67
1986,Guam,22,0.0,162,0,0.0,180,22,0.0,177,-22,-13,69.23
1986,Kiribati,2,0.0,177,14,0.0,177,16,0.0,178,12,11,9.09
1986,Tuvalu,0,0.0,179,3,0.0,178,3,0.0,179,3,3,0.0
1986,Niue,0,0.0,179,2,0.0,179,2,0.0,180,2,2,0.0
1985,United States of America,218815,11.21,1,352463,17.5,1,571278,14.4,1,133648,122387,9.2
1985,Germany,183933,9.42,2,158488,7.87,2,342421,8.63,2,-25445,-18713,35.97
1985,Japan,177164,9.07,3,130488,6.48,3,307652,7.76,3,-46676,-33524,39.23
1985,United Kingdom,101252,5.19,5,108957,5.41,4,210209,5.3,4,7705,10844,-28.95
1985,France,101674,5.21,4,108251,5.37,5,209925,5.29,5,6577,6796,-3.22
1985,Canada,90950,4.66,6,80640,4.0,8,171590,4.33,6,-10310,-12483,-17.41
1985,U.S.S.R.,86780,4.44,7,82915,4.12,7,169695,4.28,7,-3865,-11035,-64.98
1985,Italy,76717,3.93,8,87692,4.35,6,164409,4.14,8,10975,10598,3.56
1985,Netherlands,68257,3.5,9,65197,3.24,9,133454,3.36,9,-3060,-3382,-9.52
1985,Belgium-Luxembourg,53739,2.75,10,56182,2.79,10,109921,2.77,10,2443,3566,-31.49
1985,China,27350,1.4,17,42252,2.1,11,69602,1.75,11,14902,1271,1072.46
1985,"Korea, Republic of",30282,1.55,13,31136,1.55,13,61418,1.55,12,854,1386,-38.38
1985,"Hong Kong, China",30077,1.54,14,31195,1.55,12,61272,1.54,13,1118,2107,-46.94
1985,Sweden,30461,1.56,12,28548,1.42,16,59009,1.49,14,-1913,-2952,-35.2
1985,Switzerland,27433,1.41,16,30696,1.52,14,58129,1.47,15,3263,3671,-11.11
1985,Spain,24247,1.24,20,29963,1.49,15,54210,1.37,16,5716,5323,7.38
1985,"Saudi Arabia, Kingdom of",27481,1.41,15,23622,1.17,19,51103,1.29,17,-3859,-3849,0.26
1985,Chinese Taipei,30784,1.58,11,20122,1.0,21,50906,1.28,18,-10662,-8554,24.64
1985,Singapore,22812,1.17,21,26285,1.3,17,49097,1.24,19,3473,4597,-24.45
1985,Australia,22604,1.16,22,25889,1.29,18,48493,1.22,20,3285,2808,16.99
1985,Mexico,26757,1.37,18,19116,0.95,22,45873,1.16,21,-7641,-12410,-38.43
1985,Brazil,25639,1.31,19,14332,0.71,26,39971,1.01,22,-11307,-11795,-4.14
1985,Austria,17239,0.88,25,20986,1.04,20,38225,0.96,23,3747,3890,-3.68
1985,Norway,19985,1.02,23,15556,0.77,25,35541,0.9,24,-4429,-5001,-11.44
1985,Denmark,17089,0.88,26,18245,0.91,23,35334,0.89,25,1156,633,82.62
1985,German Democratic Republic,15200,0.78,30,13800,0.69,27,29000,0.73,26,-1400,-2470,-43.32
1985,Indonesia,18590,0.95,24,10262,0.51,39,28852,0.73,27,-8328,-8020,3.84
1985,South Africa,16293,0.83,28,11319,0.56,34,27612,0.7,28,-4974,-1208,311.75
1985,Malaysia,15316,0.78,29,12253,0.61,30,27569,0.69,29,-3063,-2432,25.95
1985,Bulgaria,13310,0.68,34,13630,0.68,28,26940,0.68,30,320,-140,-328.57
1985,Finland,13617,0.7,33,13232,0.66,29,26849,0.68,31,-385,-1039,-62.95
1985,Iran,14175,0.73,32,11635,0.58,32,25810,0.65,32,-2540,-1717,47.93
1985,India,9140,0.47,45,15928,0.79,24,25068,0.63,33,6788,5821,16.61
1985,United Arab Emirates,16780,0.86,27,6549,0.33,51,23329,0.59,34,-10231,-9564,6.97
1985,"Yugoslavia, Socialist Federal Republic of",10700,0.55,39,12207,0.61,31,22907,0.58,35,1507,1742,-13.49
1985,Algeria,12841,0.66,35,9841,0.49,43,22682,0.57,36,-3000,-2507,19.66
1985,"Venezuela, Bolivarian Republic of",14438,0.74,31,8106,0.4,48,22544,0.57,37,-6332,-8223,-23.0
1985,Poland,11490,0.59,38,10840,0.54,36,22330,0.56,38,-650,-1110,-41.44
1985,Nigeria,12548,0.64,36,8877,0.44,45,21425,0.54,39,-3671,-2492,47.31
1985,Czech and Slovak Federal Republic,10660,0.55,40,10325,0.51,38,20985,0.53,40,-335,-70,378.57
1985,Iraq,10409,0.53,42,10556,0.52,37,20965,0.53,41,147,1761,-91.65
1985,Ireland,10358,0.53,43,10020,0.5,41,20378,0.51,42,-338,33,-1124.24
1985,Türkiye,7958,0.41,48,11344,0.56,33,19302,0.49,43,3386,3623,-6.54
1985,Romania,10175,0.52,44,8400,0.42,46,18575,0.47,44,-1775,-3160,-43.83
1985,Hungary,8470,0.43,46,8185,0.41,47,16655,0.42,45,-285,-490,-41.84
1985,"Kuwait, the State of",10597,0.54,41,6005,0.3,52,16602,0.42,46,-4592,-4727,-2.86
1985,Libya,12314,0.63,37,4101,0.2,57,16415,0.41,47,-8213,-4926,66.73
1985,Thailand,7121,0.36,49,9242,0.46,44,16363,0.41,48,2121,2985,-28.94
1985,Israel,6260,0.32,50,9875,0.49,42,16135,0.41,49,3615,4012,-9.9
1985,Egypt,3714,0.19,58,11104,0.55,35,14818,0.37,50,7390,7626,-3.09
1985,Greece,4539,0.23,56,10134,0.5,40,14673,0.37,51,5595,4619,21.13
1985,Cuba,5983,0.31,51,7983,0.4,49,13966,0.35,52,2000,1954,2.35
1985,Portugal,5685,0.29,53,7652,0.38,50,13337,0.34,53,1967,2761,-28.76
1985,Argentina,8396,0.43,47,3814,0.19,60,12210,0.31,54,-4582,-3522,30.1
1985,New Zealand,5720,0.29,52,5992,0.3,53,11712,0.3,55,272,685,-60.29
1985,Philippines,4611,0.24,55,5455,0.27,55,10066,0.25,56,844,1158,-27.12
1985,Pakistan,2740,0.14,66,5890,0.29,54,8630,0.22,57,3150,3295,-4.4
1985,Oman,4972,0.25,54,3364,0.17,61,8336,0.21,58,-1608,-1489,7.99
1985,Colombia,3552,0.18,59,4141,0.21,56,7693,0.19,59,589,1036,-43.15
1985,Chile,3804,0.19,57,3072,0.15,64,6876,0.17,60,-732,-77,850.65
1985,Morocco,2165,0.11,69,3850,0.19,59,6015,0.15,61,1685,1740,-3.16
1985,"Bahrain, Kingdom of",2897,0.15,65,3107,0.15,62,6004,0.15,62,210,276,-23.91
1985,Bahamas,2728,0.14,67,3078,0.15,63,5806,0.15,63,350,705,-50.35
1985,Syrian Arab Republic,1640,0.08,74,3967,0.2,58,5607,0.14,64,2327,2263,2.83
1985,Côte d'Ivoire,3197,0.16,61,1749,0.09,75,4946,0.12,65,-1448,-1210,19.67
1985,Peru,2979,0.15,62,1767,0.09,73,4746,0.12,66,-1212,-1266,-4.27
1985,Ecuador,2905,0.15,64,1767,0.09,73,4672,0.12,67,-1138,-1004,13.35
1985,Qatar,3419,0.18,60,1139,0.06,89,4558,0.11,68,-2280,-3351,-31.96
1985,Tunisia,1738,0.09,73,2757,0.14,65,4495,0.11,69,1019,1380,-26.16
1985,Trinidad and Tobago,2139,0.11,70,1534,0.08,76,3673,0.09,70,-605,-254,138.19
1985,Angola,2245,0.11,68,1401,0.07,78,3646,0.09,71,-844,-777,8.62
1985,Brunei Darussalam,2972,0.15,63,615,0.03,112,3587,0.09,72,-2357,-2578,-8.57
1985,Bangladesh,999,0.05,82,2542,0.13,67,3541,0.09,73,1543,1894,-18.53
1985,Jordan,789,0.04,89,2733,0.14,66,3522,0.09,74,1944,2032,-4.33
1985,Sri Lanka,1333,0.07,75,1843,0.09,70,3176,0.08,75,510,400,27.5
1985,"Korea, Democratic People's Republic of",1325,0.07,76,1787,0.09,71,3112,0.08,76,462,500,-7.6
1985,Democratic Republic of the Congo,1853,0.09,72,1247,0.06,84,3100,0.08,77,-606,-752,-19.41
1985,Dominican Republic,1228,0.06,77,1787,0.09,71,3015,0.08,78,559,391,42.97
1985,Gabon,1951,0.1,71,855,0.04,101,2806,0.07,79,-1096,-1287,-14.84
1985,Viet Nam,698,0.04,95,1857,0.09,69,2555,0.06,80,1159,1096,5.75
1985,Lebanese Republic,288,0.01,120,2203,0.11,68,2491,0.06,81,1915,2570,-25.49
1985,Netherlands Antilles,1031,0.05,81,1388,0.07,80,2419,0.06,82,357,299,19.4
1985,Kenya,958,0.05,84,1436,0.07,77,2394,0.06,83,478,395,21.01
1985,Guatemala,1057,0.05,80,1175,0.06,87,2232,0.06,84,118,150,-21.33
1985,Zimbabwe,1112,0.06,78,1031,0.05,93,2143,0.05,85,-81,-57,42.11
1985,Costa Rica,976,0.05,83,1098,0.05,91,2074,0.05,86,122,88,38.64
1985,Papua New Guinea,912,0.05,85,1008,0.05,94,1920,0.05,87,96,218,-55.96
1985,Cameroon,722,0.04,94,1151,0.06,88,1873,0.05,88,429,226,89.82
1985,"Yemen, People's Democratic Republic",550,0.03,103,1310,0.07,83,1860,0.05,89,760,898,-15.37
1985,Mongolia,689,0.04,96,1095,0.05,92,1784,0.04,90,406,301,34.88
1985,Afghanistan,567,0.03,100,1194,0.06,86,1761,0.04,91,627,757,-17.17
1985,Panama,336,0.02,113,1392,0.07,79,1728,0.04,92,1056,1147,-7.93
1985,Cyprus,476,0.02,105,1247,0.06,84,1723,0.04,93,771,791,-2.53
1985,Iceland,815,0.04,88,905,0.04,98,1720,0.04,94,90,102,-11.76
1985,Congo,1087,0.06,79,598,0.03,114,1685,0.04,95,-489,-565,-13.45
1985,"Macao, China",906,0.05,87,778,0.04,104,1684,0.04,96,-128,-118,8.47
1985,Jamaica,566,0.03,101,1111,0.06,90,1677,0.04,97,545,441,23.58
1985,Honduras,780,0.04,91,888,0.04,99,1668,0.04,98,108,168,-35.71
1985,El Salvador,679,0.03,97,961,0.05,97,1640,0.04,99,282,260,8.46
1985,Uruguay,909,0.05,86,708,0.04,107,1617,0.04,100,-201,-157,28.03
1985,Tanzania,247,0.01,125,1324,0.07,81,1571,0.04,101,1077,367,193.46
1985,Ghana,617,0.03,99,866,0.04,100,1483,0.04,102,249,80,211.25
1985,Zambia,784,0.04,90,654,0.03,110,1438,0.04,103,-130,78,-266.67
1985,Senegal,562,0.03,102,826,0.04,103,1388,0.03,104,264,347,-23.92
1985,Ethiopia,333,0.02,114,993,0.05,95,1326,0.03,105,660,525,25.71
1985,Yemen,13,0.0,168,1313,0.07,82,1326,0.03,105,1300,1540,-15.58
1985,"Bolivia, Plurinational State of",623,0.03,98,691,0.03,108,1314,0.03,107,68,-236,-128.81
1985,Botswana,728,0.04,92,580,0.03,116,1308,0.03,108,-148,37,-500.0
1985,Namibia,727,0.04,93,581,0.03,115,1308,0.03,108,-146,52,-380.77
1985,Nicaragua,302,0.02,119,964,0.05,96,1266,0.03,110,662,462,43.29
1985,Malta,400,0.02,108,759,0.04,106,1159,0.03,111,359,323,11.15
1985,Sudan,374,0.02,110,771,0.04,105,1145,0.03,112,397,518,-23.36
1985,Barbados,352,0.02,112,607,0.03,113,959,0.02,113,255,267,-4.49
1985,Mauritius,436,0.02,106,523,0.03,118,959,0.02,113,87,99,-12.12
1985,Guinea,492,0.03,104,448,0.02,121,940,0.02,115,-44,-79,-44.3
1985,Reunion,97,0.0,139,841,0.04,102,938,0.02,116,744,711,4.64
1985,Martinique,145,0.01,134,682,0.03,109,827,0.02,117,537,532,0.94
1985,Paraguay,304,0.02,118,502,0.02,119,806,0.02,118,198,251,-21.12
1985,Fiji,307,0.02,116,442,0.02,122,749,0.02,119,135,118,14.41
1985,Guadeloupe,75,0.0,143,647,0.03,111,722,0.02,120,572,513,11.5
1985,Liberia,436,0.02,106,284,0.01,142,720,0.02,121,-152,-89,70.79
1985,Uganda,387,0.02,109,327,0.02,132,714,0.02,122,-60,-55,9.09
1985,Madagascar,274,0.01,121,402,0.02,126,676,0.02,123,128,32,300.0
1985,Niger,259,0.01,123,369,0.02,127,628,0.02,124,110,29,279.31
1985,Suriname,329,0.02,115,299,0.01,134,628,0.02,124,-30,-10,200.0
1985,New Caledonia,271,0.01,122,348,0.02,128,619,0.02,126,77,104,-25.96
1985,Nepal,160,0.01,133,453,0.02,120,613,0.02,127,293,290,1.03
1985,Haiti,168,0.01,132,442,0.02,122,610,0.02,128,274,271,1.11
1985,Mauritania,374,0.02,110,234,0.01,144,608,0.02,129,-140,-83,68.67
1985,Myanmar,306,0.02,117,286,0.01,140,592,0.01,130,-20,-63,-68.25
1985,French Polynesia,40,0.0,151,549,0.03,117,589,0.01,131,509,507,0.39
1985,Malawi,249,0.01,124,285,0.01,141,534,0.01,132,36,-43,-183.72
1985,Benin,199,0.01,128,331,0.02,131,530,0.01,133,132,121,9.09
1985,Eswatini,179,0.01,130,324,0.02,133,503,0.01,134,145,207,-29.95
1985,Mozambique,77,0.0,142,424,0.02,124,501,0.01,135,347,444,-21.85
1985,American Samoa,201,0.01,127,296,0.01,137,497,0.01,136,95,72,31.94
1985,Togo,190,0.01,129,288,0.01,139,478,0.01,137,98,79,24.05
1985,Greenland,174,0.01,131,296,0.01,137,470,0.01,138,122,105,16.19
1985,Guyana,206,0.01,126,226,0.01,145,432,0.01,139,20,3,566.67
1985,Rwanda,131,0.01,135,298,0.01,136,429,0.01,140,167,133,25.56
1985,Bermuda,23,0.0,156,403,0.02,125,426,0.01,141,380,373,1.88
1985,Mali,123,0.01,137,299,0.01,134,422,0.01,142,176,147,19.73
1985,Burkina Faso,71,0.0,144,332,0.02,130,403,0.01,143,261,174,50.0
1985,Lesotho,23,0.0,156,343,0.02,129,366,0.01,144,320,412,-22.33
1985,Burundi,112,0.01,138,189,0.01,148,301,0.01,145,77,83,-7.23
1985,French Guiana,37,0.0,152,257,0.01,143,294,0.01,146,220,211,4.27
1985,Sierra Leone,130,0.01,136,151,0.01,151,281,0.01,147,21,24,-12.5
1985,Lao People's Democratic Republic,54,0.0,149,193,0.01,147,247,0.01,148,139,118,17.8
1985,Chad,62,0.0,147,166,0.01,149,228,0.01,149,104,50,108.0
1985,Belize,90,0.0,141,128,0.01,152,218,0.01,150,38,37,2.7
1985,Djibouti,14,0.0,167,201,0.01,146,215,0.01,151,187,209,-10.53
1985,Central African Republic,92,0.0,140,113,0.01,155,205,0.01,152,21,1,2000.0
1985,Antigua and Barbuda,17,0.0,163,166,0.01,149,183,0.0,153,149,114,30.7
1985,Saint Lucia,57,0.0,148,125,0.01,153,182,0.0,154,68,70,-2.86
1985,Solomon Islands,70,0.0,145,83,0.0,160,153,0.0,155,13,-14,-192.86
1985,Saint Vincent and the Grenadines,63,0.0,146,79,0.0,161,142,0.0,156,16,23,-30.43
1985,Cambodia,20,0.0,161,120,0.01,154,140,0.0,157,100,162,-38.27
1985,The Gambia,43,0.0,150,93,0.0,157,136,0.0,158,50,51,-1.96
1985,Seychelles,28,0.0,154,99,0.0,156,127,0.0,159,71,62,14.52
1985,Bhutan,22,0.0,160,84,0.0,158,106,0.0,160,62,55,12.73
1985,Vanuatu,31,0.0,153,70,0.0,162,101,0.0,161,39,25,56.0
1985,Grenada,23,0.0,156,69,0.0,163,92,0.0,162,46,38,21.05
1985,Cabo Verde,6,0.0,172,84,0.0,158,90,0.0,163,78,80,-2.5
1985,Dominica,28,0.0,154,55,0.0,165,83,0.0,164,27,32,-15.63
1985,Maldives,23,0.0,156,53,0.0,166,76,0.0,165,30,35,-14.29
1985,Guinea-Bissau,12,0.0,170,60,0.0,164,72,0.0,166,48,31,54.84
1985,Saint Kitts and Nevis,18,0.0,162,51,0.0,167,69,0.0,167,33,33,0.0
1985,Samoa,16,0.0,165,51,0.0,167,67,0.0,168,35,30,16.67
1985,Comoros,16,0.0,165,36,0.0,171,52,0.0,169,20,36,-44.44
1985,Saint Pierre and Miquelon,7,0.0,171,40,0.0,170,47,0.0,170,33,36,-8.33
1985,Tonga,5,0.0,174,41,0.0,169,46,0.0,171,36,32,12.5
1985,Equatorial Guinea,17,0.0,163,20,0.0,173,37,0.0,172,3,3,0.0
1985,Cook Islands,3,0.0,176,25,0.0,172,28,0.0,173,22,17,29.41
1985,Montserrat,3,0.0,176,18,0.0,174,21,0.0,174,15,11,36.36
1985,Kiribati,4,0.0,175,15,0.0,175,19,0.0,175,11,7,57.14
1985,Sao Tomé and Principe,6,0.0,172,10,0.0,176,16,0.0,176,4,3,33.33
1985,Guam,13,0.0,168,0,0.0,179,13,0.0,177,-13,-92,-85.87
1985,Tuvalu,0,0.0,178,3,0.0,177,3,0.0,178,3,4,-25.0
1985,Niue,0,0.0,178,2,0.0,178,2,0.0,179,2,2,0.0
1984,United States of America,223976,11.45,1,346363,17.19,1,570339,14.37,1,122387,64239,90.52
1984,Germany,171735,8.78,2,153022,7.6,2,324757,8.18,2,-18713,-16540,13.14
1984,Japan,169700,8.68,3,136176,6.76,3,305876,7.7,3,-33524,-20528,63.31
1984,France,97566,4.99,4,104362,5.18,5,201928,5.09,4,6796,10964,-38.02
1984,United Kingdom,93881,4.8,5,104725,5.2,4,198606,5.0,5,10844,8461,28.16
1984,U.S.S.R.,91150,4.66,6,80115,3.98,7,171265,4.31,6,-11035,-11180,-1.3
1984,Canada,90272,4.62,7,77789,3.86,8,168061,4.23,7,-12483,-11960,4.37
1984,Italy,74564,3.81,8,85162,4.23,6,159726,4.02,8,10598,6931,52.91
1984,Netherlands,65677,3.36,9,62295,3.09,9,127972,3.22,9,-3382,-3032,11.54
1984,Belgium-Luxembourg,51893,2.65,10,55459,2.75,10,107352,2.7,10,3566,3374,5.69
1984,"Saudi Arabia, Kingdom of",37545,1.92,11,33696,1.67,11,71241,1.79,11,-3849,-6664,-42.24
1984,"Korea, Republic of",29245,1.5,14,30631,1.52,12,59876,1.51,12,1386,1746,-20.62
1984,"Hong Kong, China",28337,1.45,16,30444,1.51,13,58781,1.48,13,2107,1955,7.77
1984,Sweden,29378,1.5,13,26426,1.31,18,55804,1.41,14,-2952,-1348,118.99
1984,Switzerland,25851,1.32,19,29522,1.47,14,55373,1.39,15,3671,3600,1.97
1984,China,26139,1.34,18,27410,1.36,17,53549,1.35,16,1271,-836,-252.03
1984,Singapore,24070,1.23,21,28667,1.42,16,52737,1.33,17,4597,6325,-27.32
1984,Chinese Taipei,30547,1.56,12,21993,1.09,21,52540,1.32,18,-8554,-4864,75.86
1984,Spain,23508,1.2,22,28831,1.43,15,52339,1.32,19,5323,9459,-43.73
1984,Australia,23111,1.18,23,25919,1.29,19,49030,1.23,20,2808,1345,108.77
1984,German Democratic Republic,25410,1.3,20,22940,1.14,20,48350,1.22,21,-2470,-3005,-17.8
1984,Mexico,29101,1.49,15,16691,0.83,24,45792,1.15,22,-12410,-13477,-7.92
1984,Brazil,27005,1.38,17,15210,0.75,29,42215,1.06,23,-11795,-5098,131.37
1984,Indonesia,21902,1.12,24,13882,0.69,32,35784,0.9,24,-8020,-4800,67.08
1984,Austria,15739,0.8,33,19629,0.97,22,35368,0.89,25,3890,3996,-2.65
1984,Czech and Slovak Federal Republic,17200,0.88,26,17130,0.85,23,34330,0.86,26,-70,-130,-46.15
1984,South Africa,17163,0.88,27,15955,0.79,26,33118,0.83,27,-1208,-2695,-55.18
1984,Norway,18886,0.97,25,13885,0.69,31,32771,0.83,28,-5001,-4501,11.11
1984,Denmark,15980,0.82,32,16613,0.82,25,32593,0.82,29,633,213,197.18
1984,Iran,17087,0.87,28,15370,0.76,27,32457,0.82,30,-1717,-3187,-46.12
1984,Malaysia,16483,0.84,30,14051,0.7,30,30534,0.77,31,-2432,-842,188.84
1984,Finland,13472,0.69,34,12433,0.62,34,25905,0.65,32,-1039,308,-437.34
1984,Bulgaria,12860,0.66,35,12720,0.63,33,25580,0.64,33,-140,150,-193.33
1984,India,9451,0.48,44,15272,0.76,28,24723,0.62,34,5821,4913,18.48
1984,"Venezuela, Bolivarian Republic of",15997,0.82,31,7774,0.39,49,23771,0.6,35,-8223,-7518,9.38
1984,United Arab Emirates,16500,0.84,29,6936,0.34,51,23436,0.59,36,-9564,-8606,11.13
1984,Algeria,12795,0.65,36,10288,0.51,41,23083,0.58,37,-2507,-2184,14.79
1984,Poland,11760,0.6,38,10650,0.53,39,22410,0.56,38,-1110,-980,13.27
1984,"Yugoslavia, Socialist Federal Republic of",10254,0.52,42,11996,0.6,35,22250,0.56,39,1742,2240,-22.23
1984,Nigeria,11856,0.61,37,9364,0.46,45,21220,0.53,40,-2492,1897,-231.37
1984,Iraq,9317,0.48,45,11078,0.55,36,20395,0.51,41,1761,4005,-56.03
1984,Ireland,9642,0.49,43,9675,0.48,43,19317,0.49,42,33,567,-94.18
1984,"Kuwait, the State of",11623,0.59,39,6896,0.34,52,18519,0.47,43,-4727,-4131,14.43
1984,Romania,10720,0.55,41,7560,0.38,50,18280,0.46,44,-3160,-2520,25.4
1984,Türkiye,7134,0.36,49,10757,0.53,38,17891,0.45,45,3623,3507,3.31
1984,Thailand,7413,0.38,48,10398,0.52,40,17811,0.45,46,2985,3919,-23.83
1984,Libya,11148,0.57,40,6222,0.31,54,17370,0.44,47,-4926,-6187,-20.38
1984,Hungary,8620,0.44,46,8130,0.4,47,16750,0.42,48,-490,-215,127.91
1984,Israel,5807,0.3,51,9819,0.49,42,15626,0.39,49,4012,4466,-10.17
1984,Cuba,6213,0.32,50,8167,0.41,46,14380,0.36,50,1954,779,150.83
1984,Greece,4816,0.25,55,9435,0.47,44,14251,0.36,51,4619,5087,-9.2
1984,Egypt,3140,0.16,65,10766,0.53,37,13906,0.35,52,7626,7060,8.02
1984,Portugal,5200,0.27,54,7961,0.4,48,13161,0.33,53,2761,3641,-24.17
1984,Argentina,8107,0.41,47,4585,0.23,57,12692,0.32,54,-3522,-3332,5.7
1984,New Zealand,5518,0.28,52,6203,0.31,55,11721,0.3,55,685,-81,-945.68
1984,Philippines,5274,0.27,53,6432,0.32,53,11706,0.29,56,1158,3086,-62.48
1984,Pakistan,2558,0.13,68,5853,0.29,56,8411,0.21,57,3295,2252,46.31
1984,Colombia,3462,0.18,60,4498,0.22,58,7960,0.2,58,1036,1962,-47.2
1984,Netherlands Antilles,3733,0.19,58,4032,0.2,61,7765,0.2,59,299,118,153.39
1984,Bahamas,3393,0.17,61,4098,0.2,60,7491,0.19,60,705,646,9.13
1984,Oman,4422,0.23,57,2933,0.15,67,7355,0.19,61,-1489,-1625,-8.37
1984,Chile,3651,0.19,59,3574,0.18,63,7225,0.18,62,-77,-746,-89.68
1984,"Bahrain, Kingdom of",3204,0.16,62,3480,0.17,64,6684,0.17,63,276,143,93.01
1984,Morocco,2171,0.11,70,3911,0.19,62,6082,0.15,64,1740,1586,9.71
1984,Syrian Arab Republic,1853,0.09,74,4116,0.2,59,5969,0.15,65,2263,2619,-13.59
1984,Qatar,4513,0.23,56,1162,0.06,87,5675,0.14,66,-3351,-1901,76.28
1984,Peru,3147,0.16,64,1881,0.09,71,5028,0.13,67,-1266,-781,62.1
1984,Tunisia,1794,0.09,75,3174,0.16,65,4968,0.13,68,1380,1257,9.79
1984,Ecuador,2620,0.13,67,1616,0.08,76,4236,0.11,69,-1004,-861,16.61
1984,Côte d'Ivoire,2706,0.14,66,1496,0.07,79,4202,0.11,70,-1210,-251,382.07
1984,Trinidad and Tobago,2173,0.11,69,1919,0.1,70,4092,0.1,71,-254,229,-210.92
1984,Brunei Darussalam,3204,0.16,62,626,0.03,112,3830,0.1,72,-2578,-2645,-2.53
1984,Bangladesh,931,0.05,85,2825,0.14,68,3756,0.09,73,1894,1441,31.44
1984,Jordan,752,0.04,90,2784,0.14,69,3536,0.09,74,2032,2456,-17.26
1984,Sri Lanka,1467,0.08,76,1867,0.09,72,3334,0.08,75,400,757,-47.16
1984,Lebanese Republic,378,0.02,113,2948,0.15,66,3326,0.08,76,2570,2901,-11.41
1984,Angola,2033,0.1,71,1256,0.06,85,3289,0.08,77,-777,-839,-7.39
1984,Democratic Republic of the Congo,1928,0.1,73,1176,0.06,86,3104,0.08,78,-752,-473,58.99
1984,"Korea, Democratic People's Republic of",1200,0.06,78,1700,0.08,74,2900,0.07,79,500,400,25.0
1984,Dominican Republic,1254,0.06,77,1645,0.08,75,2899,0.07,80,391,616,-36.53
1984,Gabon,2011,0.1,72,724,0.04,106,2735,0.07,81,-1287,-1315,-2.13
1984,Kenya,1074,0.05,82,1469,0.07,80,2543,0.06,82,395,465,-15.05
1984,Guatemala,1129,0.06,81,1279,0.06,84,2408,0.06,83,150,-33,-554.55
1984,Viet Nam,649,0.03,99,1745,0.09,73,2394,0.06,84,1096,910,20.44
1984,Zimbabwe,1155,0.06,80,1098,0.05,92,2253,0.06,85,-57,70,-181.43
1984,"Yemen, People's Democratic Republic",645,0.03,100,1543,0.08,78,2188,0.06,86,898,809,11.0
1984,Costa Rica,1006,0.05,83,1094,0.05,93,2100,0.05,87,88,115,-23.48
1984,Afghanistan,633,0.03,102,1390,0.07,82,2023,0.05,88,757,335,125.97
1984,Papua New Guinea,892,0.05,87,1110,0.06,91,2002,0.05,89,218,307,-28.99
1984,Cameroon,886,0.05,88,1112,0.06,90,1998,0.05,90,226,248,-8.87
1984,Cyprus,573,0.03,104,1364,0.07,83,1937,0.05,91,791,716,10.47
1984,Jamaica,705,0.04,95,1146,0.06,89,1851,0.05,92,441,776,-43.17
1984,Congo,1183,0.06,79,618,0.03,113,1801,0.05,93,-565,8,-7162.5
1984,Sudan,629,0.03,103,1147,0.06,88,1776,0.04,94,518,730,-29.04
1984,Uruguay,934,0.05,84,777,0.04,104,1711,0.04,95,-157,-257,-38.91
1984,"Macao, China",913,0.05,86,795,0.04,102,1708,0.04,96,-118,-36,227.78
1984,Panama,276,0.01,123,1423,0.07,81,1699,0.04,97,1147,1092,5.04
1984,El Salvador,717,0.04,94,977,0.05,95,1694,0.04,98,260,156,66.67
1984,Mongolia,674,0.03,96,975,0.05,96,1649,0.04,99,301,318,-5.35
1984,Honduras,725,0.04,92,893,0.04,98,1618,0.04,100,168,131,28.24
1984,Senegal,634,0.03,101,981,0.05,94,1615,0.04,101,347,407,-14.74
1984,Namibia,766,0.04,89,818,0.04,101,1584,0.04,102,52,75,-30.67
1984,Iceland,739,0.04,91,841,0.04,100,1580,0.04,103,102,78,30.77
1984,Yemen,16,0.0,167,1556,0.08,77,1572,0.04,104,1540,1591,-3.21
1984,Zambia,652,0.03,98,730,0.04,105,1382,0.03,105,78,15,420.0
1984,Ethiopia,417,0.02,108,942,0.05,97,1359,0.03,106,525,472,11.23
1984,Botswana,660,0.03,97,697,0.03,108,1357,0.03,107,37,100,-63.0
1984,Nicaragua,386,0.02,112,848,0.04,99,1234,0.03,108,462,397,16.37
1984,"Bolivia, Plurinational State of",725,0.04,92,489,0.02,119,1214,0.03,109,-236,-178,32.58
1984,Ghana,528,0.03,105,608,0.03,114,1136,0.03,110,80,90,-11.11
1984,Malta,394,0.02,110,717,0.04,107,1111,0.03,111,323,370,-12.7
1984,Barbados,390,0.02,111,657,0.03,111,1047,0.03,112,267,295,-9.49
1984,Tanzania,298,0.02,121,665,0.03,110,963,0.02,113,367,468,-21.58
1984,Guinea,517,0.03,106,438,0.02,125,955,0.02,114,-79,-221,-64.25
1984,Paraguay,335,0.02,116,586,0.03,116,921,0.02,115,251,277,-9.39
1984,Reunion,80,0.0,146,791,0.04,103,871,0.02,116,711,761,-6.57
1984,Mauritius,372,0.02,114,471,0.02,120,843,0.02,117,99,75,32.0
1984,Martinique,154,0.01,133,686,0.03,109,840,0.02,118,532,573,-7.16
1984,Liberia,452,0.02,107,363,0.02,129,815,0.02,119,-89,-16,456.25
1984,Fiji,332,0.02,118,450,0.02,121,782,0.02,120,118,178,-33.71
1984,Uganda,399,0.02,109,344,0.02,131,743,0.02,121,-55,5,-1200.0
1984,Suriname,356,0.02,115,346,0.02,130,702,0.02,122,-10,105,-109.52
1984,Madagascar,334,0.02,117,366,0.02,128,700,0.02,123,32,124,-74.19
1984,Eswatini,240,0.01,125,447,0.02,123,687,0.02,124,207,247,-16.19
1984,Guadeloupe,86,0.0,144,599,0.03,115,685,0.02,125,513,578,-11.25
1984,Mozambique,96,0.0,140,540,0.03,117,636,0.02,126,444,504,-11.9
1984,Haiti,179,0.01,130,450,0.02,121,629,0.02,127,271,275,-1.45
1984,Malawi,314,0.02,119,271,0.01,139,585,0.01,128,-43,82,-152.44
1984,French Polynesia,32,0.0,155,539,0.03,118,571,0.01,129,507,499,1.6
1984,Niger,259,0.01,124,288,0.01,133,547,0.01,130,29,25,16.0
1984,Myanmar,304,0.02,120,241,0.01,143,545,0.01,131,-63,-112,-43.75
1984,Nepal,127,0.01,138,417,0.02,126,544,0.01,132,290,371,-21.83
1984,New Caledonia,207,0.01,128,311,0.02,132,518,0.01,133,104,151,-31.13
1984,Mauritania,291,0.01,122,208,0.01,146,499,0.01,134,-83,-65,27.69
1984,American Samoa,212,0.01,126,284,0.01,135,496,0.01,135,72,50,44.0
1984,Lesotho,29,0.0,156,441,0.02,124,470,0.01,136,412,454,-9.25
1984,Togo,192,0.01,129,271,0.01,139,463,0.01,137,79,119,-33.61
1984,Benin,167,0.01,132,288,0.01,133,455,0.01,138,121,251,-51.79
1984,Bermuda,41,0.0,153,414,0.02,127,455,0.01,138,373,355,5.07
1984,Greenland,169,0.01,131,274,0.01,138,443,0.01,140,105,84,25.0
1984,Guyana,210,0.01,127,213,0.01,145,423,0.01,141,3,42,-92.86
1984,Rwanda,145,0.01,134,278,0.01,137,423,0.01,141,133,158,-15.82
1984,Mali,132,0.01,136,279,0.01,136,411,0.01,143,147,188,-21.81
1984,Burkina Faso,79,0.0,147,253,0.01,141,332,0.01,144,174,233,-25.32
1984,Chad,131,0.01,137,181,0.01,148,312,0.01,145,50,52,-3.85
1984,Sierra Leone,133,0.01,135,157,0.01,151,290,0.01,146,24,41,-41.46
1984,Burundi,103,0.01,139,186,0.01,147,289,0.01,147,83,102,-18.63
1984,French Guiana,37,0.0,154,248,0.01,142,285,0.01,148,211,241,-12.45
1984,Djibouti,13,0.0,169,222,0.01,144,235,0.01,149,209,210,-0.48
1984,Belize,93,0.0,141,130,0.01,153,223,0.01,150,37,34,8.82
1984,Lao People's Democratic Republic,44,0.0,151,162,0.01,150,206,0.01,151,118,109,8.26
1984,Cambodia,18,0.0,161,180,0.01,149,198,0.0,152,162,165,-1.82
1984,Central African Republic,86,0.0,144,87,0.0,157,173,0.0,153,1,-3,-133.33
1984,Solomon Islands,93,0.0,141,79,0.0,159,172,0.0,154,-14,12,-216.67
1984,Saint Lucia,49,0.0,149,119,0.01,154,168,0.0,155,70,89,-21.35
1984,Antigua and Barbuda,18,0.0,161,132,0.01,152,150,0.0,156,114,89,28.09
1984,The Gambia,49,0.0,149,100,0.0,155,149,0.0,157,51,67,-23.88
1984,Saint Vincent and the Grenadines,54,0.0,148,77,0.0,160,131,0.0,158,23,29,-20.69
1984,Seychelles,26,0.0,157,88,0.0,156,114,0.0,159,62,68,-8.82
1984,Vanuatu,44,0.0,151,69,0.0,162,113,0.0,160,25,35,-28.57
1984,Guam,92,0.0,143,0,0.0,179,92,0.0,161,-92,-39,135.9
1984,Bhutan,18,0.0,161,73,0.0,161,91,0.0,162,55,56,-1.79
1984,Cabo Verde,3,0.0,176,83,0.0,158,86,0.0,163,80,84,-4.76
1984,Dominica,26,0.0,157,58,0.0,163,84,0.0,164,32,18,77.78
1984,Grenada,18,0.0,161,56,0.0,164,74,0.0,165,38,38,0.0
1984,Maldives,18,0.0,161,53,0.0,165,71,0.0,166,35,44,-20.45
1984,Saint Kitts and Nevis,19,0.0,160,52,0.0,166,71,0.0,166,33,34,-2.94
1984,Samoa,20,0.0,159,50,0.0,167,70,0.0,168,30,30,0.0
1984,Guinea-Bissau,17,0.0,166,48,0.0,168,65,0.0,169,31,46,-32.61
1984,Saint Pierre and Miquelon,8,0.0,173,44,0.0,169,52,0.0,170,36,31,16.13
1984,Comoros,7,0.0,174,43,0.0,170,50,0.0,171,36,15,140.0
1984,Tonga,9,0.0,171,41,0.0,171,50,0.0,171,32,33,-3.03
1984,Equatorial Guinea,15,0.0,168,18,0.0,173,33,0.0,173,3,6,-50.0
1984,Kiribati,11,0.0,170,18,0.0,173,29,0.0,174,7,11,-36.36
1984,Cook Islands,4,0.0,175,21,0.0,172,25,0.0,175,17,20,-15.0
1984,Sao Tomé and Principe,9,0.0,171,12,0.0,175,21,0.0,176,3,5,-40.0
1984,Montserrat,1,0.0,177,12,0.0,175,13,0.0,177,11,11,0.0
1984,Tuvalu,0,0.0,178,4,0.0,177,4,0.0,178,4,3,33.33
1984,Niue,0,0.0,178,2,0.0,178,2,0.0,179,2,2,0.0
1983,United States of America,205639,11.14,1,269878,14.28,1,475517,12.73,1,64239,38442,67.11
1983,Germany,169417,9.18,2,152877,8.09,2,322294,8.63,2,-16540,-21101,-21.62
1983,Japan,146965,7.96,3,126437,6.69,3,273402,7.32,3,-20528,-6886,198.11
1983,France,94943,5.14,4,105907,5.6,4,200850,5.38,4,10964,19020,-42.36
1983,United Kingdom,91619,4.96,5,100080,5.29,5,191699,5.13,5,8461,2662,217.84
1983,U.S.S.R.,91380,4.95,6,80200,4.24,6,171580,4.59,6,-11180,-9300,20.22
1983,Italy,72877,3.95,8,79808,4.22,7,152685,4.09,7,6931,13541,-48.81
1983,Canada,76749,4.16,7,64789,3.43,8,141538,3.79,8,-11960,-13106,-8.74
1983,Netherlands,64684,3.5,9,61652,3.26,9,126336,3.38,9,-3032,-2515,20.56
1983,Belgium-Luxembourg,51939,2.81,10,55313,2.93,10,107252,2.87,10,3374,5871,-42.53
1983,"Saudi Arabia, Kingdom of",45861,2.48,11,39197,2.07,11,85058,2.28,11,-6664,-38433,-82.66
1983,Switzerland,25592,1.39,14,29192,1.54,13,54784,1.47,12,3600,2660,35.34
1983,Sweden,27446,1.49,12,26098,1.38,16,53544,1.43,13,-1348,777,-273.49
1983,"Korea, Republic of",24446,1.32,17,26192,1.39,15,50638,1.36,14,1746,2398,-27.19
1983,Singapore,21833,1.18,21,28158,1.49,14,49991,1.34,15,6325,7380,-14.3
1983,Spain,19734,1.07,25,29193,1.54,12,48927,1.31,16,9459,10967,-13.75
1983,"Hong Kong, China",22454,1.22,18,24409,1.29,17,46863,1.25,17,1955,3524,-44.52
1983,German Democratic Republic,24530,1.33,16,21525,1.14,18,46055,1.23,18,-3005,-2335,28.69
1983,Chinese Taipei,25179,1.36,15,20315,1.07,21,45494,1.22,19,-4864,-3368,44.42
1983,China,22226,1.2,19,21390,1.13,20,43616,1.17,20,-836,-3036,-72.46
1983,Australia,20113,1.09,24,21458,1.14,19,41571,1.11,21,1345,5307,-74.66
1983,Iran,21507,1.17,22,18320,0.97,23,39827,1.07,22,-3187,-8497,-62.49
1983,Brazil,21899,1.19,20,16801,0.89,24,38700,1.04,23,-5098,894,-670.25
1983,Mexico,25953,1.41,13,12476,0.66,33,38429,1.03,24,-13477,-6313,113.48
1983,Indonesia,21152,1.15,23,16352,0.86,26,37504,1.0,25,-4800,-5434,-11.67
1983,Austria,15427,0.84,31,19423,1.03,22,34850,0.93,26,3996,3860,3.52
1983,South Africa,18508,1.0,26,15813,0.84,28,34321,0.92,27,-2695,734,-467.17
1983,Czech and Slovak Federal Republic,16500,0.89,29,16370,0.87,25,32870,0.88,28,-130,-185,-29.73
1983,Denmark,16053,0.87,30,16266,0.86,27,32319,0.87,29,213,1295,-83.55
1983,Norway,17998,0.98,27,13497,0.71,30,31495,0.84,30,-4501,-2116,112.71
1983,Malaysia,14104,0.76,32,13262,0.7,31,27366,0.73,31,-842,388,-317.01
1983,Finland,12518,0.68,35,12826,0.68,32,25344,0.68,32,308,313,-1.6
1983,United Arab Emirates,16900,0.92,28,8294,0.44,47,25194,0.67,33,-8606,-9340,-7.86
1983,Bulgaria,12140,0.66,37,12290,0.65,34,24430,0.65,34,150,100,50.0
1983,India,9148,0.5,43,14061,0.74,29,23209,0.62,35,4913,5428,-9.49
1983,Algeria,12583,0.68,34,10399,0.55,39,22982,0.62,36,-2184,-2416,-9.6
1983,Nigeria,10357,0.56,40,12254,0.65,35,22611,0.61,37,1897,3876,-51.06
1983,Poland,11580,0.63,38,10600,0.56,38,22180,0.59,38,-980,-970,1.03
1983,"Yugoslavia, Socialist Federal Republic of",9914,0.54,42,12154,0.64,37,22068,0.59,39,2240,3169,-29.32
1983,"Venezuela, Bolivarian Republic of",13937,0.76,33,6419,0.34,53,20356,0.54,40,-7518,-3646,106.2
1983,Iraq,8161,0.44,46,12166,0.64,36,20327,0.54,41,4005,11284,-64.51
1983,"Kuwait, the State of",11504,0.62,39,7373,0.39,51,18877,0.51,42,-4131,-2582,59.99
1983,Libya,12216,0.66,36,6029,0.32,54,18245,0.49,43,-6187,-6028,2.64
1983,Romania,10160,0.55,41,7640,0.4,50,17800,0.48,44,-2520,-1800,40.0
1983,Ireland,8592,0.47,45,9159,0.48,45,17751,0.48,45,567,1639,-65.41
1983,Hungary,8770,0.48,44,8555,0.45,46,17325,0.46,46,-215,10,-2250.0
1983,Thailand,6368,0.35,49,10287,0.54,40,16655,0.45,47,3919,1603,144.48
1983,Türkiye,5728,0.31,50,9235,0.49,44,14963,0.4,48,3507,3097,13.24
1983,Israel,5108,0.28,52,9574,0.51,42,14682,0.39,49,4466,4400,1.5
1983,Greece,4413,0.24,55,9500,0.5,43,13913,0.37,50,5087,5728,-11.19
1983,Cuba,6432,0.35,48,7211,0.38,52,13643,0.37,51,779,717,8.65
1983,Egypt,3215,0.17,62,10275,0.54,41,13490,0.36,52,7060,5958,18.5
1983,Philippines,4890,0.26,53,7976,0.42,49,12866,0.34,53,3086,3303,-6.57
1983,Portugal,4599,0.25,54,8240,0.44,48,12839,0.34,54,3641,5408,-32.67
1983,Argentina,7836,0.42,47,4504,0.24,61,12340,0.33,55,-3332,-2288,45.63
1983,New Zealand,5414,0.29,51,5333,0.28,55,10747,0.29,56,-81,211,-138.39
1983,Netherlands Antilles,4409,0.24,56,4527,0.24,60,8936,0.24,57,118,196,-39.8
1983,Bahamas,3970,0.22,58,4616,0.24,58,8586,0.23,58,646,1815,-64.41
1983,Pakistan,3077,0.17,64,5329,0.28,56,8406,0.22,59,2252,3068,-26.6
1983,Colombia,3001,0.16,66,4963,0.26,57,7964,0.21,60,1962,2456,-20.11
1983,Chile,3831,0.21,59,3085,0.16,66,6916,0.19,61,-746,283,-363.6
1983,Oman,4248,0.23,57,2623,0.14,68,6871,0.18,62,-1625,-1553,4.64
1983,Syrian Arab Republic,1923,0.1,72,4542,0.24,59,6465,0.17,63,2619,2002,30.82
1983,"Bahrain, Kingdom of",3119,0.17,63,3262,0.17,64,6381,0.17,64,143,-175,-181.71
1983,Morocco,2006,0.11,70,3592,0.19,63,5598,0.15,65,1586,2253,-29.6
1983,Peru,3015,0.16,65,2234,0.12,70,5249,0.14,66,-781,-319,144.83
1983,Tunisia,1850,0.1,73,3107,0.16,65,4957,0.13,67,1257,1434,-12.34
1983,Trinidad and Tobago,2353,0.13,67,2582,0.14,69,4935,0.13,68,229,625,-63.36
1983,Qatar,3357,0.18,61,1456,0.08,81,4813,0.13,69,-1901,-2394,-20.59
1983,Lebanese Republic,760,0.04,90,3661,0.19,62,4421,0.12,70,2901,2591,11.96
1983,Brunei Darussalam,3369,0.18,60,724,0.04,111,4093,0.11,71,-2645,-3077,-14.04
1983,Côte d'Ivoire,2090,0.11,69,1839,0.1,72,3929,0.11,72,-251,-170,47.65
1983,Ecuador,2348,0.13,68,1487,0.08,79,3835,0.1,73,-861,-158,444.94
1983,Jordan,580,0.03,105,3036,0.16,67,3616,0.1,74,2456,2488,-1.29
1983,Democratic Republic of the Congo,1686,0.09,75,1213,0.06,88,2899,0.08,75,-473,-304,55.59
1983,Bangladesh,724,0.04,95,2165,0.11,71,2889,0.08,76,1441,1695,-14.99
1983,Sri Lanka,1063,0.06,81,1820,0.1,73,2883,0.08,77,757,800,-5.38
1983,Angola,1822,0.1,74,983,0.05,95,2805,0.08,78,-839,-743,12.92
1983,"Korea, Democratic People's Republic of",1200,0.07,76,1600,0.08,76,2800,0.07,79,400,400,0.0
1983,Dominican Republic,1083,0.06,80,1699,0.09,74,2782,0.07,80,616,709,-13.12
1983,Gabon,2000,0.11,71,685,0.04,112,2685,0.07,81,-1315,-1294,1.62
1983,Ghana,1158,0.06,78,1248,0.07,85,2406,0.06,82,90,-169,-153.25
1983,Zimbabwe,1135,0.06,79,1205,0.06,89,2340,0.06,83,70,364,-80.77
1983,Guatemala,1159,0.06,77,1126,0.06,90,2285,0.06,84,-33,268,-112.31
1983,Jamaica,718,0.04,96,1494,0.08,78,2212,0.06,85,776,614,26.38
1983,Kenya,869,0.05,85,1334,0.07,84,2203,0.06,86,465,619,-24.88
1983,Cameroon,976,0.05,83,1224,0.06,86,2200,0.06,87,248,147,68.71
1983,"Yemen, People's Democratic Republic",674,0.04,97,1483,0.08,80,2157,0.06,88,809,804,0.62
1983,Viet Nam,616,0.03,103,1526,0.08,77,2142,0.06,89,910,946,-3.81
1983,Sudan,624,0.03,101,1354,0.07,83,1978,0.05,90,730,784,-6.89
1983,Papua New Guinea,813,0.04,88,1120,0.06,91,1933,0.05,91,307,399,-23.06
1983,Costa Rica,873,0.05,84,988,0.05,94,1861,0.05,92,115,19,505.26
1983,Uruguay,1045,0.06,82,788,0.04,106,1833,0.05,93,-257,87,-395.4
1983,Afghanistan,729,0.04,94,1064,0.06,92,1793,0.05,94,335,254,31.89
1983,Namibia,846,0.05,86,921,0.05,97,1767,0.05,95,75,106,-29.25
1983,Panama,320,0.02,118,1412,0.07,82,1732,0.05,96,1092,1195,-8.62
1983,Cyprus,503,0.03,106,1219,0.06,87,1722,0.05,97,716,679,5.45
1983,Zambia,836,0.05,87,851,0.05,100,1687,0.05,98,15,177,-91.53
1983,Yemen,27,0.0,156,1618,0.09,75,1645,0.04,99,1591,1482,7.35
1983,Senegal,618,0.03,102,1025,0.05,93,1643,0.04,100,407,444,-8.33
1983,El Salvador,735,0.04,93,891,0.05,98,1626,0.04,101,156,158,-1.27
1983,Iceland,740,0.04,92,818,0.04,104,1558,0.04,102,78,259,-69.88
1983,Mongolia,610,0.03,104,928,0.05,96,1538,0.04,103,318,231,37.66
1983,"Macao, China",763,0.04,89,727,0.04,110,1490,0.04,104,-36,-3,1100.0
1983,Honduras,672,0.04,98,803,0.04,105,1475,0.04,105,131,41,219.51
1983,Botswana,635,0.03,100,735,0.04,108,1370,0.04,106,100,235,-57.45
1983,"Bolivia, Plurinational State of",755,0.04,91,577,0.03,117,1332,0.04,107,-178,-274,-35.04
1983,Congo,640,0.03,99,648,0.03,114,1288,0.03,108,8,-226,-103.54
1983,Ethiopia,403,0.02,110,875,0.05,99,1278,0.03,109,472,387,21.96
1983,Nicaragua,429,0.02,108,826,0.04,103,1255,0.03,110,397,370,7.3
1983,Tanzania,364,0.02,115,832,0.04,102,1196,0.03,111,468,716,-34.64
1983,Malta,363,0.02,116,733,0.04,109,1096,0.03,112,370,378,-2.12
1983,Barbados,321,0.02,117,616,0.03,116,937,0.03,113,295,294,0.34
1983,Reunion,87,0.0,139,848,0.04,101,935,0.03,114,761,702,8.4
1983,Martinique,174,0.01,129,747,0.04,107,921,0.02,115,573,647,-11.44
1983,Eswatini,304,0.02,120,551,0.03,118,855,0.02,116,247,201,22.89
1983,Liberia,428,0.02,109,412,0.02,127,840,0.02,117,-16,-49,-67.35
1983,Suriname,367,0.02,113,472,0.02,123,839,0.02,118,105,85,23.53
1983,Paraguay,269,0.01,123,546,0.03,119,815,0.02,119,277,342,-19.01
1983,Mauritius,366,0.02,114,441,0.02,125,807,0.02,120,75,100,-25.0
1983,Fiji,306,0.02,119,484,0.03,122,790,0.02,121,178,132,34.85
1983,Mozambique,132,0.01,134,636,0.03,115,768,0.02,122,504,607,-16.97
1983,Guinea,488,0.03,107,267,0.01,141,755,0.02,123,-221,-163,35.58
1983,Uganda,372,0.02,112,377,0.02,130,749,0.02,124,5,28,-82.14
1983,Guadeloupe,83,0.0,140,661,0.03,113,744,0.02,125,578,541,6.84
1983,Myanmar,382,0.02,111,270,0.01,140,652,0.02,126,-112,18,-722.22
1983,Madagascar,263,0.01,124,387,0.02,128,650,0.02,127,124,109,13.76
1983,Niger,299,0.02,121,324,0.02,132,623,0.02,128,25,134,-81.34
1983,Haiti,166,0.01,130,441,0.02,125,607,0.02,129,275,209,31.58
1983,French Polynesia,35,0.0,153,534,0.03,120,569,0.02,130,499,492,1.42
1983,Nepal,93,0.01,138,464,0.02,124,557,0.01,131,371,307,20.85
1983,Malawi,229,0.01,125,311,0.02,134,540,0.01,132,82,65,26.15
1983,Mauritania,292,0.02,122,227,0.01,144,519,0.01,133,-65,43,-251.16
1983,Mali,165,0.01,131,353,0.02,131,518,0.01,134,188,187,0.53
1983,Lesotho,31,0.0,154,485,0.03,121,516,0.01,135,454,487,-6.78
1983,New Caledonia,154,0.01,133,305,0.02,135,459,0.01,136,151,101,49.5
1983,Greenland,181,0.01,127,265,0.01,142,446,0.01,137,84,106,-20.75
1983,Togo,163,0.01,132,282,0.01,137,445,0.01,138,119,215,-44.65
1983,Guyana,189,0.01,126,231,0.01,143,420,0.01,139,42,27,55.56
1983,American Samoa,177,0.01,128,227,0.01,144,404,0.01,140,50,11,354.55
1983,Bermuda,23,0.0,158,378,0.02,129,401,0.01,141,355,334,6.29
1983,Rwanda,121,0.01,135,279,0.01,138,400,0.01,142,158,195,-18.97
1983,Benin,67,0.0,144,318,0.02,133,385,0.01,143,251,440,-42.95
1983,Burkina Faso,58,0.0,146,291,0.02,136,349,0.01,144,233,291,-19.93
1983,French Guiana,38,0.0,152,279,0.01,138,317,0.01,145,241,217,11.06
1983,Sierra Leone,119,0.01,136,160,0.01,149,279,0.01,146,41,187,-78.07
1983,Burundi,80,0.0,141,182,0.01,147,262,0.01,147,102,125,-18.4
1983,Chad,105,0.01,137,157,0.01,150,262,0.01,147,52,51,1.96
1983,Djibouti,11,0.0,169,221,0.01,146,232,0.01,149,210,213,-1.41
1983,Saint Lucia,55,0.0,147,144,0.01,152,199,0.01,150,89,72,23.61
1983,Cambodia,15,0.0,166,180,0.01,148,195,0.01,151,165,168,-1.79
1983,Lao People's Democratic Republic,41,0.0,149,150,0.01,151,191,0.01,152,109,92,18.48
1983,Belize,78,0.0,143,112,0.01,154,190,0.01,153,34,37,-8.11
1983,The Gambia,48,0.0,148,115,0.01,153,163,0.0,154,67,59,13.56
1983,Central African Republic,80,0.0,141,77,0.0,158,157,0.0,155,-3,16,-118.75
1983,Solomon Islands,62,0.0,145,74,0.0,159,136,0.0,156,12,13,-7.69
1983,Antigua and Barbuda,20,0.0,159,109,0.01,155,129,0.0,157,89,118,-24.58
1983,Saint Vincent and the Grenadines,41,0.0,149,70,0.0,161,111,0.0,158,29,33,-12.12
1983,Seychelles,20,0.0,159,88,0.0,156,108,0.0,159,68,83,-18.07
1983,Vanuatu,29,0.0,155,64,0.0,162,93,0.0,160,35,37,-5.41
1983,Cabo Verde,3,0.0,174,87,0.0,157,90,0.0,161,84,68,23.53
1983,Bhutan,16,0.0,165,72,0.0,160,88,0.0,162,56,51,9.8
1983,Grenada,19,0.0,161,57,0.0,163,76,0.0,163,38,37,2.7
1983,Dominica,27,0.0,156,45,0.0,168,72,0.0,164,18,23,-21.74
1983,Maldives,13,0.0,167,57,0.0,163,70,0.0,165,44,33,33.33
1983,Saint Kitts and Nevis,17,0.0,164,51,0.0,166,68,0.0,166,34,27,25.93
1983,Samoa,18,0.0,163,48,0.0,167,66,0.0,167,30,37,-18.92
1983,Guinea-Bissau,9,0.0,170,55,0.0,165,64,0.0,168,46,38,21.05
1983,Comoros,19,0.0,161,34,0.0,171,53,0.0,169,15,13,15.38
1983,Tonga,5,0.0,172,38,0.0,169,43,0.0,170,33,34,-2.94
1983,Saint Pierre and Miquelon,6,0.0,171,37,0.0,170,43,0.0,170,31,36,-13.89
1983,Guam,39,0.0,151,0,0.0,179,39,0.0,172,-39,-60,-35.0
1983,Equatorial Guinea,13,0.0,167,19,0.0,173,32,0.0,173,6,19,-68.42
1983,Cook Islands,3,0.0,174,23,0.0,172,26,0.0,174,20,16,25.0
1983,Kiribati,3,0.0,174,14,0.0,174,17,0.0,175,11,12,-8.33
1983,Sao Tomé and Principe,5,0.0,172,10,0.0,176,15,0.0,176,5,3,66.67
1983,Montserrat,1,0.0,177,12,0.0,175,13,0.0,177,11,11,0.0
1983,Tuvalu,0,0.0,178,3,0.0,177,3,0.0,178,3,3,0.0
1983,Niue,0,0.0,178,2,0.0,178,2,0.0,179,2,3,-33.33
1982,United States of America,216442,11.48,1,254884,13.12,1,471326,12.31,1,38442,34637,10.99
1982,Germany,176424,9.36,2,155323,7.99,2,331747,8.67,2,-21101,-12106,74.3
1982,Japan,138385,7.34,3,131499,6.77,3,269884,7.05,3,-6886,-8629,-20.2
1982,France,96694,5.13,5,115714,5.96,4,212408,5.55,4,19020,14529,30.91
1982,United Kingdom,96984,5.14,4,99646,5.13,5,196630,5.14,5,2662,464,473.71
1982,U.S.S.R.,87000,4.61,6,77700,4.0,7,164700,4.3,6,-9300,-6225,49.4
1982,Italy,73791,3.91,8,87332,4.49,6,161123,4.21,7,13541,17191,-21.23
1982,Netherlands,66281,3.52,10,63766,3.28,8,130047,3.4,8,-2515,-1484,69.47
1982,Canada,71234,3.78,9,58128,2.99,10,129362,3.38,9,-13106,-2716,382.55
1982,"Saudi Arabia, Kingdom of",79077,4.19,7,40644,2.09,11,119721,3.13,10,-38433,-84607,-54.57
1982,Belgium-Luxembourg,52356,2.78,11,58227,3.0,9,110583,2.89,11,5871,6738,-12.87
1982,Switzerland,26018,1.38,13,28678,1.48,13,54696,1.43,12,2660,3666,-27.44
1982,Sweden,26808,1.42,12,27585,1.42,15,54393,1.42,13,777,182,326.92
1982,Spain,20498,1.09,23,31465,1.62,12,51963,1.36,14,10967,11816,-7.19
1982,Singapore,20787,1.1,22,28167,1.45,14,48954,1.28,15,7380,6605,11.73
1982,Australia,21360,1.13,20,26667,1.37,16,48027,1.25,16,5307,4738,12.01
1982,"Hong Kong, China",21343,1.13,21,24867,1.28,17,46210,1.21,17,3524,4361,-19.19
1982,"Korea, Republic of",21853,1.16,19,24251,1.25,18,46104,1.2,18,2398,4863,-50.69
1982,German Democratic Republic,22530,1.19,15,20195,1.04,21,42725,1.12,19,-2335,-490,376.53
1982,Mexico,24055,1.28,14,17742,0.91,26,41797,1.09,20,-6313,5155,-222.46
1982,China,22321,1.18,16,19285,0.99,23,41606,1.09,21,-3036,7,-43471.43
1982,Brazil,20175,1.07,25,21069,1.08,20,41244,1.08,22,894,786,13.74
1982,Chinese Taipei,22182,1.18,18,18814,0.97,24,40996,1.07,23,-3368,-1463,130.21
1982,Indonesia,22293,1.18,17,16859,0.87,27,39152,1.02,24,-5434,-8988,-39.54
1982,South Africa,17673,0.94,27,18407,0.95,25,36080,0.94,25,734,2267,-67.62
1982,Austria,15642,0.83,30,19502,1.0,22,35144,0.92,26,3860,5202,-25.8
1982,Norway,17593,0.93,28,15477,0.8,30,33070,0.86,27,-2116,-2567,-17.57
1982,Iran,20452,1.08,24,11955,0.62,37,32407,0.85,28,-8497,2862,-396.89
1982,Denmark,15397,0.82,32,16692,0.86,28,32089,0.84,29,1295,1485,-12.79
1982,Iraq,10250,0.54,42,21534,1.11,19,31784,0.83,30,11284,10205,10.57
1982,Czech and Slovak Federal Republic,15640,0.83,31,15455,0.8,31,31095,0.81,31,-185,-240,-22.92
1982,"Venezuela, Bolivarian Republic of",16590,0.88,29,12944,0.67,35,29534,0.77,32,-3646,-7874,-53.7
1982,Nigeria,12185,0.65,36,16061,0.83,29,28246,0.74,33,3876,3032,27.84
1982,United Arab Emirates,18780,1.0,26,9440,0.49,45,28220,0.74,34,-9340,-12734,-26.65
1982,Finland,13088,0.69,35,13401,0.69,34,26489,0.69,35,313,187,67.38
1982,Malaysia,12030,0.64,37,12418,0.64,36,24448,0.64,36,388,-220,-276.36
1982,India,9358,0.5,44,14786,0.76,32,24144,0.63,37,5428,7123,-23.8
1982,Algeria,13170,0.7,34,10754,0.55,39,23924,0.62,38,-2416,-3093,-21.89
1982,"Yugoslavia, Socialist Federal Republic of",10284,0.55,41,13453,0.69,33,23737,0.62,39,3169,4787,-33.8
1982,Bulgaria,11440,0.61,38,11540,0.59,38,22980,0.6,40,100,100,0.0
1982,Poland,11220,0.6,39,10250,0.53,40,21470,0.56,41,-970,2240,-143.3
1982,Libya,13203,0.7,33,7175,0.37,53,20378,0.53,42,-6028,-7189,-16.15
1982,"Kuwait, the State of",10864,0.58,40,8282,0.43,51,19146,0.5,43,-2582,-9066,-71.52
1982,Romania,10120,0.54,43,8320,0.43,50,18440,0.48,44,-1800,-200,800.0
1982,Ireland,8063,0.43,46,9702,0.5,42,17765,0.46,45,1639,2930,-44.06
1982,Hungary,8860,0.47,45,8870,0.46,47,17730,0.46,46,10,430,-97.67
1982,Thailand,6945,0.37,48,8548,0.44,49,15493,0.4,47,1603,2924,-45.18
1982,Israel,5255,0.28,52,9655,0.5,43,14910,0.39,48,4400,4565,-3.61
1982,Türkiye,5746,0.3,50,8843,0.46,48,14589,0.38,49,3097,4230,-26.78
1982,Greece,4298,0.23,58,10026,0.52,41,14324,0.37,50,5728,4564,25.5
1982,Portugal,4164,0.22,59,9572,0.49,44,13736,0.36,51,5408,5652,-4.32
1982,Philippines,4969,0.26,53,8272,0.43,52,13241,0.35,52,3303,2823,17.0
1982,Argentina,7625,0.4,47,5337,0.27,59,12962,0.34,53,-2288,287,-897.21
1982,Cuba,5920,0.31,49,6637,0.34,54,12557,0.33,54,717,1139,-37.05
1982,Egypt,3120,0.17,64,9078,0.47,46,12198,0.32,55,5958,5549,7.37
1982,New Zealand,5571,0.3,51,5782,0.3,56,11353,0.3,56,211,112,88.39
1982,Bahamas,4534,0.24,55,6349,0.33,55,10883,0.28,57,1815,1095,65.75
1982,Netherlands Antilles,4891,0.26,54,5087,0.26,60,9978,0.26,58,196,445,-55.96
1982,Colombia,3024,0.16,66,5480,0.28,57,8504,0.22,59,2456,2285,7.48
1982,Pakistan,2397,0.13,67,5465,0.28,58,7862,0.21,60,3068,2748,11.64
1982,Chile,3706,0.2,62,3989,0.21,63,7695,0.2,61,283,3344,-91.54
1982,"Bahrain, Kingdom of",3789,0.2,61,3614,0.19,65,7403,0.19,62,-175,-223,-21.52
1982,Oman,4421,0.23,56,2868,0.15,70,7289,0.19,63,-1553,-2283,-31.98
1982,Trinidad and Tobago,3072,0.16,65,3697,0.19,64,6769,0.18,64,625,-636,-198.27
1982,Morocco,2062,0.11,71,4315,0.22,61,6377,0.17,65,2253,2014,11.87
1982,Qatar,4341,0.23,57,1947,0.1,74,6288,0.16,66,-2394,-4168,-42.56
1982,Peru,3259,0.17,63,2940,0.15,69,6199,0.16,67,-319,-95,235.79
1982,Syrian Arab Republic,2026,0.11,72,4028,0.21,62,6054,0.16,68,2002,3070,-34.79
1982,Tunisia,1986,0.11,73,3420,0.18,66,5406,0.14,69,1434,1291,11.08
1982,Brunei Darussalam,3808,0.2,60,731,0.04,110,4539,0.12,70,-3077,-3443,-10.63
1982,Côte d'Ivoire,2350,0.12,68,2180,0.11,72,4530,0.12,71,-170,-151,12.58
1982,Ecuador,2327,0.12,69,2169,0.11,73,4496,0.12,72,-158,-205,-22.93
1982,Lebanese Republic,800,0.04,90,3391,0.17,67,4191,0.11,73,2591,2579,0.47
1982,Jordan,752,0.04,95,3240,0.17,68,3992,0.1,74,2488,2432,2.3
1982,Bangladesh,769,0.04,93,2464,0.13,71,3233,0.08,75,1695,1908,-11.16
1982,Gabon,2161,0.11,70,867,0.04,100,3028,0.08,76,-1294,-1360,-4.85
1982,Zimbabwe,1275,0.07,76,1639,0.08,78,2914,0.08,77,364,289,25.95
1982,Democratic Republic of the Congo,1601,0.08,75,1297,0.07,86,2898,0.08,78,-304,-257,18.29
1982,Sri Lanka,1031,0.05,80,1831,0.09,75,2862,0.07,79,800,761,5.12
1982,Dominican Republic,984,0.05,85,1693,0.09,76,2677,0.07,80,709,494,43.52
1982,Kenya,1025,0.05,81,1644,0.08,77,2669,0.07,81,619,800,-22.63
1982,"Korea, Democratic People's Republic of",1100,0.06,78,1500,0.08,82,2600,0.07,82,400,500,-20.0
1982,Angola,1629,0.09,74,886,0.05,99,2515,0.07,83,-743,-194,282.99
1982,Guatemala,1120,0.06,77,1388,0.07,84,2508,0.07,84,268,462,-41.99
1982,"Yemen, People's Democratic Republic",795,0.04,91,1599,0.08,79,2394,0.06,85,804,812,-0.99
1982,Cameroon,1064,0.06,79,1211,0.06,89,2275,0.06,86,147,322,-54.35
1982,Zambia,1024,0.05,82,1201,0.06,90,2225,0.06,87,177,182,-2.75
1982,Jamaica,767,0.04,94,1381,0.07,85,2148,0.06,88,614,499,23.05
1982,Uruguay,1023,0.05,83,1110,0.06,93,2133,0.06,89,87,426,-79.58
1982,Viet Nam,526,0.03,104,1472,0.08,83,1998,0.05,90,946,981,-3.57
1982,Namibia,934,0.05,86,1040,0.05,94,1974,0.05,91,106,156,-32.05
1982,Panama,375,0.02,116,1570,0.08,80,1945,0.05,92,1195,1212,-1.4
1982,Papua New Guinea,771,0.04,92,1170,0.06,91,1941,0.05,93,399,423,-5.67
1982,Sudan,498,0.03,105,1282,0.07,87,1780,0.05,94,784,896,-12.5
1982,Cyprus,544,0.03,103,1223,0.06,88,1767,0.05,95,679,604,12.42
1982,Congo,993,0.05,84,767,0.04,109,1760,0.05,96,-226,-365,-38.08
1982,Costa Rica,870,0.05,88,889,0.05,98,1759,0.05,97,19,201,-90.55
1982,Afghanistan,708,0.04,97,962,0.05,96,1670,0.04,98,254,192,32.29
1982,Iceland,685,0.04,99,944,0.05,97,1629,0.04,99,259,130,99.23
1982,Tanzania,450,0.02,109,1166,0.06,92,1616,0.04,100,716,633,13.11
1982,Ghana,874,0.05,87,705,0.04,112,1579,0.04,101,-169,41,-512.2
1982,Yemen,39,0.0,150,1521,0.08,81,1560,0.04,102,1482,1711,-13.38
1982,El Salvador,699,0.04,98,857,0.04,101,1556,0.04,103,158,189,-16.4
1982,Senegal,548,0.03,102,992,0.05,95,1540,0.04,104,444,576,-22.92
1982,"Macao, China",722,0.04,96,719,0.04,111,1441,0.04,105,-3,25,-112.0
1982,"Bolivia, Plurinational State of",828,0.04,89,554,0.03,117,1382,0.04,106,-274,5,-5580.0
1982,Honduras,660,0.04,100,701,0.04,113,1361,0.04,107,41,188,-78.19
1982,Mongolia,560,0.03,101,791,0.04,104,1351,0.04,108,231,235,-1.7
1982,Malta,411,0.02,111,789,0.04,105,1200,0.03,109,378,411,-8.03
1982,Ethiopia,399,0.02,113,786,0.04,106,1185,0.03,110,387,359,7.8
1982,Nicaragua,406,0.02,112,776,0.04,107,1182,0.03,111,370,491,-24.64
1982,Botswana,454,0.02,108,689,0.04,114,1143,0.03,112,235,400,-41.25
1982,Mozambique,229,0.01,128,836,0.04,102,1065,0.03,113,607,520,16.73
1982,Paraguay,330,0.02,120,672,0.03,115,1002,0.03,114,342,304,12.5
1982,Suriname,429,0.02,110,514,0.03,122,943,0.02,115,85,94,-9.57
1982,Reunion,105,0.01,137,807,0.04,103,912,0.02,116,702,680,3.24
1982,Liberia,477,0.03,106,428,0.02,127,905,0.02,117,-49,-82,-40.24
1982,Martinique,121,0.01,134,768,0.04,108,889,0.02,118,647,592,9.29
1982,Fiji,377,0.02,115,509,0.03,123,886,0.02,119,132,231,-42.86
1982,Eswatini,325,0.02,121,526,0.03,119,851,0.02,120,201,203,-0.99
1982,Mauritius,364,0.02,117,464,0.02,125,828,0.02,121,100,231,-56.71
1982,Myanmar,395,0.02,114,413,0.02,129,808,0.02,122,18,-90,-120.0
1982,Barbados,257,0.01,124,551,0.03,118,808,0.02,122,294,376,-21.81
1982,Niger,332,0.02,119,466,0.02,124,798,0.02,124,134,55,143.64
1982,Guinea,459,0.02,107,296,0.02,140,755,0.02,125,-163,-79,106.33
1982,Uganda,349,0.02,118,377,0.02,133,726,0.02,126,28,102,-72.55
1982,Madagascar,308,0.02,122,417,0.02,128,725,0.02,127,109,229,-52.4
1982,Guadeloupe,83,0.0,142,624,0.03,116,707,0.02,128,541,560,-3.39
1982,New Caledonia,266,0.01,123,367,0.02,134,633,0.02,129,101,65,55.38
1982,Togo,178,0.01,130,393,0.02,131,571,0.01,130,215,226,-4.87
1982,Haiti,178,0.01,130,387,0.02,132,565,0.01,131,209,309,-32.36
1982,Lesotho,37,0.0,151,524,0.03,120,561,0.01,132,487,466,4.51
1982,French Polynesia,28,0.0,154,520,0.03,121,548,0.01,133,492,517,-4.84
1982,Malawi,239,0.01,126,304,0.02,138,543,0.01,134,65,76,-14.47
1982,Guyana,256,0.01,125,283,0.01,142,539,0.01,135,27,86,-68.6
1982,Mauritania,233,0.01,127,276,0.01,144,509,0.01,136,43,4,975.0
1982,Benin,24,0.0,155,464,0.02,125,488,0.01,137,440,509,-13.56
1982,Nepal,88,0.0,140,395,0.02,130,483,0.01,138,307,228,34.65
1982,Mali,145,0.01,133,332,0.02,137,477,0.01,139,187,211,-11.37
1982,Greenland,172,0.01,132,278,0.01,143,450,0.01,140,106,108,-1.85
1982,Sierra Leone,111,0.01,135,298,0.02,139,409,0.01,141,187,178,5.06
1982,Burkina Faso,56,0.0,146,347,0.02,136,403,0.01,142,291,264,10.23
1982,American Samoa,187,0.01,129,198,0.01,148,385,0.01,143,11,35,-68.57
1982,Rwanda,91,0.0,138,286,0.01,141,377,0.01,144,195,201,-2.99
1982,Bermuda,17,0.0,161,351,0.02,135,368,0.01,145,334,294,13.61
1982,Burundi,88,0.0,140,213,0.01,147,301,0.01,146,125,86,45.35
1982,French Guiana,33,0.0,152,250,0.01,145,283,0.01,147,217,216,0.46
1982,Djibouti,13,0.0,165,226,0.01,146,239,0.01,148,213,215,-0.93
1982,Central African Republic,107,0.01,136,123,0.01,153,230,0.01,149,16,16,0.0
1982,Belize,91,0.0,138,128,0.01,152,219,0.01,150,37,43,-13.95
1982,Cambodia,12,0.0,167,180,0.01,149,192,0.01,151,168,170,-1.18
1982,Lao People's Democratic Republic,40,0.0,149,132,0.01,151,172,0.0,152,92,87,5.75
1982,Chad,58,0.0,144,109,0.01,155,167,0.0,153,51,25,104.0
1982,Saint Lucia,46,0.0,147,118,0.01,154,164,0.0,154,72,83,-13.25
1982,Antigua and Barbuda,21,0.0,158,139,0.01,150,160,0.0,155,118,71,66.2
1982,The Gambia,44,0.0,148,103,0.01,156,147,0.0,156,59,99,-40.4
1982,Solomon Islands,58,0.0,144,71,0.0,159,129,0.0,157,13,25,-48.0
1982,Seychelles,15,0.0,164,98,0.01,157,113,0.0,158,83,76,9.21
1982,Saint Vincent and the Grenadines,32,0.0,153,65,0.0,161,97,0.0,159,33,34,-2.94
1982,Bhutan,17,0.0,161,68,0.0,160,85,0.0,160,51,48,6.25
1982,Vanuatu,23,0.0,157,60,0.0,162,83,0.0,161,37,26,42.31
1982,Cabo Verde,4,0.0,174,72,0.0,158,76,0.0,162,68,68,0.0
1982,Grenada,19,0.0,160,56,0.0,163,75,0.0,163,37,35,5.71
1982,Dominica,24,0.0,155,47,0.0,166,71,0.0,164,23,31,-25.81
1982,Samoa,13,0.0,165,50,0.0,164,63,0.0,165,37,45,-17.78
1982,Guinea-Bissau,12,0.0,167,50,0.0,164,62,0.0,166,38,36,5.56
1982,Saint Kitts and Nevis,17,0.0,161,44,0.0,167,61,0.0,167,27,26,3.85
1982,Guam,60,0.0,143,0,0.0,179,60,0.0,168,-60,-77,-22.08
1982,Comoros,20,0.0,159,33,0.0,171,53,0.0,169,13,16,-18.75
1982,Maldives,10,0.0,171,43,0.0,168,53,0.0,169,33,22,50.0
1982,Tonga,8,0.0,172,42,0.0,169,50,0.0,171,34,32,6.25
1982,Saint Pierre and Miquelon,6,0.0,173,42,0.0,169,48,0.0,172,36,34,5.88
1982,Equatorial Guinea,12,0.0,167,31,0.0,172,43,0.0,173,19,16,18.75
1982,Sao Tomé and Principe,12,0.0,167,15,0.0,174,27,0.0,174,3,9,-66.67
1982,Cook Islands,4,0.0,174,20,0.0,173,24,0.0,175,16,21,-23.81
1982,Kiribati,2,0.0,176,14,0.0,175,16,0.0,176,12,10,20.0
1982,Montserrat,1,0.0,177,12,0.0,176,13,0.0,177,11,14,-21.43
1982,Niue,0,0.0,178,3,0.0,177,3,0.0,178,3,2,50.0
1982,Tuvalu,0,0.0,178,3,0.0,177,3,0.0,178,3,3,0.0
1981,United States of America,238715,11.85,1,273352,13.21,1,512067,12.54,1,34637,31419,10.24
1981,Germany,176047,8.74,2,163941,7.92,2,339988,8.33,2,-12106,-4858,149.2
1981,Japan,151495,7.52,3,142866,6.9,3,294361,7.21,3,-8629,10855,-179.49
1981,France,106424,5.28,5,120953,5.85,4,227377,5.57,4,14529,18836,-22.87
1981,United Kingdom,102244,5.08,6,102708,4.96,5,204952,5.02,5,464,5411,-91.42
1981,Italy,77070,3.83,8,94261,4.56,6,171331,4.2,6,17191,22637,-24.06
1981,"Saudi Arabia, Kingdom of",119876,5.95,4,35269,1.7,11,155145,3.8,7,-84607,-78917,7.21
1981,U.S.S.R.,79425,3.94,7,73200,3.54,7,152625,3.74,8,-6225,-7985,-22.04
1981,Canada,72726,3.61,9,70010,3.38,8,142736,3.5,9,-2716,-5190,-47.67
1981,Netherlands,68715,3.41,10,67231,3.25,9,135946,3.33,10,-1484,4079,-136.38
1981,Belgium-Luxembourg,55688,2.77,11,62426,3.02,10,118114,2.89,11,6738,7320,-7.95
1981,Switzerland,27031,1.34,13,30697,1.48,13,57728,1.41,12,3666,6709,-45.36
1981,Sweden,28658,1.42,12,28840,1.39,14,57498,1.41,13,182,2532,-92.81
1981,Spain,20334,1.01,27,32150,1.55,12,52484,1.29,14,11816,13358,-11.54
1981,Mexico,23307,1.16,14,28462,1.38,15,51769,1.27,15,5155,4113,25.33
1981,Singapore,20967,1.04,24,27572,1.33,16,48539,1.19,16,6605,4631,42.63
1981,"Hong Kong, China",21775,1.08,20,26136,1.26,18,47911,1.17,17,4361,2671,63.27
1981,Australia,21477,1.07,21,26215,1.27,17,47692,1.17,18,4738,455,941.32
1981,"Korea, Republic of",21268,1.06,22,26131,1.26,19,47399,1.16,19,4863,4780,1.74
1981,Brazil,23293,1.16,15,24079,1.16,20,47372,1.16,20,786,4829,-83.72
1981,China,22007,1.09,19,22014,1.06,22,44021,1.08,21,7,1842,-99.62
1981,Chinese Taipei,22593,1.12,16,21130,1.02,23,43723,1.07,22,-1463,-88,1562.5
1981,South Africa,20658,1.03,26,22925,1.11,21,43583,1.07,23,2267,-5927,-138.25
1981,German Democratic Republic,20670,1.03,25,20180,0.98,27,40850,1.0,24,-490,490,-200.0
1981,Nigeria,17845,0.89,29,20877,1.01,25,38722,0.95,25,3032,-9308,-132.57
1981,Austria,15841,0.79,32,21043,1.02,24,36884,0.9,26,5202,6955,-25.2
1981,Indonesia,22260,1.11,18,13272,0.64,36,35532,0.87,27,-8988,-11075,-18.84
1981,"Venezuela, Bolivarian Republic of",20980,1.04,23,13106,0.63,37,34086,0.83,28,-7874,-7394,6.49
1981,Norway,18217,0.9,28,15650,0.76,30,33867,0.83,29,-2567,-1617,58.75
1981,Denmark,16095,0.8,30,17580,0.85,28,33675,0.82,30,1485,2591,-42.69
1981,United Arab Emirates,22380,1.11,17,9646,0.47,46,32026,0.78,31,-12734,-13224,-3.71
1981,Iraq,10530,0.52,43,20735,1.0,26,31265,0.77,32,10205,-12407,-182.25
1981,Czech and Slovak Federal Republic,14910,0.74,34,14670,0.71,34,29580,0.72,33,-240,250,-196.0
1981,Poland,13290,0.66,37,15530,0.75,31,28820,0.71,34,2240,2100,6.67
1981,Finland,14005,0.7,36,14192,0.69,35,28197,0.69,35,187,1485,-87.41
1981,"Yugoslavia, Socialist Federal Republic of",10940,0.54,41,15727,0.76,29,26667,0.65,36,4787,6098,-21.5
1981,Iran,11831,0.59,38,14693,0.71,33,26524,0.65,37,2862,-92,-3210.87
1981,Algeria,14396,0.71,35,11303,0.55,39,25699,0.63,38,-3093,-3313,-6.64
1981,Libya,15571,0.77,33,8382,0.41,53,23953,0.59,39,-7189,-15133,-52.49
1981,India,8295,0.41,46,15418,0.75,32,23713,0.58,40,7123,6278,13.46
1981,Malaysia,11770,0.58,39,11550,0.56,38,23320,0.57,41,-220,-2166,-89.84
1981,"Kuwait, the State of",16044,0.8,31,6978,0.34,56,23022,0.56,42,-9066,-13133,-30.97
1981,Romania,11180,0.56,40,10980,0.53,40,22160,0.54,43,-200,1800,-111.11
1981,Bulgaria,10700,0.53,42,10800,0.52,41,21500,0.53,44,100,-720,-113.89
1981,Argentina,9143,0.45,44,9430,0.46,47,18573,0.45,45,287,2520,-88.61
1981,Ireland,7678,0.38,47,10608,0.51,42,18286,0.45,46,2930,2755,6.35
1981,Hungary,8730,0.43,45,9160,0.44,48,17890,0.44,47,430,580,-25.86
1981,Thailand,7031,0.35,48,9955,0.48,44,16986,0.42,48,2924,2709,7.94
1981,Israel,5670,0.28,51,10235,0.49,43,15905,0.39,49,4565,4246,7.51
1981,Philippines,5655,0.28,52,8478,0.41,52,14133,0.35,50,2823,2550,10.71
1981,Portugal,4148,0.21,60,9800,0.47,45,13948,0.34,51,5652,4669,21.05
1981,Türkiye,4703,0.23,56,8933,0.43,49,13636,0.33,52,4230,5000,-15.4
1981,Bahamas,6189,0.31,49,7284,0.35,54,13473,0.33,53,1095,2537,-56.84
1981,Greece,4246,0.21,59,8810,0.43,50,13056,0.32,54,4564,5395,-15.4
1981,Egypt,3233,0.16,65,8782,0.42,51,12015,0.29,55,5549,1814,205.9
1981,Cuba,5406,0.27,55,6545,0.32,57,11951,0.29,56,1139,928,22.74
1981,New Zealand,5622,0.28,53,5734,0.28,59,11356,0.28,57,112,51,119.61
1981,Netherlands Antilles,5417,0.27,54,5862,0.28,58,11279,0.28,58,445,514,-13.42
1981,Chile,3837,0.19,62,7181,0.35,55,11018,0.27,59,3344,1092,206.23
1981,Pakistan,2883,0.14,67,5631,0.27,60,8514,0.21,60,2748,2732,0.59
1981,"Bahrain, Kingdom of",4347,0.22,58,4124,0.2,64,8471,0.21,61,-223,-123,81.3
1981,Colombia,2916,0.14,66,5201,0.25,61,8117,0.2,62,2285,815,180.37
1981,Syrian Arab Republic,2103,0.1,73,5173,0.25,62,7276,0.18,63,3070,2016,52.28
1981,Qatar,5686,0.28,50,1518,0.07,84,7204,0.18,64,-4168,-4257,-2.09
1981,Oman,4696,0.23,57,2413,0.12,71,7109,0.17,65,-2283,-2016,13.24
1981,Trinidad and Tobago,3761,0.19,63,3125,0.15,69,6886,0.17,66,-636,-899,-29.25
1981,Morocco,2386,0.12,71,4400,0.21,63,6786,0.17,67,2014,1814,11.03
1981,Peru,3255,0.16,64,3160,0.15,68,6415,0.16,68,-95,-1325,-92.83
1981,Tunisia,2500,0.12,69,3791,0.18,65,6291,0.15,69,1291,1342,-3.8
1981,Côte d'Ivoire,2533,0.13,68,2382,0.12,72,4915,0.12,70,-151,-167,-9.58
1981,Ecuador,2451,0.12,70,2246,0.11,73,4697,0.12,71,-205,-228,-10.09
1981,Brunei Darussalam,4037,0.2,61,594,0.03,117,4631,0.11,72,-3443,-4009,-14.12
1981,Lebanese Republic,920,0.05,89,3499,0.17,66,4419,0.11,73,2579,2695,-4.3
1981,Jordan,733,0.04,97,3165,0.15,67,3898,0.1,74,2432,1828,33.04
1981,Angola,1856,0.09,74,1662,0.08,80,3518,0.09,75,-194,-555,-65.05
1981,Bangladesh,791,0.04,95,2699,0.13,70,3490,0.09,76,1908,1840,3.7
1981,Dominican Republic,1457,0.07,76,1951,0.09,74,3408,0.08,77,494,747,-33.87
1981,Zimbabwe,1407,0.07,77,1696,0.08,78,3103,0.08,78,289,34,750.0
1981,Democratic Republic of the Congo,1678,0.08,75,1421,0.07,88,3099,0.08,79,-257,-750,-65.73
1981,Kenya,1139,0.06,80,1939,0.09,75,3078,0.08,80,800,880,-9.09
1981,Gabon,2201,0.11,72,841,0.04,106,3042,0.07,81,-1360,-1499,-9.27
1981,Sri Lanka,1088,0.05,82,1849,0.09,76,2937,0.07,82,761,975,-21.95
1981,Guatemala,1226,0.06,78,1688,0.08,79,2914,0.07,83,462,78,492.31
1981,Uruguay,1215,0.06,79,1641,0.08,81,2856,0.07,84,426,621,-31.4
1981,Cameroon,1105,0.05,81,1427,0.07,87,2532,0.06,85,322,218,47.71
1981,"Korea, Democratic People's Republic of",1000,0.05,87,1500,0.07,85,2500,0.06,86,500,300,66.67
1981,Jamaica,974,0.05,88,1473,0.07,86,2447,0.06,87,499,208,139.9
1981,Zambia,1079,0.05,84,1261,0.06,91,2340,0.06,88,182,41,343.9
1981,Namibia,1088,0.05,82,1244,0.06,93,2332,0.06,89,156,-303,-151.49
1981,Costa Rica,1008,0.05,86,1209,0.06,95,2217,0.05,90,201,538,-62.64
1981,Sudan,657,0.03,100,1553,0.08,82,2210,0.05,91,896,1033,-13.26
1981,Ghana,1065,0.05,85,1106,0.05,97,2171,0.05,92,41,-129,-131.78
1981,Papua New Guinea,838,0.04,92,1261,0.06,91,2099,0.05,93,423,145,191.72
1981,"Yemen, People's Democratic Republic",607,0.03,101,1419,0.07,89,2026,0.05,94,812,750,8.27
1981,Iceland,894,0.04,91,1024,0.05,99,1918,0.05,95,130,81,60.49
1981,Panama,328,0.02,121,1540,0.07,83,1868,0.05,96,1212,1088,11.4
1981,"Bolivia, Plurinational State of",912,0.05,90,917,0.04,103,1829,0.04,97,5,-277,-101.81
1981,Yemen,47,0.0,148,1758,0.08,77,1805,0.04,98,1711,1830,-6.5
1981,Tanzania,580,0.03,102,1213,0.06,94,1793,0.04,99,633,741,-14.57
1981,El Salvador,797,0.04,94,986,0.05,101,1783,0.04,100,189,-1,-19000.0
1981,Viet Nam,401,0.02,113,1382,0.07,90,1783,0.04,100,981,976,0.51
1981,Cyprus,562,0.03,103,1166,0.06,96,1728,0.04,102,604,670,-9.85
1981,Honduras,761,0.04,96,949,0.05,102,1710,0.04,103,188,179,5.03
1981,Afghanistan,694,0.03,98,886,0.04,104,1580,0.04,104,192,171,12.28
1981,Senegal,500,0.02,106,1076,0.05,98,1576,0.04,105,576,575,0.17
1981,Nicaragua,508,0.03,105,999,0.05,100,1507,0.04,106,491,436,12.61
1981,"Macao, China",686,0.03,99,711,0.03,112,1397,0.03,107,25,-69,-136.23
1981,Malta,449,0.02,111,860,0.04,105,1309,0.03,108,411,455,-9.67
1981,Congo,811,0.04,93,446,0.02,129,1257,0.03,109,-365,-331,10.27
1981,Botswana,397,0.02,115,797,0.04,108,1194,0.03,110,400,190,110.53
1981,Mongolia,469,0.02,108,704,0.03,113,1173,0.03,111,235,145,62.07
1981,Ethiopia,380,0.02,117,739,0.04,111,1119,0.03,112,359,291,23.37
1981,Mozambique,281,0.01,125,801,0.04,107,1082,0.03,113,520,519,0.19
1981,Suriname,474,0.02,107,568,0.03,120,1042,0.03,114,94,-10,-1040.0
1981,Fiji,400,0.02,114,631,0.03,115,1031,0.03,115,231,92,151.09
1981,Eswatini,391,0.02,116,594,0.03,117,985,0.02,116,203,254,-20.08
1981,Liberia,529,0.03,104,447,0.02,128,976,0.02,117,-82,-65,26.15
1981,Niger,455,0.02,110,510,0.02,126,965,0.02,118,55,28,96.43
1981,Martinique,184,0.01,132,776,0.04,110,960,0.02,119,592,713,-16.97
1981,Paraguay,296,0.01,123,600,0.03,116,896,0.02,120,304,305,-0.33
1981,Mauritius,332,0.02,120,563,0.03,121,895,0.02,121,231,178,29.78
1981,Reunion,107,0.01,138,787,0.04,109,894,0.02,122,680,758,-10.29
1981,Madagascar,316,0.02,122,545,0.03,123,861,0.02,123,229,199,15.08
1981,Myanmar,466,0.02,109,376,0.02,133,842,0.02,124,-90,-120,-25.0
1981,Guyana,352,0.02,118,438,0.02,130,790,0.02,125,86,-31,-377.42
1981,Guinea,430,0.02,112,351,0.02,137,781,0.02,126,-79,-41,92.68
1981,Barbados,195,0.01,130,571,0.03,119,766,0.02,127,376,298,26.17
1981,New Caledonia,343,0.02,119,408,0.02,132,751,0.02,128,65,38,71.05
1981,Guadeloupe,92,0.0,139,652,0.03,114,744,0.02,129,560,572,-2.1
1981,Togo,208,0.01,128,434,0.02,131,642,0.02,130,226,213,6.1
1981,Malawi,283,0.01,124,359,0.02,136,642,0.02,130,76,144,-47.22
1981,Haiti,152,0.01,134,461,0.02,127,613,0.02,132,309,149,107.38
1981,Uganda,243,0.01,127,345,0.02,138,588,0.01,133,102,-52,-296.15
1981,Benin,34,0.0,151,543,0.03,124,577,0.01,134,509,268,89.93
1981,French Polynesia,29,0.0,154,546,0.03,122,575,0.01,135,517,517,0.0
1981,Lesotho,50,0.0,147,516,0.02,125,566,0.01,136,466,406,14.78
1981,Mauritania,261,0.01,126,265,0.01,144,526,0.01,137,4,92,-95.65
1981,Mali,154,0.01,133,365,0.02,135,519,0.01,138,211,234,-9.83
1981,Nepal,141,0.01,136,369,0.02,134,510,0.01,139,228,262,-12.98
1981,Greenland,186,0.01,131,294,0.01,142,480,0.01,140,108,142,-23.94
1981,Sierra Leone,150,0.01,135,328,0.02,140,478,0.01,141,178,203,-12.32
1981,American Samoa,199,0.01,129,234,0.01,146,433,0.01,142,35,-32,-209.38
1981,Burkina Faso,74,0.0,145,338,0.02,139,412,0.01,143,264,269,-1.86
1981,Rwanda,82,0.0,141,283,0.01,143,365,0.01,144,201,171,17.54
1981,Bermuda,29,0.0,154,323,0.02,141,352,0.01,145,294,275,6.91
1981,French Guiana,34,0.0,151,250,0.01,145,284,0.01,146,216,230,-6.09
1981,Belize,119,0.01,137,162,0.01,149,281,0.01,147,43,39,10.26
1981,Burundi,75,0.0,144,161,0.01,150,236,0.01,148,86,103,-16.5
1981,Djibouti,9,0.0,169,224,0.01,147,233,0.01,149,215,200,7.5
1981,Chad,83,0.0,140,108,0.01,155,191,0.0,150,25,3,733.33
1981,Cambodia,10,0.0,168,180,0.01,148,190,0.0,151,170,164,3.66
1981,Saint Lucia,46,0.0,149,129,0.01,151,175,0.0,152,83,66,25.76
1981,Central African Republic,79,0.0,142,95,0.0,156,174,0.0,153,16,-35,-145.71
1981,Solomon Islands,66,0.0,146,91,0.0,158,157,0.0,154,25,15,66.67
1981,The Gambia,27,0.0,156,126,0.01,152,153,0.0,155,99,134,-26.12
1981,Antigua and Barbuda,40,0.0,150,111,0.01,153,151,0.0,156,71,62,14.52
1981,Lao People's Democratic Republic,23,0.0,158,110,0.01,154,133,0.0,157,87,64,35.94
1981,Seychelles,17,0.0,163,93,0.0,157,110,0.0,158,76,78,-2.56
1981,Vanuatu,32,0.0,153,58,0.0,161,90,0.0,159,26,37,-29.73
1981,Bhutan,20,0.0,160,68,0.0,160,88,0.0,160,48,33,45.45
1981,Saint Vincent and the Grenadines,24,0.0,157,58,0.0,161,82,0.0,161,34,42,-19.05
1981,Guam,77,0.0,143,0,0.0,179,77,0.0,162,-77,-61,26.23
1981,Cabo Verde,3,0.0,176,71,0.0,159,74,0.0,163,68,63,7.94
1981,Grenada,19,0.0,161,54,0.0,164,73,0.0,164,35,33,6.06
1981,Saint Kitts and Nevis,22,0.0,159,48,0.0,167,70,0.0,165,26,21,23.81
1981,Dominica,19,0.0,161,50,0.0,165,69,0.0,166,31,38,-18.42
1981,Samoa,11,0.0,166,56,0.0,163,67,0.0,167,45,45,0.0
1981,Guinea-Bissau,14,0.0,165,50,0.0,165,64,0.0,168,36,44,-18.18
1981,Comoros,16,0.0,164,32,0.0,170,48,0.0,169,16,20,-20.0
1981,Tonga,8,0.0,171,40,0.0,169,48,0.0,169,32,31,3.23
1981,Saint Pierre and Miquelon,7,0.0,173,41,0.0,168,48,0.0,169,34,36,-5.56
1981,Maldives,9,0.0,169,31,0.0,171,40,0.0,172,22,21,4.76
1981,Equatorial Guinea,11,0.0,166,27,0.0,172,38,0.0,173,16,12,33.33
1981,Cook Islands,4,0.0,174,25,0.0,173,29,0.0,174,21,19,10.53
1981,Sao Tomé and Principe,8,0.0,171,17,0.0,174,25,0.0,175,9,3,200.0
1981,Kiribati,4,0.0,174,14,0.0,176,18,0.0,176,10,14,-28.57
1981,Montserrat,1,0.0,177,15,0.0,175,16,0.0,177,14,11,27.27
1981,Niue,1,0.0,177,3,0.0,177,4,0.0,178,2,3,-33.33
1981,Tuvalu,0,0.0,179,3,0.0,177,3,0.0,179,3,4,-25.0
1980,United States of America,225566,11.08,1,256985,12.38,1,482551,11.74,1,31419,35862,-12.39
1980,Germany,192860,9.47,2,188002,9.06,2,380862,9.26,2,-4858,-12158,-60.04
1980,Japan,130441,6.41,3,141296,6.81,3,271737,6.61,3,10855,7532,44.12
1980,France,116030,5.7,4,134866,6.5,4,250896,6.1,4,18836,6317,198.18
1980,United Kingdom,110134,5.41,5,115545,5.57,5,225679,5.49,5,5411,13203,-59.02
1980,Italy,78104,3.84,7,100741,4.85,6,178845,4.35,6,22637,5662,299.81
1980,Netherlands,73960,3.63,9,78039,3.76,7,151999,3.7,7,4079,3794,7.51
1980,U.S.S.R.,76500,3.76,8,68515,3.3,9,145015,3.53,8,-7985,-6990,14.23
1980,"Saudi Arabia, Kingdom of",109083,5.36,6,30166,1.45,14,139249,3.39,9,-78917,-38965,102.53
1980,Belgium-Luxembourg,64540,3.17,11,71860,3.46,8,136400,3.32,10,7320,4213,73.75
1980,Canada,67734,3.33,10,62544,3.01,10,130278,3.17,11,-5190,-1652,214.16
1980,Switzerland,29632,1.46,13,36341,1.75,11,65973,1.6,12,6709,2818,138.08
1980,Sweden,30906,1.52,12,33438,1.61,13,64344,1.56,13,2532,1133,123.48
1980,Spain,20720,1.02,21,34078,1.64,12,54798,1.33,14,13358,7230,84.76
1980,South Africa,25525,1.25,16,19598,0.94,24,45123,1.1,15,-5927,-9269,-36.06
1980,Brazil,20132,0.99,23,24961,1.2,15,45093,1.1,16,4829,4560,5.9
1980,Australia,21944,1.08,18,22399,1.08,19,44343,1.08,17,455,-472,-196.4
1980,Singapore,19376,0.95,26,24007,1.16,17,43383,1.06,18,4631,3410,35.81
1980,"Hong Kong, China",20323,1.0,22,22994,1.11,18,43317,1.05,19,2671,1987,34.42
1980,Nigeria,25968,1.28,15,16660,0.8,29,42628,1.04,20,-9308,-7116,30.8
1980,Austria,17489,0.86,33,24444,1.18,16,41933,1.02,21,6955,4771,45.78
1980,Iraq,26349,1.29,14,13942,0.67,34,40291,0.98,22,-12407,-14393,-13.8
1980,Mexico,18031,0.89,31,22144,1.07,21,40175,0.98,23,4113,3104,32.51
1980,"Korea, Republic of",17512,0.86,32,22292,1.07,20,39804,0.97,24,4780,5282,-9.5
1980,Chinese Taipei,19842,0.97,24,19754,0.95,23,39596,0.96,25,-88,-1287,-93.16
1980,China,18099,0.89,30,19941,0.96,22,38040,0.93,26,1842,2007,-8.22
1980,German Democratic Republic,18590,0.91,28,19080,0.92,27,37670,0.92,27,490,1151,-57.43
1980,Poland,17020,0.84,34,19120,0.92,26,36140,0.88,28,2100,2060,1.94
1980,Denmark,16749,0.82,35,19340,0.93,25,36089,0.88,29,2591,3705,-30.07
1980,Norway,18543,0.91,29,16926,0.82,28,35469,0.86,30,-1617,160,-1110.63
1980,Indonesia,21909,1.08,20,10834,0.52,39,32743,0.8,31,-11075,-8389,32.02
1980,"Venezuela, Bolivarian Republic of",19221,0.94,27,11827,0.57,37,31048,0.76,32,-7394,-3647,102.74
1980,United Arab Emirates,21970,1.08,17,8746,0.42,49,30716,0.75,33,-13224,-6686,97.79
1980,Czech and Slovak Federal Republic,14930,0.73,36,15180,0.73,31,30110,0.73,34,250,1065,-76.53
1980,Finland,14150,0.7,37,15635,0.75,30,29785,0.72,35,1485,226,557.08
1980,Libya,21910,1.08,19,6777,0.33,53,28687,0.7,36,-15133,-10765,40.58
1980,"Kuwait, the State of",19663,0.97,25,6530,0.31,54,26193,0.64,37,-13133,-13203,-0.53
1980,Romania,11400,0.56,41,13200,0.64,35,24600,0.6,38,1800,2065,-12.83
1980,Iran,12338,0.61,40,12246,0.59,36,24584,0.6,39,-92,1428,-106.44
1980,Algeria,13871,0.68,38,10558,0.51,41,24429,0.59,40,-3313,-1148,188.59
1980,"Yugoslavia, Socialist Federal Republic of",8978,0.44,43,15076,0.73,32,24054,0.58,41,6098,6372,-4.3
1980,Malaysia,12945,0.64,39,10779,0.52,40,23724,0.58,42,-2166,-3230,-32.94
1980,India,8586,0.42,45,14864,0.72,33,23450,0.57,43,6278,2021,210.64
1980,Bulgaria,10390,0.51,42,9670,0.47,45,20060,0.49,44,-720,-355,102.82
1980,Ireland,8398,0.41,46,11153,0.54,38,19551,0.48,45,2755,2741,0.51
1980,Argentina,8021,0.39,47,10541,0.51,43,18562,0.45,46,2520,-1110,-327.03
1980,Hungary,8610,0.42,44,9190,0.44,48,17800,0.43,47,580,752,-22.87
1980,Thailand,6505,0.32,48,9214,0.44,47,15719,0.38,48,2709,1860,45.65
1980,Greece,5153,0.25,55,10548,0.51,42,15701,0.38,49,5395,5729,-5.83
1980,Israel,5538,0.27,52,9784,0.47,44,15322,0.37,50,4246,4030,5.36
1980,Philippines,5741,0.28,49,8291,0.4,50,14032,0.34,51,2550,2046,24.63
1980,Portugal,4640,0.23,58,9309,0.45,46,13949,0.34,52,4669,3055,52.83
1980,Bahamas,5009,0.25,56,7546,0.36,52,12555,0.31,53,2537,-272,-1032.72
1980,Cuba,5577,0.27,51,6505,0.31,55,12082,0.29,54,928,258,259.69
1980,New Zealand,5421,0.27,53,5472,0.26,58,10893,0.26,55,51,-153,-133.33
1980,Netherlands Antilles,5162,0.25,54,5676,0.27,57,10838,0.26,56,514,429,19.81
1980,Türkiye,2910,0.14,67,7910,0.38,51,10820,0.26,57,5000,2809,78.0
1980,Chile,4705,0.23,57,5797,0.28,56,10502,0.26,58,1092,914,19.47
1980,Colombia,3924,0.19,61,4739,0.23,61,8663,0.21,59,815,-47,-1834.04
1980,Pakistan,2618,0.13,68,5350,0.26,59,7968,0.19,60,2732,2036,34.18
1980,Egypt,3046,0.15,66,4860,0.23,60,7906,0.19,61,1814,1997,-9.16
1980,Trinidad and Tobago,4077,0.2,60,3178,0.15,67,7255,0.18,62,-899,-505,78.02
1980,Qatar,5680,0.28,50,1423,0.07,87,7103,0.17,63,-4257,-2329,82.78
1980,"Bahrain, Kingdom of",3606,0.18,64,3483,0.17,66,7089,0.17,64,-123,-12,925.0
1980,Morocco,2441,0.12,70,4255,0.2,62,6696,0.16,65,1814,1719,5.53
1980,Peru,3898,0.19,62,2573,0.12,70,6471,0.16,66,-1325,-1671,-20.71
1980,Syrian Arab Republic,2108,0.1,74,4124,0.2,63,6232,0.15,67,2016,1685,19.64
1980,Côte d'Ivoire,3134,0.15,65,2967,0.14,68,6101,0.15,68,-167,-23,626.09
1980,Tunisia,2198,0.11,72,3540,0.17,65,5738,0.14,69,1342,1058,26.84
1980,Oman,3748,0.18,63,1732,0.08,77,5480,0.13,70,-2016,-324,522.22
1980,Brunei Darussalam,4581,0.23,59,572,0.03,119,5153,0.13,71,-4009,-2270,76.61
1980,Ecuador,2481,0.12,69,2253,0.11,72,4734,0.12,72,-228,-504,-54.76
1980,Lebanese Republic,955,0.05,90,3650,0.18,64,4605,0.11,73,2695,1850,45.68
1980,Democratic Republic of the Congo,2269,0.11,71,1519,0.07,84,3788,0.09,74,-750,-1315,-42.97
1980,Kenya,1245,0.06,82,2125,0.1,73,3370,0.08,75,880,546,61.17
1980,Bangladesh,759,0.04,97,2599,0.13,69,3358,0.08,76,1840,1249,47.32
1980,Angola,1883,0.09,75,1328,0.06,89,3211,0.08,77,-555,21,-2742.86
1980,Dominican Republic,1217,0.06,83,1964,0.09,75,3181,0.08,78,747,344,117.15
1980,Guatemala,1520,0.07,76,1598,0.08,80,3118,0.08,79,78,263,-70.34
1980,Sri Lanka,1062,0.05,84,2037,0.1,74,3099,0.08,80,975,485,101.03
1980,Cameroon,1384,0.07,79,1602,0.08,79,2986,0.07,81,218,143,52.45
1980,Jordan,574,0.03,101,2402,0.12,71,2976,0.07,82,1828,1560,17.18
1980,Zimbabwe,1414,0.07,78,1448,0.07,86,2862,0.07,83,34,-123,-127.64
1980,Gabon,2173,0.11,73,674,0.03,111,2847,0.07,84,-1499,-1316,13.91
1980,Uruguay,1059,0.05,85,1680,0.08,78,2739,0.07,85,621,418,48.56
1980,Zambia,1298,0.06,80,1339,0.06,88,2637,0.06,86,41,-624,-106.57
1980,Namibia,1459,0.07,77,1156,0.06,96,2615,0.06,87,-303,,
1980,Costa Rica,1002,0.05,87,1540,0.07,82,2542,0.06,88,538,463,16.2
1980,Ghana,1258,0.06,81,1129,0.05,97,2387,0.06,89,-129,-143,-9.79
1980,"Yemen, People's Democratic Republic",777,0.04,96,1527,0.07,83,2304,0.06,90,750,459,63.4
1980,Papua New Guinea,1031,0.05,86,1176,0.06,94,2207,0.05,91,145,-61,-337.7
1980,Jamaica,963,0.05,89,1171,0.06,95,2134,0.05,92,208,175,18.86
1980,Sudan,543,0.03,103,1576,0.08,81,2119,0.05,93,1033,574,79.97
1980,"Korea, Democratic People's Republic of",900,0.04,94,1200,0.06,93,2100,0.05,94,300,,
1980,El Salvador,967,0.05,88,966,0.05,101,1933,0.05,95,-1,-186,-99.46
1980,Iceland,918,0.05,92,999,0.05,100,1917,0.05,96,81,33,145.45
1980,Yemen,23,0.0,158,1853,0.09,76,1876,0.05,97,1830,1478,23.82
1980,Honduras,830,0.04,95,1009,0.05,99,1839,0.04,98,179,92,94.57
1980,Panama,361,0.02,121,1449,0.07,85,1810,0.04,99,1088,881,23.5
1980,Tanzania,511,0.03,106,1252,0.06,91,1763,0.04,100,741,608,21.88
1980,Cyprus,532,0.03,104,1202,0.06,92,1734,0.04,101,670,554,20.94
1980,Viet Nam,338,0.02,123,1314,0.06,90,1652,0.04,102,976,1012,-3.56
1980,"Bolivia, Plurinational State of",942,0.05,91,665,0.03,112,1607,0.04,103,-277,134,-306.72
1980,Senegal,477,0.02,109,1052,0.05,98,1529,0.04,104,575,396,45.2
1980,Afghanistan,670,0.03,98,841,0.04,106,1511,0.04,105,171,-49,-448.98
1980,Congo,911,0.04,93,580,0.03,118,1491,0.04,106,-331,-205,61.46
1980,Malta,483,0.02,108,938,0.05,102,1421,0.03,107,455,335,35.82
1980,Nicaragua,451,0.02,112,887,0.04,104,1338,0.03,108,436,-207,-310.63
1980,Botswana,502,0.02,107,692,0.03,109,1194,0.03,109,190,87,118.39
1980,Niger,566,0.03,102,594,0.03,117,1160,0.03,110,28,13,115.38
1980,"Macao, China",613,0.03,99,544,0.03,124,1157,0.03,111,-69,-38,81.58
1980,Ethiopia,425,0.02,114,716,0.03,108,1141,0.03,112,291,149,95.3
1980,Liberia,600,0.03,100,535,0.03,125,1135,0.03,113,-65,-30,116.67
1980,Mozambique,281,0.01,127,800,0.04,107,1081,0.03,114,519,314,65.29
1980,Mauritius,431,0.02,113,609,0.03,115,1040,0.03,115,178,193,-7.77
1980,Fiji,470,0.02,111,562,0.03,120,1032,0.03,116,92,156,-41.03
1980,Suriname,514,0.03,105,504,0.02,127,1018,0.02,117,-10,-33,-69.7
1980,Reunion,130,0.01,135,888,0.04,103,1018,0.02,117,758,619,22.46
1980,Madagascar,401,0.02,117,600,0.03,116,1001,0.02,119,199,247,-19.43
1980,Eswatini,369,0.02,120,623,0.03,113,992,0.02,120,254,203,25.12
1980,Martinique,131,0.01,134,844,0.04,105,975,0.02,121,713,543,31.31
1980,Mongolia,403,0.02,116,548,0.03,122,951,0.02,122,145,,
1980,Paraguay,310,0.02,125,615,0.03,114,925,0.02,123,305,216,41.2
1980,Togo,338,0.02,123,551,0.03,121,889,0.02,124,213,301,-29.24
1980,New Caledonia,418,0.02,115,456,0.02,129,874,0.02,125,38,-7,-642.86
1980,Myanmar,477,0.02,109,357,0.02,137,834,0.02,126,-120,-65,84.62
1980,Guadeloupe,107,0.01,139,679,0.03,110,786,0.02,127,572,485,17.94
1980,Guyana,396,0.02,119,365,0.02,134,761,0.02,128,-31,25,-224.0
1980,Guinea,401,0.02,117,360,0.02,135,761,0.02,128,-41,-119,-65.55
1980,Barbados,226,0.01,128,524,0.03,126,750,0.02,130,298,273,9.16
1980,Malawi,295,0.01,126,439,0.02,130,734,0.02,131,144,166,-13.25
1980,Sierra Leone,224,0.01,130,427,0.02,132,651,0.02,132,203,116,75.0
1980,Mali,205,0.01,131,439,0.02,130,644,0.02,133,234,213,9.86
1980,Uganda,345,0.02,122,293,0.01,142,638,0.02,134,-52,-238,-78.15
1980,Haiti,226,0.01,128,375,0.02,133,601,0.01,135,149,87,71.26
1980,French Polynesia,30,0.0,153,547,0.03,123,577,0.01,136,517,447,15.66
1980,Lesotho,58,0.0,148,464,0.02,128,522,0.01,137,406,283,43.46
1980,Greenland,186,0.01,133,328,0.02,140,514,0.01,138,142,110,29.09
1980,Mauritania,194,0.01,132,286,0.01,143,480,0.01,139,92,112,-17.86
1980,Burkina Faso,90,0.0,140,359,0.02,136,449,0.01,140,269,224,20.09
1980,Nepal,80,0.0,141,342,0.02,138,422,0.01,141,262,145,80.69
1980,Benin,63,0.0,146,331,0.02,139,394,0.01,142,268,274,-2.19
1980,Bermuda,37,0.0,150,312,0.02,141,349,0.01,143,275,,
1980,Rwanda,72,0.0,143,243,0.01,145,315,0.01,144,171,74,131.08
1980,French Guiana,25,0.0,156,255,0.01,144,280,0.01,145,230,234,-1.71
1980,Belize,111,0.01,138,150,0.01,150,261,0.01,146,39,45,-13.33
1980,Burundi,65,0.0,145,168,0.01,148,233,0.01,147,103,48,114.58
1980,Djibouti,13,0.0,167,213,0.01,146,226,0.01,148,200,177,12.99
1980,American Samoa,127,0.01,136,95,0.0,153,222,0.01,149,-32,-85,-62.35
1980,Central African Republic,116,0.01,137,81,0.0,157,197,0.0,150,-35,-10,250.0
1980,The Gambia,31,0.0,152,165,0.01,149,196,0.0,151,134,83,61.45
1980,Cambodia,16,0.0,163,180,0.01,147,196,0.0,151,164,135,21.48
1980,Saint Lucia,58,0.0,148,124,0.01,151,182,0.0,153,66,65,1.54
1980,Solomon Islands,74,0.0,142,89,0.0,155,163,0.0,154,15,0,
1980,Chad,71,0.0,144,74,0.0,158,145,0.0,155,3,-3,-200.0
1980,Seychelles,21,0.0,159,99,0.0,152,120,0.0,156,78,63,23.81
1980,Lao People's Democratic Republic,28,0.0,154,92,0.0,154,120,0.0,156,64,51,25.49
1980,Antigua and Barbuda,26,0.0,155,88,0.0,156,114,0.0,158,62,26,138.46
1980,Vanuatu,36,0.0,151,73,0.0,159,109,0.0,159,37,20,85.0
1980,Samoa,17,0.0,160,62,0.0,161,79,0.0,160,45,55,-18.18
1980,Cabo Verde,5,0.0,174,68,0.0,160,73,0.0,161,63,51,23.53
1980,Saint Vincent and the Grenadines,15,0.0,165,57,0.0,162,72,0.0,162,42,32,31.25
1980,Saint Kitts and Nevis,24,0.0,157,45,0.0,167,69,0.0,163,21,16,31.25
1980,Bhutan,17,0.0,160,50,0.0,164,67,0.0,164,33,,
1980,Grenada,17,0.0,160,50,0.0,164,67,0.0,164,33,23,43.48
1980,Guinea-Bissau,11,0.0,168,55,0.0,163,66,0.0,166,44,48,-8.33
1980,Guam,61,0.0,147,0,0.0,179,61,0.0,167,-61,-25,144.0
1980,Dominica,10,0.0,169,48,0.0,166,58,0.0,168,38,13,192.31
1980,Saint Pierre and Miquelon,6,0.0,173,42,0.0,168,48,0.0,169,36,31,16.13
1980,Tonga,7,0.0,172,38,0.0,169,45,0.0,170,31,22,40.91
1980,Equatorial Guinea,14,0.0,166,26,0.0,172,40,0.0,171,12,-10,-220.0
1980,Comoros,9,0.0,170,29,0.0,170,38,0.0,172,20,12,66.67
1980,Maldives,8,0.0,171,29,0.0,170,37,0.0,173,21,16,31.25
1980,Sao Tomé and Principe,16,0.0,163,19,0.0,174,35,0.0,174,3,-7,-142.86
1980,Cook Islands,4,0.0,175,23,0.0,173,27,0.0,175,19,19,0.0
1980,Kiribati,3,0.0,176,17,0.0,175,20,0.0,176,14,-11,-227.27
1980,Montserrat,1,0.0,177,12,0.0,176,13,0.0,177,11,9,22.22
1980,Tuvalu,0,0.0,178,4,0.0,177,4,0.0,178,4,,
1980,Niue,0,0.0,178,3,0.0,178,3,0.0,179,3,,
1979,United States of America,186363,11.23,1,222225,13.12,1,408588,12.18,1,35862,40199,-10.79
1979,Germany,171804,10.35,2,159646,9.43,2,331450,9.88,2,-12158,-20699,-41.26
1979,Japan,102299,6.16,3,109831,6.49,3,212130,6.33,3,7532,-18289,-141.18
1979,France,100692,6.07,4,107009,6.32,4,207701,6.19,4,6317,2417,161.36
1979,United Kingdom,86397,5.21,5,99600,5.88,5,185997,5.55,5,13203,7926,66.58
1979,Netherlands,73537,4.43,6,77331,4.57,7,150868,4.5,6,3794,3724,1.88
1979,Italy,72233,4.35,7,77895,4.6,6,150128,4.48,7,5662,406,1294.58
1979,U.S.S.R.,64761,3.9,8,57771,3.41,9,122532,3.65,8,-6990,-1673,317.81
1979,Belgium-Luxembourg,56700,3.42,11,60913,3.6,8,117613,3.51,9,4213,3662,15.05
1979,Canada,58294,3.51,10,56642,3.34,10,114936,3.43,10,-1652,-2154,-23.31
1979,"Saudi Arabia, Kingdom of",63427,3.82,9,24462,1.44,14,87889,2.62,11,-38965,-20313,91.82
1979,Sweden,27602,1.66,12,28735,1.7,12,56337,1.68,12,1133,-1201,-194.34
1979,Switzerland,26538,1.6,13,29356,1.73,11,55894,1.67,13,2818,244,1054.92
1979,Spain,18208,1.1,18,25438,1.5,13,43646,1.3,14,7230,5598,29.15
1979,Australia,18663,1.12,15,18191,1.07,19,36854,1.1,15,-472,1151,-141.01
1979,Austria,15481,0.93,23,20252,1.2,16,35733,1.07,16,4771,3844,24.12
1979,"Korea, Republic of",15057,0.91,27,20339,1.2,15,35396,1.06,17,5282,2250,134.76
1979,Brazil,15244,0.92,24,19804,1.17,17,35048,1.05,18,4560,2395,90.4
1979,Denmark,14696,0.89,28,18401,1.09,18,33097,0.99,19,3705,2925,26.67
1979,"Hong Kong, China",15140,0.91,25,17127,1.01,21,32267,0.96,20,1987,1941,2.37
1979,Singapore,14233,0.86,30,17643,1.04,20,31876,0.95,21,3410,2927,16.5
1979,German Democratic Republic,15063,0.91,26,16214,0.96,22,31277,0.93,22,1151,1305,-11.8
1979,Chinese Taipei,16081,0.97,20,14794,0.87,25,30875,0.92,23,-1287,-1631,-21.09
1979,Poland,14082,0.85,31,16142,0.95,23,30224,0.9,24,2060,2506,-17.8
1979,China,13614,0.82,33,15621,0.92,24,29235,0.87,25,2007,1176,70.66
1979,Iraq,21572,1.3,14,7179,0.42,45,28751,0.86,26,-14393,-6851,110.09
1979,Nigeria,17334,1.04,19,10218,0.6,33,27552,0.82,27,-7116,2883,-346.83
1979,Czech and Slovak Federal Republic,13197,0.8,35,14262,0.84,26,27459,0.82,28,1065,818,30.2
1979,Norway,13546,0.82,34,13706,0.81,27,27252,0.81,29,160,615,-73.98
1979,South Africa,18258,1.1,17,8989,0.53,38,27247,0.81,30,-9269,-5157,79.74
1979,"Venezuela, Bolivarian Republic of",14317,0.86,29,10670,0.63,32,24987,0.75,31,-3647,2580,-241.36
1979,"Kuwait, the State of",18404,1.11,16,5201,0.31,52,23605,0.7,32,-13203,-5829,126.51
1979,Indonesia,15591,0.94,22,7202,0.43,44,22793,0.68,33,-8389,-4953,69.37
1979,Finland,11172,0.67,36,11398,0.67,31,22570,0.67,34,226,-704,-132.1
1979,Romania,9724,0.59,38,11789,0.7,30,21513,0.64,35,2065,1552,33.05
1979,Libya,16076,0.97,21,5311,0.31,51,21387,0.64,36,-10765,-5292,103.42
1979,Mexico,8982,0.54,40,12086,0.71,29,21068,0.63,37,3104,2104,47.53
1979,United Arab Emirates,13652,0.82,32,6966,0.41,47,20618,0.61,38,-6686,-3755,78.06
1979,"Yugoslavia, Socialist Federal Republic of",6491,0.39,47,12863,0.76,28,19354,0.58,39,6372,4317,47.6
1979,Malaysia,11079,0.67,37,7849,0.46,43,18928,0.56,40,-3230,-1495,116.05
1979,Iran,8310,0.5,42,9738,0.57,36,18048,0.54,41,1428,4990,-71.38
1979,Algeria,9551,0.58,39,8403,0.5,42,17954,0.54,42,-1148,2222,-151.67
1979,India,7806,0.47,45,9827,0.58,35,17633,0.53,43,2021,1194,69.26
1979,Bulgaria,8869,0.53,41,8514,0.5,41,17383,0.52,44,-355,173,-305.2
1979,Ireland,7143,0.43,46,9884,0.58,34,17027,0.51,45,2741,1430,91.68
1979,Hungary,7930,0.48,43,8682,0.51,39,16612,0.5,46,752,1582,-52.47
1979,Argentina,7810,0.47,44,6700,0.4,48,14510,0.43,47,-1110,-2566,-56.74
1979,Greece,3885,0.23,55,9614,0.57,37,13499,0.4,48,5729,4461,28.42
1979,Israel,4546,0.27,52,8576,0.51,40,13122,0.39,49,4030,3494,15.34
1979,Thailand,5298,0.32,48,7158,0.42,46,12456,0.37,50,1860,1271,46.34
1979,Philippines,4567,0.28,51,6613,0.39,49,11180,0.33,51,2046,1743,17.38
1979,Portugal,3479,0.21,59,6534,0.39,50,10013,0.3,52,3055,2823,8.22
1979,Cuba,4827,0.29,49,5085,0.3,53,9912,0.3,53,258,293,-11.95
1979,New Zealand,4706,0.28,50,4553,0.27,56,9259,0.28,54,-153,-247,-38.06
1979,Chile,3894,0.23,54,4808,0.28,55,8702,0.26,55,914,930,-1.72
1979,Netherlands Antilles,3966,0.24,53,4395,0.26,58,8361,0.25,56,429,515,-16.7
1979,Türkiye,2261,0.14,66,5070,0.3,54,7331,0.22,57,2809,2311,21.55
1979,Bahamas,3786,0.23,56,3514,0.21,61,7300,0.22,58,-272,92,-395.65
1979,Pakistan,2462,0.15,65,4498,0.27,57,6960,0.21,59,2036,2225,-8.49
1979,Colombia,3411,0.21,60,3364,0.2,62,6775,0.2,60,-47,-39,20.51
1979,Egypt,1840,0.11,70,3837,0.23,59,5677,0.17,61,1997,4990,-59.98
1979,Morocco,1959,0.12,68,3678,0.22,60,5637,0.17,62,1719,1462,17.58
1979,Peru,3491,0.21,58,1820,0.11,71,5311,0.16,63,-1671,-766,118.15
1979,Qatar,3753,0.23,57,1424,0.08,78,5177,0.15,64,-2329,-1206,93.12
1979,Côte d'Ivoire,2514,0.15,63,2491,0.15,66,5005,0.15,65,-23,4,-675.0
1979,Syrian Arab Republic,1644,0.1,72,3329,0.2,63,4973,0.15,66,1685,1399,20.44
1979,"Bahrain, Kingdom of",2492,0.15,64,2480,0.15,67,4972,0.15,67,-12,152,-107.89
1979,Trinidad and Tobago,2610,0.16,62,2105,0.12,68,4715,0.14,68,-505,-73,591.78
1979,Tunisia,1791,0.11,71,2849,0.17,64,4640,0.14,69,1058,1012,4.55
1979,Ecuador,2104,0.13,67,1600,0.09,73,3704,0.11,70,-504,-53,850.94
1979,Lebanese Republic,850,0.05,87,2700,0.16,65,3550,0.11,71,1850,1092,69.41
1979,Brunei Darussalam,2666,0.16,61,396,0.02,121,3062,0.09,72,-2270,-1564,45.14
1979,Oman,1570,0.09,73,1246,0.07,81,2816,0.08,73,-324,-149,117.45
1979,Guatemala,1241,0.07,76,1504,0.09,75,2745,0.08,74,263,197,33.5
1979,Kenya,1090,0.07,80,1636,0.1,72,2726,0.08,75,546,688,-20.64
1979,Bangladesh,659,0.04,93,1908,0.11,70,2567,0.08,76,1249,965,29.43
1979,Sri Lanka,981,0.06,83,1466,0.09,77,2447,0.07,77,485,124,291.13
1979,Cameroon,1132,0.07,78,1275,0.08,80,2407,0.07,78,143,254,-43.7
1979,Gabon,1848,0.11,69,532,0.03,109,2380,0.07,79,-1316,-490,168.57
1979,Jordan,403,0.02,110,1963,0.12,69,2366,0.07,80,1560,1206,29.35
1979,Costa Rica,934,0.06,85,1397,0.08,79,2331,0.07,81,463,301,53.82
1979,El Salvador,1223,0.07,77,1037,0.06,88,2260,0.07,82,-186,180,-203.33
1979,Angola,1091,0.07,79,1112,0.07,85,2203,0.07,83,21,-83,-125.3
1979,Viet Nam,587,0.04,94,1599,0.09,74,2186,0.07,84,1012,837,20.91
1979,Zambia,1373,0.08,75,749,0.04,101,2122,0.06,85,-624,-238,162.18
1979,Dominican Republic,869,0.05,86,1213,0.07,82,2082,0.06,86,344,311,10.61
1979,Uruguay,788,0.05,89,1206,0.07,83,1994,0.06,87,418,71,488.73
1979,Zimbabwe,1053,0.06,81,930,0.05,92,1983,0.06,88,-123,-203,-39.41
1979,Papua New Guinea,964,0.06,84,903,0.05,94,1867,0.06,89,-61,56,-208.93
1979,Ghana,995,0.06,82,852,0.05,96,1847,0.06,90,-143,-87,64.37
1979,Jamaica,818,0.05,88,993,0.06,90,1811,0.05,91,175,71,146.48
1979,Democratic Republic of the Congo,1514,0.09,74,199,0.01,139,1713,0.05,92,-1315,-735,78.91
1979,"Bolivia, Plurinational State of",760,0.05,91,894,0.05,95,1654,0.05,93,134,179,-25.14
1979,Sudan,535,0.03,97,1109,0.07,86,1644,0.05,94,574,676,-15.09
1979,Tanzania,497,0.03,99,1105,0.07,87,1602,0.05,95,608,669,-9.12
1979,Iceland,782,0.05,90,815,0.05,98,1597,0.05,96,33,34,-2.94
1979,Honduras,734,0.04,92,826,0.05,97,1560,0.05,97,92,85,8.24
1979,Yemen,14,0.0,163,1492,0.09,76,1506,0.04,98,1478,1277,15.74
1979,Panama,303,0.02,119,1184,0.07,84,1487,0.04,99,881,686,28.43
1979,Cyprus,456,0.03,103,1010,0.06,89,1466,0.04,100,554,414,33.82
1979,Senegal,535,0.03,97,931,0.05,91,1466,0.04,100,396,306,29.41
1979,"Yemen, People's Democratic Republic",466,0.03,102,925,0.05,93,1391,0.04,102,459,383,19.84
1979,Malta,424,0.03,108,759,0.04,99,1183,0.04,103,335,233,43.78
1979,Liberia,537,0.03,96,507,0.03,112,1044,0.03,104,-30,-23,30.43
1979,Madagascar,394,0.02,111,641,0.04,103,1035,0.03,105,247,55,349.09
1979,Botswana,451,0.03,104,538,0.03,108,989,0.03,106,87,138,-36.96
1979,Ethiopia,418,0.03,109,567,0.03,107,985,0.03,107,149,149,0.0
1979,Mauritius,381,0.02,114,574,0.03,105,955,0.03,108,193,175,10.29
1979,Nicaragua,567,0.03,95,360,0.02,124,927,0.03,109,-207,-50,314.0
1979,Niger,448,0.03,105,461,0.03,115,909,0.03,110,13,23,-43.48
1979,Afghanistan,474,0.03,101,425,0.03,117,899,0.03,111,-49,74,-166.22
1979,Reunion,140,0.01,131,759,0.04,99,899,0.03,111,619,481,28.69
1979,Suriname,444,0.03,106,411,0.02,119,855,0.03,113,-33,13,-353.85
1979,Paraguay,305,0.02,118,521,0.03,110,826,0.02,114,216,126,71.43
1979,Mozambique,254,0.02,121,568,0.03,106,822,0.02,115,314,360,-12.78
1979,Martinique,133,0.01,132,676,0.04,102,809,0.02,116,543,373,45.58
1979,Congo,496,0.03,100,291,0.02,132,787,0.02,117,-205,-49,318.37
1979,Fiji,314,0.02,117,470,0.03,114,784,0.02,118,156,104,50.0
1979,"Macao, China",389,0.02,112,351,0.02,125,740,0.02,119,-38,-9,322.22
1979,Togo,218,0.01,124,519,0.03,111,737,0.02,120,301,216,39.35
1979,New Caledonia,368,0.02,116,361,0.02,122,729,0.02,121,-7,70,-110.0
1979,Guadeloupe,113,0.01,135,598,0.04,104,711,0.02,122,485,312,55.45
1979,Myanmar,387,0.02,113,322,0.02,127,709,0.02,123,-65,67,-197.01
1979,Eswatini,232,0.01,123,435,0.03,116,667,0.02,124,203,115,76.52
1979,Uganda,435,0.03,107,197,0.01,140,632,0.02,125,-238,-94,153.19
1979,Malawi,233,0.01,122,399,0.02,120,632,0.02,125,166,153,8.5
1979,Guinea,372,0.02,115,253,0.01,137,625,0.02,127,-119,-71,67.61
1979,Guyana,293,0.02,120,318,0.02,129,611,0.02,128,25,-17,-247.06
1979,Barbados,152,0.01,128,425,0.03,117,577,0.02,129,273,183,49.18
1979,Sierra Leone,200,0.01,125,316,0.02,130,516,0.02,130,116,109,6.42
1979,Mali,148,0.01,129,361,0.02,122,509,0.02,131,213,174,22.41
1979,French Polynesia,29,0.0,149,476,0.03,113,505,0.02,132,447,366,22.13
1979,Haiti,185,0.01,126,272,0.02,134,457,0.01,133,87,78,11.54
1979,Greenland,165,0.01,127,275,0.02,133,440,0.01,134,110,77,42.86
1979,Mauritania,147,0.01,130,259,0.02,135,406,0.01,135,112,58,93.1
1979,Burkina Faso,77,0.0,141,301,0.02,131,378,0.01,136,224,184,21.74
1979,Lesotho,45,0.0,145,328,0.02,126,373,0.01,137,283,249,13.65
1979,Benin,46,0.0,144,320,0.02,128,366,0.01,138,274,284,-3.52
1979,Nepal,109,0.01,136,254,0.01,136,363,0.01,139,145,130,11.54
1979,Rwanda,118,0.01,134,192,0.01,141,310,0.01,140,74,116,-36.21
1979,French Guiana,17,0.0,158,251,0.01,138,268,0.01,141,234,184,27.17
1979,Burundi,104,0.01,137,152,0.01,143,256,0.01,142,48,29,65.52
1979,Belize,87,0.01,139,132,0.01,146,219,0.01,143,45,26,73.08
1979,Djibouti,11,0.0,165,188,0.01,142,199,0.01,144,177,146,21.23
1979,The Gambia,58,0.0,143,141,0.01,145,199,0.01,144,83,61,36.07
1979,Chad,88,0.01,138,85,0.01,148,173,0.01,146,-3,118,-102.54
1979,American Samoa,125,0.01,133,40,0.0,160,165,0.0,147,-85,-31,174.19
1979,Cambodia,15,0.0,161,150,0.01,144,165,0.0,147,135,5,2600.0
1979,Central African Republic,80,0.0,140,70,0.0,151,150,0.0,149,-10,-15,-33.33
1979,Solomon Islands,70,0.0,142,70,0.0,151,140,0.0,150,0,4,-100.0
1979,Saint Lucia,36,0.0,148,101,0.01,147,137,0.0,151,65,54,20.37
1979,Seychelles,22,0.0,154,85,0.01,148,107,0.0,152,63,43,46.51
1979,Vanuatu,42,0.0,146,62,0.0,155,104,0.0,153,20,14,42.86
1979,Antigua and Barbuda,37,0.0,147,63,0.0,154,100,0.0,154,26,28,-7.14
1979,Samoa,18,0.0,157,73,0.0,150,91,0.0,155,55,41,34.15
1979,Lao People's Democratic Republic,19,0.0,156,70,0.0,151,89,0.0,156,51,13,292.31
1979,Guinea-Bissau,13,0.0,164,61,0.0,156,74,0.0,157,48,37,29.73
1979,Grenada,21,0.0,155,44,0.0,159,65,0.0,158,23,19,21.05
1979,Saint Vincent and the Grenadines,15,0.0,161,47,0.0,158,62,0.0,159,32,20,60.0
1979,Cabo Verde,2,0.0,171,53,0.0,157,55,0.0,160,51,51,0.0
1979,Equatorial Guinea,29,0.0,149,19,0.0,169,48,0.0,161,-10,-8,25.0
1979,Saint Kitts and Nevis,16,0.0,160,32,0.0,162,48,0.0,161,16,8,100.0
1979,Sao Tomé and Principe,27,0.0,151,20,0.0,168,47,0.0,163,-7,-3,133.33
1979,Comoros,17,0.0,158,29,0.0,163,46,0.0,164,12,10,20.0
1979,Kiribati,25,0.0,152,14,0.0,170,39,0.0,165,-11,-12,-8.33
1979,Saint Pierre and Miquelon,4,0.0,169,35,0.0,161,39,0.0,165,31,26,19.23
1979,Tonga,7,0.0,167,29,0.0,163,36,0.0,167,22,21,4.76
1979,Dominica,9,0.0,166,22,0.0,166,31,0.0,168,13,12,8.33
1979,Cook Islands,4,0.0,169,23,0.0,165,27,0.0,169,19,16,18.75
1979,Maldives,5,0.0,168,21,0.0,167,26,0.0,170,16,10,60.0
1979,Guam,25,0.0,152,0,0.0,172,25,0.0,171,-25,-34,-26.47
1979,Montserrat,1,0.0,172,10,0.0,171,11,0.0,172,9,66,-86.36
1978,United States of America,145847,11.16,1,186046,13.7,1,331893,12.45,1,40199,37229,7.98
1978,Germany,142453,10.9,2,121754,8.97,2,264207,9.91,2,-20699,-16614,24.59
1978,Japan,98211,7.51,3,79922,5.89,4,178133,6.68,3,-18289,-9743,87.71
1978,France,79371,6.07,4,81788,6.02,3,161159,6.05,4,2417,5507,-56.11
1978,United Kingdom,67887,5.19,5,75813,5.58,5,143700,5.39,5,7926,7331,8.12
1978,Netherlands,57590,4.41,6,61314,4.52,6,118904,4.46,6,3724,2793,33.33
1978,Italy,56090,4.29,7,56496,4.16,7,112586,4.22,7,406,2787,-85.43
1978,U.S.S.R.,52219,3.99,8,50546,3.72,8,102765,3.86,8,-1673,-4344,-61.49
1978,Canada,48432,3.71,9,46278,3.41,10,94710,3.55,9,-2154,-1462,47.33
1978,Belgium-Luxembourg,44947,3.44,10,48609,3.58,9,93556,3.51,10,3662,2868,27.68
1978,"Saudi Arabia, Kingdom of",40735,3.12,11,20422,1.5,13,61157,2.29,11,-20313,-28810,-29.49
1978,Switzerland,23560,1.8,12,23804,1.75,11,47364,1.78,12,244,326,-25.15
1978,Sweden,21790,1.67,13,20589,1.52,12,42379,1.59,13,-1201,1055,-213.84
1978,Spain,13114,1.0,16,18712,1.38,14,31826,1.19,14,5598,7613,-26.47
1978,Australia,14416,1.1,14,15567,1.15,16,29983,1.13,15,1151,144,699.31
1978,Austria,12175,0.93,22,16019,1.18,15,28194,1.06,16,3844,4437,-13.36
1978,German Democratic Republic,13267,1.01,15,14572,1.07,21,27839,1.04,17,1305,2310,-43.51
1978,Brazil,12659,0.97,20,15054,1.11,17,27713,1.04,18,2395,1137,110.64
1978,"Korea, Republic of",12722,0.97,18,14972,1.1,18,27694,1.04,19,2250,763,194.89
1978,Poland,12238,0.94,21,14744,1.09,20,26982,1.01,20,2506,4008,-37.48
1978,Denmark,11883,0.91,23,14808,1.09,19,26691,1.0,21,2925,3200,-8.59
1978,"Hong Kong, China",11453,0.88,26,13394,0.99,23,24847,0.93,22,1941,830,133.86
1978,Czech and Slovak Federal Republic,11747,0.9,24,12565,0.93,26,24312,0.91,23,818,331,147.13
1978,Chinese Taipei,12682,0.97,19,11051,0.81,30,23733,0.89,24,-1631,-827,97.22
1978,Singapore,10134,0.78,30,13061,0.96,24,23195,0.87,25,2927,2230,31.26
1978,Nigeria,9938,0.76,32,12821,0.94,25,22759,0.85,26,2883,-744,-487.5
1978,Norway,10882,0.83,28,11497,0.85,28,22379,0.84,27,615,4003,-84.64
1978,Iran,8560,0.65,37,13550,1.0,22,22110,0.83,28,4990,4854,2.8
1978,China,9955,0.76,31,11131,0.82,29,21086,0.79,29,1176,-372,-416.13
1978,"Venezuela, Bolivarian Republic of",9187,0.7,34,11767,0.87,27,20954,0.79,30,2580,1387,86.01
1978,South Africa,12772,0.98,17,7615,0.56,40,20387,0.76,31,-5157,-3634,41.91
1978,Indonesia,11643,0.89,25,6690,0.49,44,18333,0.69,32,-4953,-4623,7.14
1978,Romania,8086,0.62,38,9638,0.71,32,17724,0.67,33,1552,558,178.14
1978,Finland,8570,0.66,36,7866,0.58,36,16436,0.62,34,-704,-57,1135.09
1978,"Yugoslavia, Socialist Federal Republic of",5671,0.43,47,9988,0.74,31,15659,0.59,35,4317,4380,-1.44
1978,Iraq,11064,0.85,27,4213,0.31,54,15277,0.57,36,-6851,-5751,19.13
1978,Bulgaria,7478,0.57,39,7651,0.56,39,15129,0.57,37,173,0,
1978,"Kuwait, the State of",10427,0.8,29,4598,0.34,53,15025,0.56,38,-5829,-4908,18.77
1978,Algeria,6326,0.48,44,8548,0.63,33,14874,0.56,39,2222,1181,88.15
1978,India,6671,0.51,41,7865,0.58,37,14536,0.55,40,1194,269,343.87
1978,Libya,9895,0.76,33,4603,0.34,51,14498,0.54,41,-5292,-7638,-30.71
1978,United Arab Emirates,9126,0.7,35,5371,0.4,46,14497,0.54,42,-3755,-4581,-18.03
1978,Hungary,6408,0.49,42,7990,0.59,35,14398,0.54,43,1582,690,129.28
1978,Mexico,6005,0.46,45,8109,0.6,34,14114,0.53,44,2104,1322,59.15
1978,Malaysia,7404,0.57,40,5909,0.44,45,13313,0.5,45,-1495,-1537,-2.73
1978,Ireland,5691,0.44,46,7121,0.52,42,12812,0.48,46,1430,992,44.15
1978,Israel,3921,0.3,50,7415,0.55,41,11336,0.43,47,3494,2705,29.17
1978,Greece,3368,0.26,53,7829,0.58,38,11197,0.42,48,4461,4097,8.88
1978,Argentina,6400,0.49,43,3834,0.28,56,10234,0.38,49,-2566,-1490,72.21
1978,Thailand,4085,0.31,49,5356,0.39,47,9441,0.35,50,1271,1127,12.78
1978,Cuba,4487,0.34,48,4780,0.35,50,9267,0.35,51,293,700,-58.14
1978,Philippines,3401,0.26,52,5144,0.38,49,8545,0.32,52,1743,1143,52.49
1978,Egypt,1737,0.13,66,6727,0.5,43,8464,0.32,53,4990,3107,60.61
1978,Portugal,2414,0.18,58,5237,0.39,48,7651,0.29,54,2823,2774,1.77
1978,New Zealand,3738,0.29,51,3491,0.26,57,7229,0.27,55,-247,165,-249.7
1978,Türkiye,2288,0.18,61,4599,0.34,52,6887,0.26,56,2311,4043,-42.84
1978,Netherlands Antilles,2976,0.23,56,3491,0.26,57,6467,0.24,57,515,481,7.07
1978,Bahamas,3058,0.23,54,3150,0.23,60,6208,0.23,58,92,307,-70.03
1978,Colombia,3010,0.23,55,2971,0.22,61,5981,0.22,59,-39,-523,-92.54
1978,Chile,2478,0.19,57,3408,0.25,59,5886,0.22,60,930,349,166.48
1978,Pakistan,1634,0.13,67,3859,0.28,55,5493,0.21,61,2225,1373,62.05
1978,Côte d'Ivoire,2322,0.18,60,2326,0.17,64,4648,0.17,62,4,-401,-101.0
1978,Morocco,1508,0.12,69,2970,0.22,62,4478,0.17,63,1462,1897,-22.93
1978,Trinidad and Tobago,2040,0.16,62,1967,0.14,67,4007,0.15,64,-73,-361,-79.78
1978,"Bahrain, Kingdom of",1893,0.14,64,2045,0.15,66,3938,0.15,65,152,184,-17.39
1978,Qatar,2391,0.18,59,1185,0.09,77,3576,0.13,66,-1206,-847,42.38
1978,Syrian Arab Republic,1060,0.08,75,2459,0.18,63,3519,0.13,67,1399,1632,-14.28
1978,Tunisia,1126,0.09,70,2138,0.16,65,3264,0.12,68,1012,896,12.95
1978,Peru,1941,0.15,63,1175,0.09,78,3116,0.12,69,-766,185,-514.05
1978,Ecuador,1558,0.12,68,1505,0.11,71,3063,0.11,70,-53,-247,-78.54
1978,Lebanese Republic,830,0.06,85,1922,0.14,68,2752,0.1,71,1092,779,40.18
1978,Kenya,1023,0.08,76,1711,0.13,69,2734,0.1,72,688,103,567.96
1978,Guatemala,1089,0.08,74,1286,0.09,74,2375,0.09,73,197,-107,-284.11
1978,Viet Nam,648,0.05,90,1485,0.11,73,2133,0.08,74,837,778,7.58
1978,Brunei Darussalam,1845,0.14,65,281,0.02,126,2126,0.08,75,-1564,-1361,14.92
1978,Ghana,1093,0.08,73,1006,0.07,83,2099,0.08,76,-87,24,-462.5
1978,Bangladesh,548,0.04,95,1513,0.11,70,2061,0.08,77,965,687,40.47
1978,Oman,1096,0.08,72,947,0.07,86,2043,0.08,78,-149,-264,-43.56
1978,Costa Rica,865,0.07,80,1166,0.09,79,2031,0.08,79,301,193,55.96
1978,El Salvador,848,0.06,82,1028,0.08,82,1876,0.07,80,180,-43,-518.6
1978,Cameroon,802,0.06,86,1056,0.08,81,1858,0.07,81,254,31,719.35
1978,Angola,968,0.07,77,885,0.07,89,1853,0.07,82,-83,-66,25.76
1978,Sri Lanka,845,0.06,83,969,0.07,85,1814,0.07,83,124,-61,-303.28
1978,Jordan,298,0.02,110,1504,0.11,72,1802,0.07,84,1206,1132,6.54
1978,Jamaica,833,0.06,84,904,0.07,88,1737,0.07,85,71,92,-22.83
1978,Gabon,1107,0.08,71,617,0.05,99,1724,0.06,86,-490,-627,-21.85
1978,Sudan,518,0.04,96,1194,0.09,76,1712,0.06,87,676,420,60.95
1978,Dominican Republic,676,0.05,89,987,0.07,84,1663,0.06,88,311,195,59.49
1978,Tanzania,476,0.04,98,1145,0.08,80,1621,0.06,89,669,237,182.28
1978,Zimbabwe,888,0.07,79,685,0.05,96,1573,0.06,90,-203,-167,21.56
1978,Papua New Guinea,714,0.05,87,770,0.06,91,1484,0.06,91,56,-41,-236.59
1978,Zambia,856,0.07,81,618,0.05,98,1474,0.06,92,-238,-225,5.78
1978,Uruguay,686,0.05,88,757,0.06,93,1443,0.05,93,71,122,-41.8
1978,"Bolivia, Plurinational State of",629,0.05,93,808,0.06,90,1437,0.05,94,179,-14,-1378.57
1978,Iceland,641,0.05,92,675,0.05,97,1316,0.05,95,34,93,-63.44
1978,Honduras,608,0.05,94,693,0.05,95,1301,0.05,96,85,62,37.1
1978,Yemen,7,0.0,164,1284,0.09,75,1291,0.05,97,1277,1029,24.1
1978,Nicaragua,646,0.05,91,596,0.04,101,1242,0.05,98,-50,125,-140.0
1978,Senegal,449,0.03,99,755,0.06,94,1204,0.05,99,306,140,118.57
1978,Panama,256,0.02,115,942,0.07,87,1198,0.04,100,686,610,12.46
1978,Democratic Republic of the Congo,931,0.07,78,196,0.01,138,1127,0.04,101,-735,-786,-6.49
1978,Cyprus,344,0.03,103,758,0.06,92,1102,0.04,102,414,305,35.74
1978,Liberia,504,0.04,97,481,0.04,107,985,0.04,103,-23,17,-235.29
1978,Malta,342,0.03,105,575,0.04,102,917,0.03,104,233,227,2.64
1978,Madagascar,388,0.03,100,443,0.03,110,831,0.03,105,55,9,511.11
1978,Mauritius,325,0.02,106,500,0.04,105,825,0.03,106,175,138,26.81
1978,"Yemen, People's Democratic Republic",192,0.01,122,575,0.04,102,767,0.03,107,383,363,5.51
1978,Ethiopia,306,0.02,109,455,0.03,108,761,0.03,108,149,19,684.21
1978,Suriname,369,0.03,101,382,0.03,115,751,0.03,109,13,88,-85.23
1978,Afghanistan,321,0.02,107,395,0.03,113,716,0.03,110,74,22,236.36
1978,Reunion,116,0.01,130,597,0.04,100,713,0.03,111,481,378,27.25
1978,Mozambique,163,0.01,125,523,0.04,104,686,0.03,112,360,172,109.3
1978,Togo,234,0.02,118,450,0.03,109,684,0.03,113,216,125,72.8
1978,Paraguay,257,0.02,114,383,0.03,114,640,0.02,114,126,29,334.48
1978,Martinique,125,0.01,128,498,0.04,106,623,0.02,115,373,300,24.33
1978,Guinea,343,0.03,104,272,0.02,130,615,0.02,116,-71,-67,5.97
1978,Fiji,251,0.02,116,355,0.03,117,606,0.02,117,104,83,25.3
1978,Botswana,233,0.02,119,371,0.03,116,604,0.02,118,138,100,38.0
1978,Uganda,348,0.03,102,254,0.02,132,602,0.02,119,-94,-347,-72.91
1978,Niger,282,0.02,112,305,0.02,123,587,0.02,120,23,36,-36.11
1978,Guyana,296,0.02,111,279,0.02,128,575,0.02,121,-17,55,-130.91
1978,Congo,308,0.02,108,259,0.02,131,567,0.02,122,-49,-59,-16.95
1978,Myanmar,245,0.02,117,312,0.02,120,557,0.02,123,67,27,148.15
1978,Guadeloupe,112,0.01,131,424,0.03,111,536,0.02,124,312,296,5.41
1978,Malawi,185,0.01,123,338,0.02,118,523,0.02,125,153,35,337.14
1978,New Caledonia,222,0.02,120,292,0.02,124,514,0.02,126,70,-23,-404.35
1978,Eswatini,196,0.01,121,311,0.02,121,507,0.02,127,115,17,576.47
1978,"Macao, China",258,0.02,113,249,0.02,133,507,0.02,127,-9,-21,-57.14
1978,Sierra Leone,170,0.01,124,279,0.02,128,449,0.02,129,109,45,142.22
1978,Barbados,131,0.01,127,314,0.02,119,445,0.02,130,183,176,3.98
1978,French Polynesia,37,0.0,144,403,0.03,112,440,0.02,131,366,311,17.68
1978,Mali,112,0.01,131,286,0.02,125,398,0.01,132,174,34,411.76
1978,Haiti,155,0.01,126,233,0.02,134,388,0.01,133,78,64,21.88
1978,Benin,27,0.0,149,311,0.02,121,338,0.01,134,284,237,19.83
1978,Chad,99,0.01,135,217,0.02,137,316,0.01,135,118,82,43.9
1978,Lesotho,32,0.0,147,281,0.02,126,313,0.01,136,249,220,13.18
1978,Nepal,91,0.01,136,221,0.02,136,312,0.01,137,130,87,49.43
1978,Mauritania,123,0.01,129,181,0.01,141,304,0.01,138,58,50,16.0
1978,Greenland,102,0.01,134,179,0.01,142,281,0.01,139,77,68,13.24
1978,Burkina Faso,43,0.0,141,227,0.02,135,270,0.01,140,184,154,19.48
1978,Rwanda,72,0.01,138,188,0.01,140,260,0.01,141,116,31,274.19
1978,French Guiana,7,0.0,164,191,0.01,139,198,0.01,142,184,137,34.31
1978,Belize,80,0.01,137,106,0.01,144,186,0.01,143,26,28,-7.14
1978,Djibouti,18,0.0,152,164,0.01,143,182,0.01,144,146,88,65.91
1978,American Samoa,104,0.01,133,73,0.01,148,177,0.01,145,-31,-26,19.23
1978,Burundi,69,0.01,140,98,0.01,146,167,0.01,146,29,-16,-281.25
1978,The Gambia,39,0.0,142,100,0.01,145,139,0.01,147,61,31,96.77
1978,Central African Republic,72,0.01,138,57,0.0,151,129,0.0,148,-15,-19,-21.05
1978,Saint Lucia,29,0.0,148,83,0.01,147,112,0.0,149,54,34,58.82
1978,Vanuatu,37,0.0,144,51,0.0,154,88,0.0,150,14,8,75.0
1978,Solomon Islands,38,0.0,143,42,0.0,156,80,0.0,151,4,0,
1978,Montserrat,7,0.0,164,73,0.01,148,80,0.0,151,66,47,40.43
1978,Seychelles,15,0.0,158,58,0.0,150,73,0.0,153,43,35,22.86
1978,Samoa,11,0.0,162,52,0.0,153,63,0.0,154,41,26,57.69
1978,Guinea-Bissau,12,0.0,161,49,0.0,155,61,0.0,155,37,24,54.17
1978,Cabo Verde,2,0.0,172,53,0.0,152,55,0.0,156,51,36,41.67
1978,Antigua and Barbuda,13,0.0,160,41,0.0,157,54,0.0,157,28,27,3.7
1978,Grenada,17,0.0,153,36,0.0,158,53,0.0,158,19,18,5.56
1978,Saint Vincent and the Grenadines,16,0.0,155,36,0.0,158,52,0.0,159,20,20,0.0
1978,Dominica,16,0.0,155,28,0.0,161,44,0.0,160,12,10,20.0
1978,Saint Kitts and Nevis,16,0.0,155,24,0.0,163,40,0.0,161,8,8,0.0
1978,Sao Tomé and Principe,21,0.0,151,18,0.0,167,39,0.0,162,-3,-9,-66.67
1978,Kiribati,25,0.0,150,13,0.0,170,38,0.0,163,-12,-9,33.33
1978,Cambodia,15,0.0,158,20,0.0,164,35,0.0,164,5,4,25.0
1978,Guam,34,0.0,146,0,0.0,172,34,0.0,165,-34,-31,9.68
1978,Saint Pierre and Miquelon,4,0.0,168,30,0.0,160,34,0.0,165,26,23,13.04
1978,Tonga,5,0.0,167,26,0.0,162,31,0.0,167,21,13,61.54
1978,Comoros,9,0.0,163,19,0.0,165,28,0.0,168,10,7,42.86
1978,Equatorial Guinea,17,0.0,153,9,0.0,171,26,0.0,169,-8,-4,100.0
1978,Cook Islands,3,0.0,170,19,0.0,165,22,0.0,170,16,15,6.67
1978,Lao People's Democratic Republic,3,0.0,170,16,0.0,168,19,0.0,171,13,10,30.0
1978,Maldives,4,0.0,168,14,0.0,169,18,0.0,172,10,7,42.86
1977,United States of America,123182,10.92,1,160411,13.71,1,283593,12.34,1,37229,15703,137.08
1977,Germany,118072,10.47,2,101458,8.67,2,219530,9.55,2,-16614,-13741,20.91
1977,Japan,81083,7.19,3,71340,6.1,3,152423,6.63,3,-9743,-2409,304.44
1977,France,65130,5.77,4,70637,6.04,4,135767,5.91,4,5507,7208,-23.6
1977,United Kingdom,55860,4.95,5,63191,5.4,5,119051,5.18,5,7331,10388,-29.43
1977,Netherlands,50110,4.44,6,52903,4.52,6,103013,4.48,6,2793,581,380.72
1977,Italy,45305,4.02,7,48092,4.11,7,93397,4.06,7,2787,6640,-58.03
1977,U.S.S.R.,45161,4.0,8,40817,3.49,9,85978,3.74,8,-4344,939,-562.62
1977,Canada,43545,3.86,9,42083,3.6,8,85628,3.73,9,-1462,-355,311.83
1977,Belgium-Luxembourg,37538,3.33,11,40406,3.45,10,77944,3.39,10,2868,2656,7.98
1977,"Saudi Arabia, Kingdom of",43466,3.85,10,14656,1.25,15,58122,2.53,11,-28810,-29591,-2.64
1977,Sweden,19082,1.69,12,20137,1.72,11,39219,1.71,12,1055,1193,-11.57
1977,Switzerland,17614,1.56,13,17940,1.53,12,35554,1.55,13,326,-60,-643.33
1977,Spain,10223,0.91,22,17836,1.52,13,28059,1.22,14,7613,8744,-12.93
1977,Australia,13367,1.18,14,13511,1.15,19,26878,1.17,15,144,-961,-114.98
1977,German Democratic Republic,12024,1.07,16,14334,1.23,16,26358,1.15,16,2310,1835,25.89
1977,Brazil,12120,1.07,15,13257,1.13,21,25377,1.1,17,1137,3598,-68.4
1977,Poland,10666,0.95,21,14674,1.25,14,25340,1.1,18,4008,2843,40.98
1977,Austria,9808,0.87,26,14245,1.22,17,24053,1.05,19,4437,3017,47.07
1977,Denmark,10065,0.89,23,13265,1.13,20,23330,1.02,20,3200,3312,-3.38
1977,Iran,9216,0.82,33,14070,1.2,18,23286,1.01,21,4854,3959,22.61
1977,Nigeria,11839,1.05,17,11095,0.95,24,22934,1.0,22,-744,-2353,-68.38
1977,Czech and Slovak Federal Republic,10818,0.96,20,11149,0.95,23,21967,0.96,23,331,671,-50.67
1977,Norway,8880,0.79,34,12883,1.1,22,21763,0.95,24,4003,3170,26.28
1977,"Korea, Republic of",10048,0.89,24,10811,0.92,26,20859,0.91,25,763,1058,-27.88
1977,"Venezuela, Bolivarian Republic of",9551,0.85,31,10938,0.93,25,20489,0.89,26,1387,-1636,-184.78
1977,"Hong Kong, China",9616,0.85,30,10446,0.89,28,20062,0.87,27,830,354,134.46
1977,Singapore,8241,0.73,35,10471,0.9,27,18712,0.81,28,2230,2486,-10.3
1977,Chinese Taipei,9349,0.83,32,8522,0.73,30,17871,0.78,29,-827,-546,51.47
1977,Indonesia,10853,0.96,19,6230,0.53,40,17083,0.74,30,-4623,-2874,60.86
1977,South Africa,9904,0.88,25,6270,0.54,39,16174,0.7,31,-3634,-565,543.19
1977,Finland,7665,0.68,36,7608,0.65,31,15273,0.66,32,-57,1050,-105.43
1977,Libya,11411,1.01,18,3773,0.32,55,15184,0.66,33,-7638,-6342,20.44
1977,"Yugoslavia, Socialist Federal Republic of",5254,0.47,45,9634,0.82,29,14888,0.65,34,4380,2488,76.05
1977,United Arab Emirates,9636,0.85,29,5055,0.43,45,14691,0.64,35,-4581,-6198,-26.09
1977,China,7520,0.67,37,7148,0.61,33,14668,0.64,36,-372,-283,31.45
1977,Romania,7021,0.62,38,7579,0.65,32,14600,0.64,37,558,445,25.39
1977,"Kuwait, the State of",9754,0.86,27,4846,0.41,46,14600,0.64,37,-4908,-6519,-24.71
1977,Iraq,9650,0.86,28,3899,0.33,54,13549,0.59,39,-5751,-5376,6.98
1977,Algeria,5944,0.53,42,7125,0.61,34,13069,0.57,40,1181,-178,-763.48
1977,India,6378,0.57,39,6647,0.57,36,13025,0.57,41,269,116,131.9
1977,Bulgaria,6329,0.56,40,6329,0.54,38,12658,0.55,42,0,846,-100.0
1977,Hungary,5832,0.52,43,6522,0.56,37,12354,0.54,43,690,595,15.97
1977,Malaysia,6079,0.54,41,4542,0.39,51,10621,0.46,44,-1537,-1471,4.49
1977,Argentina,5652,0.5,44,4162,0.36,53,9814,0.43,45,-1490,-883,68.74
1977,Ireland,4404,0.39,46,5396,0.46,44,9800,0.43,46,992,885,12.09
1977,Mexico,4167,0.37,47,5489,0.47,43,9656,0.42,47,1322,2611,-49.37
1977,Greece,2756,0.24,54,6853,0.59,35,9609,0.42,48,4097,3498,17.12
1977,Israel,3082,0.27,53,5787,0.49,42,8869,0.39,49,2705,3254,-16.87
1977,Cuba,4000,0.35,48,4700,0.4,49,8700,0.38,50,700,493,41.99
1977,Thailand,3490,0.31,49,4617,0.39,50,8107,0.35,51,1127,592,90.37
1977,Türkiye,1753,0.16,63,5796,0.5,41,7549,0.33,52,4043,3169,27.58
1977,Philippines,3127,0.28,52,4270,0.36,52,7397,0.32,53,1143,1387,-17.59
1977,Bahamas,3261,0.29,50,3568,0.3,56,6829,0.3,54,307,133,130.83
1977,Portugal,1970,0.17,61,4744,0.41,48,6714,0.29,55,2774,2409,15.15
1977,New Zealand,3196,0.28,51,3361,0.29,57,6557,0.29,56,165,459,-64.05
1977,Egypt,1708,0.15,65,4815,0.41,47,6523,0.28,57,3107,2285,35.97
1977,Netherlands Antilles,2647,0.23,55,3128,0.27,59,5775,0.25,58,481,1143,-57.92
1977,Chile,2190,0.19,57,2539,0.22,62,4729,0.21,59,349,-219,-259.36
1977,Morocco,1302,0.12,69,3199,0.27,58,4501,0.2,60,1897,1357,39.79
1977,Colombia,2403,0.21,56,1880,0.16,65,4283,0.19,61,-523,-212,146.7
1977,Trinidad and Tobago,2180,0.19,58,1819,0.16,67,3999,0.17,62,-361,-204,76.96
1977,Côte d'Ivoire,2157,0.19,59,1756,0.15,68,3913,0.17,63,-401,-336,19.35
1977,"Bahrain, Kingdom of",1845,0.16,62,2029,0.17,63,3874,0.17,64,184,152,21.05
1977,Pakistan,1213,0.11,70,2586,0.22,61,3799,0.17,65,1373,1125,22.04
1977,Syrian Arab Republic,1070,0.09,74,2702,0.23,60,3772,0.16,66,1632,1309,24.68
1977,Peru,1726,0.15,64,1911,0.16,64,3637,0.16,67,185,677,-72.67
1977,Qatar,2072,0.18,60,1225,0.1,73,3297,0.14,68,-847,-1393,-39.2
1977,Tunisia,929,0.08,78,1825,0.16,66,2754,0.12,69,896,741,20.92
1977,Ecuador,1436,0.13,67,1189,0.1,74,2625,0.11,70,-247,-300,-17.67
1977,Kenya,1186,0.11,71,1289,0.11,72,2475,0.11,71,103,179,-42.46
1977,Lebanese Republic,760,0.07,86,1539,0.13,69,2299,0.1,72,779,66,1080.3
1977,Guatemala,1160,0.1,72,1053,0.09,77,2213,0.1,73,-107,79,-235.44
1977,Gabon,1343,0.12,68,716,0.06,92,2059,0.09,74,-627,-632,-0.79
1977,Ghana,1014,0.09,75,1038,0.09,79,2052,0.09,75,24,30,-20.0
1977,Oman,1139,0.1,73,875,0.07,83,2014,0.09,76,-264,-409,-35.45
1977,Viet Nam,594,0.05,94,1372,0.12,71,1966,0.09,77,778,769,1.17
1977,Brunei Darussalam,1640,0.15,66,279,0.02,120,1919,0.08,78,-1361,-1073,26.84
1977,El Salvador,972,0.09,77,929,0.08,82,1901,0.08,79,-43,-8,437.5
1977,Costa Rica,828,0.07,81,1021,0.09,80,1849,0.08,80,193,177,9.04
1977,Dominican Republic,780,0.07,83,975,0.08,81,1755,0.08,81,195,162,20.37
1977,Sudan,661,0.06,89,1081,0.09,76,1742,0.08,82,420,426,-1.41
1977,Bangladesh,476,0.04,99,1163,0.1,75,1639,0.07,83,687,551,24.68
1977,Jordan,249,0.02,114,1381,0.12,70,1630,0.07,84,1132,799,41.68
1977,Jamaica,768,0.07,84,860,0.07,85,1628,0.07,85,92,283,-67.49
1977,Zimbabwe,877,0.08,80,710,0.06,93,1587,0.07,86,-167,-188,-11.17
1977,Zambia,896,0.08,79,671,0.06,95,1567,0.07,87,-225,-396,-43.18
1977,Angola,786,0.07,82,720,0.06,91,1506,0.07,88,-66,-266,-75.19
1977,Sri Lanka,761,0.07,85,700,0.06,94,1461,0.06,89,-61,13,-569.23
1977,Cameroon,704,0.06,87,735,0.06,89,1439,0.06,90,31,102,-69.61
1977,Nicaragua,637,0.06,90,762,0.07,87,1399,0.06,91,125,-10,-1350.0
1977,Senegal,624,0.06,92,764,0.07,86,1388,0.06,92,140,151,-7.28
1977,Uruguay,608,0.05,93,730,0.06,90,1338,0.06,93,122,41,197.56
1977,Papua New Guinea,683,0.06,88,642,0.05,96,1325,0.06,94,-41,-49,-16.33
1977,Tanzania,507,0.04,98,744,0.06,88,1251,0.05,95,237,198,19.7
1977,"Bolivia, Plurinational State of",632,0.06,91,618,0.05,98,1250,0.05,96,-14,-13,7.69
1977,Democratic Republic of the Congo,989,0.09,76,203,0.02,132,1192,0.05,97,-786,-720,9.17
1977,Iceland,512,0.05,97,605,0.05,99,1117,0.05,98,93,66,40.91
1977,Panama,251,0.02,113,861,0.07,84,1112,0.05,99,610,610,0.0
1977,Honduras,513,0.05,96,575,0.05,100,1088,0.05,100,62,56,10.71
1977,Yemen,11,0.0,160,1040,0.09,78,1051,0.05,101,1029,405,154.07
1977,Cyprus,318,0.03,103,623,0.05,97,941,0.04,102,305,174,75.29
1977,Liberia,447,0.04,100,464,0.04,104,911,0.04,103,17,-61,-127.87
1977,Uganda,588,0.05,95,241,0.02,125,829,0.04,104,-347,-192,80.73
1977,Malta,289,0.03,109,516,0.04,102,805,0.04,105,227,195,16.41
1977,Mauritius,309,0.03,107,447,0.04,105,756,0.03,106,138,95,45.26
1977,"Yemen, People's Democratic Republic",181,0.02,120,544,0.05,101,725,0.03,107,363,249,45.78
1977,Suriname,310,0.03,106,398,0.03,107,708,0.03,108,88,18,388.89
1977,Ethiopia,333,0.03,102,352,0.03,109,685,0.03,109,19,72,-73.61
1977,Madagascar,338,0.03,101,347,0.03,110,685,0.03,109,9,10,-10.0
1977,Afghanistan,306,0.03,108,328,0.03,111,634,0.03,111,22,-30,-173.33
1977,New Caledonia,315,0.03,104,292,0.02,117,607,0.03,112,-23,-29,-20.69
1977,Reunion,114,0.01,130,492,0.04,103,606,0.03,113,378,351,7.69
1977,Paraguay,279,0.02,110,308,0.03,115,587,0.03,114,29,39,-25.64
1977,Guyana,259,0.02,112,314,0.03,114,573,0.02,115,55,85,-35.29
1977,Guinea,314,0.03,105,247,0.02,123,561,0.02,116,-67,46,-245.65
1977,Martinique,128,0.01,128,428,0.04,106,556,0.02,117,300,289,3.81
1977,Fiji,224,0.02,115,307,0.03,116,531,0.02,118,83,92,-9.78
1977,Congo,267,0.02,111,208,0.02,130,475,0.02,119,-59,-49,20.41
1977,Botswana,186,0.02,119,286,0.02,118,472,0.02,120,100,39,156.41
1977,Mozambique,149,0.01,125,321,0.03,113,470,0.02,121,172,150,14.67
1977,Myanmar,215,0.02,117,242,0.02,124,457,0.02,122,27,-29,-193.1
1977,Guadeloupe,79,0.01,139,375,0.03,108,454,0.02,123,296,228,29.82
1977,Togo,159,0.01,123,284,0.02,119,443,0.02,124,125,80,56.25
1977,Malawi,200,0.02,118,235,0.02,126,435,0.02,125,35,40,-12.5
1977,"Macao, China",219,0.02,116,198,0.02,133,417,0.02,126,-21,-27,-22.22
1977,Barbados,97,0.01,132,273,0.02,121,370,0.02,127,176,151,16.56
1977,Mauritania,157,0.01,124,207,0.02,131,364,0.02,128,50,1,4900.0
1977,Haiti,149,0.01,125,213,0.02,128,362,0.02,129,64,83,-22.89
1977,Niger,161,0.01,122,197,0.02,134,358,0.02,130,36,-8,-550.0
1977,Eswatini,165,0.01,121,182,0.02,136,347,0.02,131,17,17,0.0
1977,French Polynesia,16,0.0,151,327,0.03,112,343,0.01,132,311,274,13.5
1977,Sierra Leone,136,0.01,127,181,0.02,137,317,0.01,133,45,54,-16.67
1977,Benin,31,0.0,145,268,0.02,122,299,0.01,134,237,194,22.16
1977,Chad,107,0.01,131,189,0.02,135,296,0.01,135,82,53,54.72
1977,Mali,125,0.01,129,159,0.01,140,284,0.01,136,34,71,-52.11
1977,Burkina Faso,55,0.0,141,209,0.02,129,264,0.01,137,154,91,69.23
1977,Greenland,92,0.01,133,160,0.01,139,252,0.01,138,68,43,58.14
1977,Nepal,81,0.01,137,168,0.01,138,249,0.01,139,87,65,33.85
1977,Lesotho,14,0.0,154,234,0.02,127,248,0.01,140,220,195,12.82
1977,Rwanda,92,0.01,133,123,0.01,142,215,0.01,141,31,26,19.23
1977,Burundi,90,0.01,135,74,0.01,146,164,0.01,142,-16,-3,433.33
1977,Belize,62,0.01,140,90,0.01,144,152,0.01,143,28,31,-9.68
1977,French Guiana,7,0.0,164,144,0.01,141,151,0.01,144,137,82,67.07
1977,Central African Republic,82,0.01,136,63,0.01,147,145,0.01,145,-19,-6,216.67
1977,American Samoa,81,0.01,137,55,0.0,149,136,0.01,146,-26,-14,85.71
1977,Djibouti,19,0.0,150,107,0.01,143,126,0.01,147,88,104,-15.38
1977,The Gambia,47,0.0,142,78,0.01,145,125,0.01,148,31,39,-20.51
1977,Saint Lucia,25,0.0,147,59,0.01,148,84,0.0,149,34,27,25.93
1977,Vanuatu,32,0.0,144,40,0.0,153,72,0.0,150,8,17,-52.94
1977,Solomon Islands,33,0.0,143,33,0.0,157,66,0.0,151,0,6,-100.0
1977,Seychelles,11,0.0,160,46,0.0,151,57,0.0,152,35,30,16.67
1977,Samoa,15,0.0,152,41,0.0,152,56,0.0,153,26,23,13.04
1977,Montserrat,4,0.0,167,51,0.0,150,55,0.0,154,47,51,-7.84
1977,Guinea-Bissau,13,0.0,158,37,0.0,155,50,0.0,155,24,31,-22.58
1977,Grenada,14,0.0,154,32,0.0,158,46,0.0,156,18,12,50.0
1977,Antigua and Barbuda,7,0.0,164,34,0.0,156,41,0.0,157,27,26,3.85
1977,Cabo Verde,2,0.0,171,38,0.0,154,40,0.0,158,36,28,28.57
1977,Saint Vincent and the Grenadines,10,0.0,162,30,0.0,159,40,0.0,158,20,15,33.33
1977,Sao Tomé and Principe,23,0.0,148,14,0.0,167,37,0.0,160,-9,1,-1000.0
1977,Saint Kitts and Nevis,14,0.0,154,22,0.0,161,36,0.0,161,8,5,60.0
1977,Dominica,12,0.0,159,22,0.0,161,34,0.0,162,10,8,25.0
1977,Cambodia,15,0.0,152,19,0.0,164,34,0.0,162,4,6,-33.33
1977,Guam,31,0.0,145,0,0.0,172,31,0.0,164,-31,-25,24.0
1977,Kiribati,20,0.0,149,11,0.0,169,31,0.0,164,-9,-14,-35.71
1977,Saint Pierre and Miquelon,3,0.0,169,26,0.0,160,29,0.0,166,23,19,21.05
1977,Tonga,7,0.0,164,20,0.0,163,27,0.0,167,13,10,30.0
1977,Comoros,9,0.0,163,16,0.0,166,25,0.0,168,7,1,600.0
1977,Equatorial Guinea,14,0.0,154,10,0.0,170,24,0.0,169,-4,-6,-33.33
1977,Cook Islands,2,0.0,171,17,0.0,165,19,0.0,170,15,11,36.36
1977,Lao People's Democratic Republic,4,0.0,167,14,0.0,167,18,0.0,171,10,33,-69.7
1977,Maldives,3,0.0,169,10,0.0,170,13,0.0,172,7,3,133.33
1976,United States of America,116794,11.77,1,132497,12.92,1,249291,12.36,1,15703,-2975,-627.83
1976,Germany,102162,10.3,2,88421,8.62,2,190583,9.45,2,-13741,-15245,-9.87
1976,Japan,67304,6.78,3,64895,6.33,3,132199,6.55,3,-2409,2041,-218.03
1976,France,56874,5.73,4,64082,6.25,4,120956,5.99,4,7208,847,751.0
1976,United Kingdom,45356,4.57,6,55744,5.43,5,101100,5.01,5,10388,9918,4.74
1976,Netherlands,46153,4.65,5,46734,4.56,6,92887,4.6,6,581,1009,-42.42
1976,Italy,37265,3.76,9,43905,4.28,7,81170,4.02,7,6640,3538,87.68
1976,Canada,40598,4.09,7,40243,3.92,8,80841,4.01,8,-355,2033,-117.46
1976,U.S.S.R.,37169,3.75,10,38108,3.72,9,75277,3.73,9,939,3655,-74.31
1976,Belgium-Luxembourg,32889,3.32,11,35545,3.47,10,68434,3.39,10,2656,1977,34.34
1976,"Saudi Arabia, Kingdom of",38286,3.86,8,8695,0.85,26,46981,2.33,11,-29591,-25460,16.23
1976,Sweden,18435,1.86,12,19628,1.91,11,38063,1.89,12,1193,66,1707.58
1976,Switzerland,14835,1.5,13,14775,1.44,13,29610,1.47,13,-60,350,-117.14
1976,Spain,8730,0.88,27,17474,1.7,12,26204,1.3,14,8744,8575,1.97
1976,Australia,13193,1.33,14,12232,1.19,19,25425,1.26,15,-961,-1251,-23.18
1976,Poland,11024,1.11,16,13867,1.35,14,24891,1.23,16,2843,2247,26.52
1976,German Democratic Republic,11361,1.15,15,13196,1.29,16,24557,1.22,17,1835,1202,52.66
1976,Brazil,10128,1.02,18,13726,1.34,15,23854,1.18,18,3598,4922,-26.9
1976,Iran,8935,0.9,26,12894,1.26,17,21829,1.08,19,3959,2380,66.34
1976,Denmark,9115,0.92,24,12427,1.21,18,21542,1.07,20,3312,1656,100.0
1976,Austria,8506,0.86,29,11523,1.12,20,20029,0.99,21,3017,1875,60.91
1976,Norway,7951,0.8,32,11121,1.08,21,19072,0.95,22,3170,2473,28.18
1976,Nigeria,10566,1.07,17,8213,0.8,27,18779,0.93,23,-2353,-1793,31.23
1976,Czech and Slovak Federal Republic,9035,0.91,25,9706,0.95,22,18741,0.93,24,671,725,-7.45
1976,"Hong Kong, China",8484,0.86,30,8838,0.86,24,17322,0.86,25,354,740,-52.16
1976,"Venezuela, Bolivarian Republic of",9299,0.94,22,7663,0.75,28,16962,0.84,26,-1636,-2800,-41.57
1976,"Korea, Republic of",7716,0.78,34,8774,0.86,25,16490,0.82,27,1058,2329,-54.57
1976,Chinese Taipei,8155,0.82,31,7609,0.74,29,15764,0.78,28,-546,657,-183.11
1976,Singapore,6585,0.66,36,9071,0.88,23,15656,0.78,29,2486,2757,-9.83
1976,South Africa,7850,0.79,33,7285,0.71,32,15135,0.75,30,-565,-496,13.91
1976,Indonesia,8547,0.86,28,5673,0.55,38,14220,0.7,31,-2874,-2332,23.24
1976,Finland,6342,0.64,37,7392,0.72,30,13734,0.68,32,1050,2126,-50.61
1976,China,6943,0.7,35,6660,0.65,33,13603,0.67,33,-283,237,-219.41
1976,"Kuwait, the State of",9846,0.99,19,3327,0.32,54,13173,0.65,34,-6519,-6796,-4.08
1976,Iraq,9273,0.93,23,3897,0.38,48,13170,0.65,35,-5376,-4083,31.67
1976,United Arab Emirates,9535,0.96,21,3337,0.33,53,12872,0.64,36,-6198,-4577,35.42
1976,Libya,9554,0.96,20,3212,0.31,56,12766,0.63,37,-6342,-3292,92.65
1976,Romania,6138,0.62,38,6583,0.64,34,12721,0.63,38,445,428,3.97
1976,"Yugoslavia, Socialist Federal Republic of",4878,0.49,44,7366,0.72,31,12244,0.61,39,2488,3625,-31.37
1976,Bulgaria,5382,0.54,40,6228,0.61,35,11610,0.58,40,846,1258,-32.75
1976,India,5549,0.56,39,5665,0.55,40,11214,0.56,41,116,2026,-94.27
1976,Hungary,4934,0.5,43,5529,0.54,41,10463,0.52,42,595,1085,-45.16
1976,Algeria,5259,0.53,42,5081,0.5,43,10340,0.51,43,-178,798,-122.31
1976,Mexico,3417,0.34,47,6028,0.59,37,9445,0.47,44,2611,3676,-28.97
1976,Malaysia,5295,0.53,41,3824,0.37,49,9119,0.45,45,-1471,-277,431.05
1976,Greece,2561,0.26,52,6059,0.59,36,8620,0.43,46,3498,3063,14.2
1976,Israel,2415,0.24,55,5669,0.55,39,8084,0.4,47,3254,4056,-19.77
1976,Cuba,3573,0.36,46,4066,0.4,46,7639,0.38,48,493,206,139.32
1976,Ireland,3315,0.33,48,4200,0.41,45,7515,0.37,49,885,586,51.02
1976,Türkiye,1960,0.2,59,5129,0.5,42,7089,0.35,50,3169,3338,-5.06
1976,Argentina,3916,0.39,45,3033,0.3,58,6949,0.34,51,-883,986,-189.55
1976,Thailand,2980,0.3,50,3572,0.35,52,6552,0.32,52,592,1072,-44.78
1976,Philippines,2555,0.26,53,3942,0.38,47,6497,0.32,53,1387,1462,-5.13
1976,Netherlands Antilles,2524,0.25,54,3667,0.36,51,6191,0.31,54,1143,430,165.81
1976,Bahamas,2992,0.3,49,3125,0.3,57,6117,0.3,55,133,189,-29.63
1976,New Zealand,2795,0.28,51,3254,0.32,55,6049,0.3,56,459,993,-53.78
1976,Portugal,1811,0.18,61,4220,0.41,44,6031,0.3,57,2409,1900,26.79
1976,Egypt,1522,0.15,63,3807,0.37,50,5329,0.26,58,2285,2532,-9.76
1976,Trinidad and Tobago,2214,0.22,56,2010,0.2,63,4224,0.21,59,-204,-302,-32.45
1976,Chile,2083,0.21,58,1864,0.18,64,3947,0.2,60,-219,-27,711.11
1976,Morocco,1261,0.13,67,2618,0.26,59,3879,0.19,61,1357,1025,32.39
1976,Colombia,1874,0.19,60,1662,0.16,66,3536,0.18,62,-212,30,-806.67
1976,Pakistan,1186,0.12,69,2311,0.23,61,3497,0.17,63,1125,1160,-3.02
1976,Syrian Arab Republic,1074,0.11,72,2383,0.23,60,3457,0.17,64,1309,755,73.38
1976,Peru,1360,0.14,65,2037,0.2,62,3397,0.17,65,677,1259,-46.23
1976,"Bahrain, Kingdom of",1516,0.15,64,1668,0.16,65,3184,0.16,66,152,82,85.37
1976,Qatar,2210,0.22,57,817,0.08,80,3027,0.15,67,-1393,-1392,0.07
1976,Côte d'Ivoire,1632,0.16,62,1296,0.13,68,2928,0.15,68,-336,-54,522.22
1976,Tunisia,788,0.08,78,1529,0.15,67,2317,0.11,69,741,568,30.46
1976,Ecuador,1258,0.13,68,958,0.09,73,2216,0.11,70,-300,13,-2407.69
1976,Oman,1134,0.11,71,725,0.07,83,1859,0.09,71,-409,-279,46.59
1976,Kenya,790,0.08,77,969,0.09,72,1759,0.09,72,179,339,-47.2
1976,Zambia,1070,0.11,73,674,0.07,85,1744,0.09,73,-396,119,-432.77
1976,Ghana,832,0.08,76,862,0.08,77,1694,0.08,74,30,-25,-220.0
1976,Gabon,1135,0.11,70,503,0.05,94,1638,0.08,75,-632,-474,33.33
1976,Guatemala,760,0.08,79,839,0.08,79,1599,0.08,76,79,109,-27.52
1976,Dominican Republic,716,0.07,81,878,0.09,76,1594,0.08,77,162,-5,-3340.0
1976,Zimbabwe,891,0.09,75,703,0.07,84,1594,0.08,77,-188,0,
1976,Brunei Darussalam,1333,0.13,66,260,0.03,118,1593,0.08,79,-1073,-776,38.27
1976,Viet Nam,402,0.04,96,1171,0.11,69,1573,0.08,80,769,873,-11.91
1976,Jamaica,630,0.06,82,913,0.09,75,1543,0.08,81,283,365,-22.47
1976,Sudan,554,0.06,87,980,0.1,71,1534,0.08,82,426,449,-5.12
1976,El Salvador,743,0.07,80,735,0.07,82,1478,0.07,83,-8,83,-109.64
1976,Costa Rica,593,0.06,84,770,0.08,81,1363,0.07,84,177,201,-11.94
1976,Bangladesh,401,0.04,97,952,0.09,74,1353,0.07,85,551,994,-44.57
1976,Jordan,207,0.02,114,1006,0.1,70,1213,0.06,86,799,579,38.0
1976,Democratic Republic of the Congo,944,0.1,74,224,0.02,120,1168,0.06,87,-720,-565,27.43
1976,Lebanese Republic,546,0.06,89,612,0.06,89,1158,0.06,88,66,815,-91.9
1976,Sri Lanka,572,0.06,85,585,0.06,91,1157,0.06,89,13,247,-94.74
1976,Uruguay,546,0.06,89,587,0.06,90,1133,0.06,90,41,172,-76.16
1976,Cameroon,511,0.05,92,613,0.06,88,1124,0.06,91,102,152,-32.89
1976,"Bolivia, Plurinational State of",568,0.06,86,555,0.05,92,1123,0.06,92,-13,114,-111.4
1976,Senegal,485,0.05,93,636,0.06,87,1121,0.06,93,151,122,23.77
1976,Panama,238,0.02,109,848,0.08,78,1086,0.05,94,610,606,0.66
1976,Tanzania,440,0.04,95,638,0.06,86,1078,0.05,95,198,406,-51.23
1976,Nicaragua,542,0.05,91,532,0.05,93,1074,0.05,96,-10,142,-107.04
1976,Papua New Guinea,551,0.06,88,502,0.05,95,1053,0.05,97,-49,151,-132.45
1976,Angola,619,0.06,83,353,0.03,107,972,0.05,98,-266,-583,-54.37
1976,Iceland,401,0.04,97,467,0.05,96,868,0.04,99,66,178,-62.92
1976,Liberia,460,0.05,94,399,0.04,104,859,0.04,100,-61,-63,-3.17
1976,Honduras,400,0.04,99,456,0.04,97,856,0.04,101,56,105,-46.67
1976,Cyprus,258,0.03,108,432,0.04,99,690,0.03,102,174,156,11.54
1976,Malta,228,0.02,111,423,0.04,100,651,0.03,103,195,209,-6.7
1976,Guyana,279,0.03,104,364,0.04,105,643,0.03,104,85,-21,-504.76
1976,Ethiopia,280,0.03,103,352,0.03,108,632,0.03,105,72,73,-1.37
1976,Mauritius,265,0.03,107,360,0.04,106,625,0.03,106,95,34,179.41
1976,New Caledonia,306,0.03,101,277,0.03,115,583,0.03,107,-29,20,-245.0
1976,"Yemen, People's Democratic Republic",163,0.02,122,412,0.04,103,575,0.03,108,249,132,88.64
1976,Suriname,276,0.03,105,294,0.03,112,570,0.03,109,18,-15,-220.0
1976,Madagascar,275,0.03,106,285,0.03,113,560,0.03,110,10,65,-84.62
1976,Afghanistan,291,0.03,102,261,0.03,117,552,0.03,111,-30,133,-122.56
1976,Reunion,94,0.01,130,445,0.04,98,539,0.03,112,351,348,0.86
1976,Martinique,124,0.01,125,413,0.04,101,537,0.03,113,289,244,18.44
1976,Uganda,364,0.04,100,172,0.02,131,536,0.03,114,-192,-50,284.0
1976,Guinea,237,0.02,110,283,0.03,114,520,0.03,115,46,55,-16.36
1976,Mozambique,150,0.02,123,300,0.03,110,450,0.02,116,150,213,-29.58
1976,Fiji,172,0.02,119,264,0.03,116,436,0.02,117,92,65,41.54
1976,Yemen,8,0.0,161,413,0.04,101,421,0.02,118,405,283,43.11
1976,Guadeloupe,90,0.01,131,318,0.03,109,408,0.02,119,228,223,2.24
1976,Paraguay,181,0.02,117,220,0.02,121,401,0.02,120,39,30,30.0
1976,Congo,221,0.02,112,172,0.02,131,393,0.02,121,-49,-8,512.5
1976,Myanmar,208,0.02,113,179,0.02,129,387,0.02,122,-29,22,-231.82
1976,Eswatini,183,0.02,116,200,0.02,127,383,0.02,123,17,-17,-200.0
1976,Botswana,170,0.02,120,209,0.02,124,379,0.02,124,39,74,-47.3
1976,Malawi,166,0.02,121,206,0.02,126,372,0.02,125,40,113,-64.6
1976,Mauritania,178,0.02,118,179,0.02,129,357,0.02,126,1,-15,-106.67
1976,"Macao, China",188,0.02,115,161,0.02,134,349,0.02,127,-27,28,-196.43
1976,Haiti,124,0.01,125,207,0.02,125,331,0.02,128,83,69,20.29
1976,Barbados,86,0.01,132,237,0.02,119,323,0.02,129,151,110,37.27
1976,French Polynesia,22,0.0,146,296,0.03,111,318,0.02,130,274,261,4.98
1976,Togo,105,0.01,127,185,0.02,128,290,0.01,131,80,48,66.67
1976,Nepal,98,0.01,129,163,0.02,133,261,0.01,132,65,72,-9.72
1976,Niger,134,0.01,124,126,0.01,139,260,0.01,133,-8,10,-180.0
1976,Sierra Leone,99,0.01,128,153,0.01,136,252,0.01,134,54,67,-19.4
1976,Benin,25,0.0,143,219,0.02,122,244,0.01,135,194,156,24.36
1976,Mali,84,0.01,134,155,0.02,135,239,0.01,136,71,123,-42.28
1976,Lesotho,17,0.0,149,212,0.02,123,229,0.01,137,195,152,28.29
1976,Greenland,86,0.01,132,129,0.01,138,215,0.01,138,43,41,4.88
1976,Burkina Faso,53,0.01,140,144,0.01,137,197,0.01,139,91,107,-14.95
1976,Rwanda,80,0.01,135,106,0.01,142,186,0.01,140,26,57,-54.39
1976,Chad,63,0.01,137,116,0.01,141,179,0.01,141,53,85,-37.65
1976,Djibouti,16,0.0,152,120,0.01,140,136,0.01,142,104,121,-14.05
1976,Burundi,61,0.01,138,58,0.01,146,119,0.01,143,-3,30,-110.0
1976,Central African Republic,61,0.01,138,55,0.01,147,116,0.01,144,-6,22,-127.27
1976,American Samoa,65,0.01,136,51,0.0,149,116,0.01,144,-14,3,-566.67
1976,Belize,42,0.0,141,73,0.01,145,115,0.01,146,31,21,47.62
1976,The Gambia,35,0.0,142,74,0.01,144,109,0.01,147,39,16,143.75
1976,French Guiana,4,0.0,166,86,0.01,143,90,0.0,148,82,70,17.14
1976,Saint Lucia,21,0.0,148,48,0.0,150,69,0.0,149,27,29,-6.9
1976,Montserrat,3,0.0,169,54,0.01,148,57,0.0,150,51,34,50.0
1976,Lao People's Democratic Republic,12,0.0,154,45,0.0,151,57,0.0,150,33,33,0.0
1976,Solomon Islands,24,0.0,145,30,0.0,156,54,0.0,152,6,17,-64.71
1976,Vanuatu,17,0.0,149,34,0.0,155,51,0.0,153,17,28,-39.29
1976,Seychelles,9,0.0,158,39,0.0,152,48,0.0,154,30,26,15.38
1976,Antigua and Barbuda,9,0.0,158,35,0.0,154,44,0.0,155,26,47,-44.68
1976,Guinea-Bissau,6,0.0,165,37,0.0,153,43,0.0,156,31,31,0.0
1976,Saint Kitts and Nevis,17,0.0,149,22,0.0,162,39,0.0,157,5,3,66.67
1976,Grenada,13,0.0,153,25,0.0,160,38,0.0,158,12,12,0.0
1976,Samoa,7,0.0,164,30,0.0,156,37,0.0,159,23,30,-23.33
1976,Saint Pierre and Miquelon,8,0.0,161,27,0.0,159,35,0.0,160,19,18,5.56
1976,Saint Vincent and the Grenadines,9,0.0,158,24,0.0,161,33,0.0,161,15,17,-11.76
1976,Cabo Verde,2,0.0,171,30,0.0,156,32,0.0,162,28,38,-26.32
1976,Kiribati,22,0.0,146,8,0.0,169,30,0.0,163,-14,-29,-51.72
1976,Dominica,11,0.0,156,19,0.0,163,30,0.0,163,8,10,-20.0
1976,Comoros,12,0.0,154,13,0.0,165,25,0.0,165,1,13,-92.31
1976,Guam,25,0.0,143,0,0.0,172,25,0.0,165,-25,-28,-10.71
1976,Tonga,4,0.0,166,14,0.0,164,18,0.0,167,10,11,-9.09
1976,Sao Tomé and Principe,8,0.0,161,9,0.0,168,17,0.0,168,1,4,-75.0
1976,Cook Islands,2,0.0,171,13,0.0,165,15,0.0,169,11,10,10.0
1976,Equatorial Guinea,10,0.0,157,4,0.0,171,14,0.0,170,-6,-6,0.0
1976,Cambodia,4,0.0,166,10,0.0,167,14,0.0,170,6,55,-89.09
1976,Maldives,3,0.0,169,6,0.0,170,9,0.0,172,3,4,-25.0
1975,United States of America,108856,12.42,1,105881,11.62,1,214737,12.01,1,-2975,11041,-126.95
1975,Germany,90176,10.29,2,74931,8.22,2,165107,9.23,2,-15245,-19707,-22.64
1975,Japan,55819,6.37,3,57860,6.35,3,113679,6.36,3,2041,6479,-68.5
1975,France,53100,6.06,4,53947,5.92,4,107047,5.99,4,847,6659,-87.28
1975,United Kingdom,43423,4.95,5,53341,5.85,5,96764,5.41,5,9918,15993,-37.99
1975,Netherlands,39888,4.55,6,40897,4.49,6,80785,4.52,6,1009,1526,-33.88
1975,Italy,34988,3.99,7,38526,4.23,7,73514,4.11,7,3538,10624,-66.7
1975,U.S.S.R.,33316,3.8,9,36971,4.06,8,70287,3.93,8,3655,-2515,-245.33
1975,Canada,34074,3.89,8,36107,3.96,9,70181,3.92,9,2033,-260,-881.92
1975,Belgium-Luxembourg,28804,3.29,11,30781,3.38,10,59585,3.33,10,1977,1546,27.88
1975,Sweden,17384,1.98,12,17450,1.91,11,34834,1.95,11,66,744,-91.13
1975,"Saudi Arabia, Kingdom of",29673,3.38,10,4213,0.46,44,33886,1.89,12,-25460,-32695,-22.13
1975,Switzerland,12953,1.48,13,13303,1.46,14,26256,1.47,13,350,2511,-86.06
1975,Spain,7690,0.88,26,16265,1.78,12,23955,1.34,14,8575,8337,2.85
1975,Poland,10289,1.17,15,12536,1.38,15,22825,1.28,15,2247,2161,3.98
1975,Australia,11948,1.36,14,10697,1.17,17,22645,1.27,16,-1251,966,-229.5
1975,Brazil,8670,0.99,21,13592,1.49,13,22262,1.24,17,4922,6217,-20.83
1975,German Democratic Republic,10088,1.15,16,11290,1.24,16,21378,1.2,18,1202,898,33.85
1975,Denmark,8712,0.99,20,10368,1.14,18,19080,1.07,19,1656,2208,-25.0
1975,Iran,7963,0.91,24,10343,1.13,19,18306,1.02,20,2380,-2969,-180.16
1975,Czech and Slovak Federal Republic,8356,0.95,22,9081,1.0,22,17437,0.98,21,725,479,51.36
1975,South Africa,8789,1.0,19,8293,0.91,23,17082,0.96,22,-496,-832,-40.38
1975,Norway,7232,0.82,30,9705,1.06,20,16937,0.95,23,2473,2138,15.67
1975,Austria,7519,0.86,28,9394,1.03,21,16913,0.95,24,1875,1861,0.75
1975,China,7689,0.88,27,7926,0.87,25,15615,0.87,25,237,683,-65.3
1975,"Venezuela, Bolivarian Republic of",8800,1.0,18,6000,0.66,34,14800,0.83,26,-2800,-7005,-60.03
1975,Nigeria,7834,0.89,25,6041,0.66,33,13875,0.78,27,-1793,-6433,-72.13
1975,Singapore,5376,0.61,36,8133,0.89,24,13509,0.76,28,2757,2570,7.28
1975,Hungary,6091,0.69,33,7176,0.79,29,13267,0.74,29,1085,446,143.27
1975,Finland,5502,0.63,35,7628,0.84,27,13130,0.73,30,2126,1323,60.7
1975,"Hong Kong, China",6026,0.69,34,6766,0.74,30,12792,0.72,31,740,810,-8.64
1975,Iraq,8298,0.95,23,4215,0.46,43,12513,0.7,32,-4083,-4232,-3.52
1975,"Korea, Republic of",4945,0.56,39,7274,0.8,28,12219,0.68,33,2329,2390,-2.55
1975,Indonesia,7102,0.81,31,4770,0.52,41,11872,0.66,34,-2332,-3584,-34.93
1975,"Yugoslavia, Socialist Federal Republic of",4072,0.46,43,7697,0.84,26,11769,0.66,35,3625,3737,-3.0
1975,"Kuwait, the State of",9184,1.05,17,2388,0.26,60,11572,0.65,36,-6796,-9409,-27.77
1975,Chinese Taipei,5302,0.6,38,5959,0.65,36,11261,0.63,37,657,1465,-55.15
1975,Romania,5341,0.61,37,5769,0.63,38,11110,0.62,38,428,681,-37.15
1975,India,4355,0.5,42,6381,0.7,32,10736,0.6,39,2026,1210,67.44
1975,Bulgaria,4691,0.54,41,5949,0.65,37,10640,0.6,40,1258,490,156.73
1975,Libya,6834,0.78,32,3542,0.39,52,10376,0.58,41,-3292,-5497,-40.11
1975,Algeria,4700,0.54,40,5498,0.6,39,10198,0.57,42,798,-652,-222.39
1975,United Arab Emirates,7262,0.83,29,2685,0.29,57,9947,0.56,43,-4577,-4709,-2.8
1975,Mexico,2904,0.33,48,6580,0.72,31,9484,0.53,44,3676,3099,18.62
1975,Israel,1941,0.22,55,5997,0.66,35,7938,0.44,45,4056,3612,12.29
1975,Greece,2294,0.26,51,5357,0.59,40,7651,0.43,46,3063,2355,30.06
1975,Cuba,3677,0.42,45,3883,0.43,47,7560,0.42,47,206,-12,-1816.67
1975,Malaysia,3843,0.44,44,3566,0.39,51,7409,0.41,48,-277,-122,127.05
1975,Ireland,3192,0.36,46,3778,0.41,49,6970,0.39,49,586,1156,-49.31
1975,Argentina,2961,0.34,47,3947,0.43,45,6908,0.39,50,986,-296,-433.11
1975,Türkiye,1401,0.16,63,4739,0.52,42,6140,0.34,51,3338,2246,48.62
1975,Philippines,2294,0.26,51,3756,0.41,50,6050,0.34,52,1462,746,95.98
1975,Portugal,1939,0.22,56,3839,0.42,48,5778,0.32,53,1900,2219,-14.38
1975,Thailand,2208,0.25,53,3280,0.36,53,5488,0.31,54,1072,699,53.36
1975,Egypt,1402,0.16,62,3934,0.43,46,5336,0.3,55,2532,835,203.23
1975,New Zealand,2162,0.25,54,3155,0.35,54,5317,0.3,56,993,1213,-18.14
1975,Netherlands Antilles,2397,0.27,50,2827,0.31,55,5224,0.29,57,430,401,7.23
1975,Bahamas,2508,0.29,49,2697,0.3,56,5205,0.29,58,189,464,-59.27
1975,Morocco,1543,0.18,60,2568,0.28,58,4111,0.23,59,1025,196,422.96
1975,Peru,1291,0.15,64,2550,0.28,59,3841,0.21,60,1259,28,4396.43
1975,Lebanese Republic,1233,0.14,65,2048,0.22,62,3281,0.18,61,815,719,13.35
1975,Pakistan,1053,0.12,68,2213,0.24,61,3266,0.18,62,1160,1013,14.51
1975,Trinidad and Tobago,1771,0.2,58,1469,0.16,66,3240,0.18,63,-302,-190,58.95
1975,Chile,1552,0.18,59,1525,0.17,64,3077,0.17,64,-27,-333,-91.89
1975,Colombia,1465,0.17,61,1495,0.16,65,2960,0.17,65,30,88,-65.91
1975,Syrian Arab Republic,930,0.11,75,1685,0.18,63,2615,0.15,66,755,445,69.66
1975,Côte d'Ivoire,1181,0.13,66,1127,0.12,70,2308,0.13,67,-54,-244,-77.87
1975,"Bahrain, Kingdom of",1107,0.13,67,1189,0.13,69,2296,0.13,68,82,-145,-156.55
1975,Tunisia,856,0.1,78,1424,0.16,67,2280,0.13,69,568,207,174.4
1975,Qatar,1805,0.21,57,413,0.05,97,2218,0.12,70,-1392,-1744,-20.18
1975,Ecuador,974,0.11,72,987,0.11,73,1961,0.11,71,13,-446,-102.91
1975,Jamaica,759,0.09,81,1124,0.12,71,1883,0.11,72,365,332,9.94
1975,Zimbabwe,932,0.11,74,932,0.1,75,1864,0.1,73,0,2,-100.0
1975,Oman,1044,0.12,70,765,0.08,83,1809,0.1,74,-279,-430,-35.12
1975,Dominican Republic,894,0.1,76,889,0.1,78,1783,0.1,75,-5,171,-102.92
1975,Zambia,810,0.09,80,929,0.1,76,1739,0.1,76,119,-620,-119.19
1975,Bangladesh,327,0.04,97,1321,0.14,68,1648,0.09,77,994,730,36.16
1975,Ghana,816,0.09,79,791,0.09,81,1607,0.09,78,-25,83,-130.12
1975,Kenya,606,0.07,83,945,0.1,74,1551,0.09,79,339,423,-19.86
1975,Angola,1012,0.12,71,429,0.05,96,1441,0.08,80,-583,-588,-0.85
1975,Gabon,943,0.11,73,469,0.05,95,1412,0.08,81,-474,-436,8.72
1975,Sri Lanka,569,0.06,84,816,0.09,80,1385,0.08,82,247,193,27.98
1975,Guatemala,624,0.07,82,733,0.08,84,1357,0.08,83,109,128,-14.84
1975,Viet Nam,229,0.03,107,1102,0.12,72,1331,0.07,84,873,296,194.93
1975,Sudan,438,0.05,91,887,0.1,79,1325,0.07,85,449,292,53.77
1975,Brunei Darussalam,1049,0.12,69,273,0.03,116,1322,0.07,86,-776,-795,-2.39
1975,Costa Rica,493,0.06,86,694,0.08,86,1187,0.07,87,201,280,-28.21
1975,Panama,286,0.03,103,892,0.1,77,1178,0.07,88,606,611,-0.82
1975,Democratic Republic of the Congo,865,0.1,77,300,0.03,113,1165,0.07,89,-565,-1032,-45.25
1975,Tanzania,372,0.04,95,778,0.09,82,1150,0.06,90,406,350,16.0
1975,El Salvador,531,0.06,85,614,0.07,87,1145,0.06,91,83,99,-16.16
1975,Cameroon,447,0.05,88,599,0.07,88,1046,0.06,92,152,-41,-470.73
1975,Senegal,461,0.05,87,583,0.06,90,1044,0.06,93,122,107,14.02
1975,Papua New Guinea,441,0.05,90,592,0.06,89,1033,0.06,94,151,-136,-211.03
1975,"Bolivia, Plurinational State of",444,0.05,89,558,0.06,91,1002,0.06,95,114,-167,-168.26
1975,Uruguay,384,0.04,93,556,0.06,92,940,0.05,96,172,105,63.81
1975,Nicaragua,375,0.04,94,517,0.06,93,892,0.05,97,142,181,-21.55
1975,Jordan,153,0.02,119,732,0.08,85,885,0.05,98,579,333,73.87
1975,Iceland,306,0.03,99,484,0.05,94,790,0.04,99,178,187,-4.81
1975,Liberia,394,0.04,92,331,0.04,108,725,0.04,100,-63,-112,-43.75
1975,Guyana,365,0.04,96,344,0.04,105,709,0.04,101,-21,-15,40.0
1975,Honduras,295,0.03,102,400,0.04,100,695,0.04,102,105,93,12.9
1975,New Caledonia,327,0.04,97,347,0.04,104,674,0.04,103,20,3,566.67
1975,Madagascar,301,0.03,100,366,0.04,102,667,0.04,104,65,37,75.68
1975,Mauritius,298,0.03,101,332,0.04,107,630,0.04,105,34,-3,-1233.33
1975,Mozambique,198,0.02,110,411,0.05,98,609,0.03,106,213,164,29.88
1975,Afghanistan,217,0.02,108,350,0.04,103,567,0.03,107,133,13,923.08
1975,Ethiopia,240,0.03,106,313,0.03,110,553,0.03,108,73,14,421.43
1975,Malta,166,0.02,117,375,0.04,101,541,0.03,109,209,227,-7.93
1975,Suriname,277,0.03,104,262,0.03,118,539,0.03,110,-15,-39,-61.54
1975,"Yemen, People's Democratic Republic",191,0.02,112,323,0.04,109,514,0.03,111,132,156,-15.38
1975,Reunion,62,0.01,134,410,0.04,99,472,0.03,112,348,267,30.34
1975,Fiji,203,0.02,109,268,0.03,117,471,0.03,113,65,83,-21.69
1975,Uganda,257,0.03,105,207,0.02,123,464,0.03,114,-50,-102,-50.98
1975,Cyprus,152,0.02,120,308,0.03,111,460,0.03,115,156,255,-38.82
1975,Martinique,96,0.01,128,340,0.04,106,436,0.02,116,244,221,10.41
1975,Malawi,140,0.02,122,253,0.03,119,393,0.02,117,113,68,66.18
1975,Guadeloupe,84,0.01,131,307,0.03,112,391,0.02,118,223,172,29.65
1975,Paraguay,176,0.02,114,206,0.02,124,382,0.02,119,30,31,-3.23
1975,Guinea,161,0.02,118,216,0.02,121,377,0.02,120,55,48,14.58
1975,Eswatini,195,0.02,111,178,0.02,128,373,0.02,121,-17,-40,-57.5
1975,Myanmar,173,0.02,116,195,0.02,125,368,0.02,122,22,-12,-283.33
1975,Botswana,142,0.02,121,216,0.02,121,358,0.02,123,74,63,17.46
1975,Congo,178,0.02,113,170,0.02,132,348,0.02,124,-8,-102,-92.16
1975,Mauritania,176,0.02,114,161,0.02,134,337,0.02,125,-15,-60,-75.0
1975,Barbados,107,0.01,126,217,0.02,120,324,0.02,126,110,118,-6.78
1975,French Polynesia,25,0.0,147,286,0.03,115,311,0.02,127,261,255,2.35
1975,Yemen,11,0.0,157,294,0.03,114,305,0.02,128,283,177,59.89
1975,Sierra Leone,118,0.01,125,185,0.02,127,303,0.02,129,67,78,-14.1
1975,Togo,126,0.01,124,174,0.02,130,300,0.02,130,48,-70,-168.57
1975,"Macao, China",133,0.02,123,161,0.02,134,294,0.02,131,28,24,16.67
1975,Nepal,100,0.01,127,172,0.02,131,272,0.02,132,72,68,5.88
1975,Mali,53,0.01,135,176,0.02,129,229,0.01,133,123,116,6.03
1975,Haiti,80,0.01,132,149,0.02,137,229,0.01,133,69,53,30.19
1975,Benin,32,0.0,143,188,0.02,126,220,0.01,135,156,113,38.05
1975,Greenland,87,0.01,130,128,0.01,140,215,0.01,136,41,14,192.86
1975,Burkina Faso,44,0.01,139,151,0.02,136,195,0.01,137,107,108,-0.93
1975,Niger,91,0.01,129,101,0.01,141,192,0.01,138,10,44,-77.27
1975,Chad,48,0.01,137,133,0.01,139,181,0.01,139,85,50,70.0
1975,Lesotho,12,0.0,153,164,0.02,133,176,0.01,140,152,106,43.4
1975,Belize,67,0.01,133,88,0.01,143,155,0.01,141,21,19,10.53
1975,Djibouti,15,0.0,152,136,0.01,138,151,0.01,142,121,101,19.8
1975,Rwanda,42,0.0,141,99,0.01,142,141,0.01,143,57,22,159.09
1975,Central African Republic,47,0.01,138,69,0.01,145,116,0.01,144,22,-2,-1200.0
1975,The Gambia,44,0.01,139,60,0.01,148,104,0.01,145,16,4,300.0
1975,American Samoa,50,0.01,136,53,0.01,150,103,0.01,146,3,-36,-108.33
1975,Burundi,32,0.0,143,62,0.01,147,94,0.01,147,30,12,150.0
1975,Antigua and Barbuda,20,0.0,149,67,0.01,146,87,0.0,148,47,41,14.63
1975,French Guiana,2,0.0,170,72,0.01,144,74,0.0,149,70,55,27.27
1975,Cambodia,5,0.0,167,60,0.01,148,65,0.0,150,55,161,-65.84
1975,Saint Lucia,17,0.0,150,46,0.01,151,63,0.0,151,29,28,3.57
1975,Lao People's Democratic Republic,12,0.0,153,45,0.0,152,57,0.0,152,33,55,-40.0
1975,Vanuatu,12,0.0,153,40,0.0,153,52,0.0,153,28,19,47.37
1975,Solomon Islands,16,0.0,151,33,0.0,158,49,0.0,154,17,1,1600.0
1975,Equatorial Guinea,26,0.0,146,20,0.0,166,46,0.0,155,-6,-19,-68.42
1975,Guinea-Bissau,7,0.0,161,38,0.0,155,45,0.0,156,31,39,-20.51
1975,Saint Kitts and Nevis,21,0.0,148,24,0.0,161,45,0.0,156,3,8,-62.5
1975,Samoa,7,0.0,161,37,0.0,156,44,0.0,158,30,13,130.77
1975,Kiribati,36,0.0,142,7,0.0,170,43,0.0,159,-29,-23,26.09
1975,Cabo Verde,2,0.0,170,40,0.0,153,42,0.0,160,38,32,18.75
1975,Seychelles,6,0.0,164,32,0.0,159,38,0.0,161,26,21,23.81
1975,Montserrat,2,0.0,170,36,0.0,157,38,0.0,161,34,31,9.68
1975,Grenada,12,0.0,153,24,0.0,161,36,0.0,163,12,8,50.0
1975,Comoros,10,0.0,159,23,0.0,164,33,0.0,164,13,17,-23.53
1975,Saint Vincent and the Grenadines,8,0.0,160,25,0.0,160,33,0.0,164,17,18,-5.56
1975,Dominica,11,0.0,157,21,0.0,165,32,0.0,166,10,9,11.11
1975,Saint Pierre and Miquelon,6,0.0,164,24,0.0,161,30,0.0,167,18,21,-14.29
1975,Guam,28,0.0,145,0,0.0,172,28,0.0,168,-28,-20,40.0
1975,Tonga,6,0.0,164,17,0.0,167,23,0.0,169,11,10,10.0
1975,Sao Tomé and Principe,7,0.0,161,11,0.0,169,18,0.0,170,4,-7,-157.14
1975,Cook Islands,3,0.0,168,13,0.0,168,16,0.0,171,10,5,100.0
1975,Maldives,3,0.0,168,7,0.0,170,10,0.0,172,4,3,33.33
1974,United States of America,99437,11.83,1,110478,12.84,1,209915,12.34,1,11041,2749,301.64
1974,Germany,89368,10.63,2,69661,8.1,2,159029,9.35,2,-19707,-12672,55.52
1974,Japan,55469,6.6,3,61948,7.2,3,117417,6.9,3,6479,1372,372.23
1974,France,46259,5.5,4,52918,6.15,5,99177,5.83,4,6659,1069,522.92
1974,United Kingdom,38197,4.54,5,54190,6.3,4,92387,5.43,5,15993,8891,79.88
1974,Netherlands,37423,4.45,6,38949,4.53,7,76372,4.49,6,1526,1392,9.63
1974,Italy,30465,3.62,9,41089,4.78,6,71554,4.21,7,10624,5572,90.67
1974,Canada,34508,4.11,8,34248,3.98,8,68756,4.04,8,-260,-1724,-84.92
1974,Belgium-Luxembourg,28334,3.37,10,29880,3.47,9,58214,3.42,9,1546,-380,-506.84
1974,U.S.S.R.,27405,3.26,11,24890,2.89,10,52295,3.07,10,-2515,-351,616.52
1974,"Saudi Arabia, Kingdom of",35555,4.23,7,2860,0.33,50,38415,2.26,11,-32695,-7016,366.01
1974,Sweden,15939,1.9,12,16683,1.94,11,32622,1.92,12,744,-1294,-157.5
1974,Switzerland,11934,1.42,13,14445,1.68,13,26379,1.55,13,2511,2098,19.69
1974,Australia,11016,1.31,15,11982,1.39,15,22998,1.35,14,966,-2166,-144.6
1974,Spain,7091,0.84,28,15428,1.79,12,22519,1.32,15,8337,4469,86.55
1974,Brazil,7951,0.95,23,14168,1.65,14,22119,1.3,16,6217,800,677.13
1974,Poland,8321,0.99,21,10482,1.22,16,18803,1.11,17,2161,1382,56.37
1974,German Democratic Republic,8748,1.04,18,9646,1.12,18,18394,1.08,18,898,333,169.67
1974,Denmark,7719,0.92,24,9927,1.15,17,17646,1.04,19,2208,1554,42.08
1974,South Africa,8688,1.03,19,7856,0.91,22,16544,0.97,20,-832,-901,-7.66
1974,Austria,7161,0.85,26,9022,1.05,19,16183,0.95,21,1861,1836,1.36
1974,"Venezuela, Bolivarian Republic of",11153,1.33,14,4148,0.48,39,15301,0.9,22,-7005,-2079,236.94
1974,China,7108,0.85,27,7791,0.91,23,14899,0.88,23,683,-668,-202.25
1974,Norway,6282,0.75,32,8420,0.98,20,14702,0.86,24,2138,1564,36.7
1974,Czech and Slovak Federal Republic,7053,0.84,29,7532,0.88,25,14585,0.86,25,479,102,369.61
1974,Singapore,5810,0.69,34,8380,0.97,21,14190,0.83,26,2570,1474,74.36
1974,Iran,8402,1.0,20,5433,0.63,34,13835,0.81,27,-2969,724,-510.08
1974,"Hong Kong, China",5968,0.71,33,6778,0.79,29,12746,0.75,28,810,584,38.7
1974,"Kuwait, the State of",10963,1.3,16,1554,0.18,64,12517,0.74,29,-9409,-2766,240.17
1974,Chinese Taipei,5518,0.66,35,6983,0.81,26,12501,0.74,30,1465,-582,-351.72
1974,Finland,5490,0.65,36,6813,0.79,28,12303,0.72,31,1323,504,162.5
1974,Nigeria,9205,1.1,17,2772,0.32,51,11977,0.7,32,-6433,-1600,302.06
1974,"Yugoslavia, Socialist Federal Republic of",3805,0.45,45,7542,0.88,24,11347,0.67,33,3737,1658,125.39
1974,"Korea, Republic of",4462,0.53,40,6852,0.8,27,11314,0.67,34,2390,1019,134.54
1974,Indonesia,7426,0.88,25,3842,0.45,42,11268,0.66,35,-3584,-482,643.57
1974,Libya,8259,0.98,22,2762,0.32,52,11021,0.65,36,-5497,-2197,150.2
1974,Hungary,5130,0.61,37,5576,0.65,31,10706,0.63,37,446,-514,-186.77
1974,Romania,4874,0.58,38,5555,0.65,32,10429,0.61,38,681,47,1348.94
1974,India,3926,0.47,43,5136,0.6,35,9062,0.53,39,1210,294,311.56
1974,Mexico,2958,0.35,47,6057,0.7,30,9015,0.53,40,3099,1564,98.15
1974,Iraq,6602,0.79,30,2370,0.28,54,8972,0.53,41,-4232,-1048,303.82
1974,Algeria,4687,0.56,39,4035,0.47,41,8722,0.51,42,-652,349,-286.82
1974,Malaysia,4236,0.5,41,4114,0.48,40,8350,0.49,43,-122,-599,-79.63
1974,Bulgaria,3836,0.46,44,4326,0.5,38,8162,0.48,44,490,-62,-890.32
1974,United Arab Emirates,6414,0.76,31,1705,0.2,62,8119,0.48,45,-4709,-986,377.59
1974,Argentina,3931,0.47,42,3635,0.42,46,7566,0.44,46,-296,-1036,-71.43
1974,Israel,1825,0.22,58,5437,0.63,33,7262,0.43,47,3612,2791,29.42
1974,Netherlands Antilles,3230,0.38,46,3631,0.42,47,6861,0.4,48,401,224,79.02
1974,Portugal,2277,0.27,54,4496,0.52,36,6773,0.4,49,2219,1173,89.17
1974,Ireland,2658,0.32,50,3814,0.44,43,6472,0.38,50,1156,658,75.68
1974,Greece,2030,0.24,56,4385,0.51,37,6415,0.38,51,2355,2021,16.53
1974,Philippines,2725,0.32,48,3471,0.4,48,6196,0.36,52,746,-85,-977.65
1974,New Zealand,2435,0.29,53,3648,0.42,45,6083,0.36,53,1213,-420,-388.81
1974,Thailand,2444,0.29,52,3143,0.37,49,5587,0.33,54,699,485,44.12
1974,Türkiye,1532,0.18,61,3778,0.44,44,5310,0.31,55,2246,769,192.07
1974,Cuba,2660,0.32,49,2648,0.31,53,5308,0.31,56,-12,383,-103.13
1974,Chile,2481,0.3,51,2148,0.25,58,4629,0.27,57,-333,59,-664.41
1974,Lebanese Republic,1636,0.19,60,2355,0.27,55,3991,0.23,58,719,365,96.99
1974,Trinidad and Tobago,2036,0.24,55,1846,0.21,61,3882,0.23,59,-190,98,-293.88
1974,Egypt,1516,0.18,62,2351,0.27,56,3867,0.23,60,835,-206,-505.34
1974,Morocco,1708,0.2,59,1904,0.22,60,3612,0.21,61,196,234,-16.24
1974,Pakistan,1193,0.14,71,2206,0.26,57,3399,0.2,62,1013,67,1411.94
1974,Bahamas,1444,0.17,65,1908,0.22,59,3352,0.2,63,464,234,98.29
1974,Colombia,1509,0.18,63,1597,0.19,63,3106,0.18,64,88,-107,-182.24
1974,Peru,1503,0.18,64,1531,0.18,65,3034,0.18,65,28,-93,-130.11
1974,"Bahrain, Kingdom of",1272,0.15,68,1127,0.13,68,2399,0.14,66,-145,31,-567.74
1974,Qatar,2015,0.24,57,271,0.03,112,2286,0.13,67,-1744,-433,302.77
1974,Zambia,1407,0.17,66,787,0.09,77,2194,0.13,68,-620,-611,1.47
1974,Côte d'Ivoire,1213,0.14,69,969,0.11,71,2182,0.13,69,-244,-147,65.99
1974,Tunisia,921,0.11,74,1128,0.13,67,2049,0.12,70,207,260,-20.38
1974,Syrian Arab Republic,782,0.09,77,1227,0.14,66,2009,0.12,71,445,262,69.85
1974,Angola,1202,0.14,70,614,0.07,84,1816,0.11,72,-588,-213,176.06
1974,Ecuador,1124,0.13,72,678,0.08,82,1802,0.11,73,-446,-135,230.37
1974,Democratic Republic of the Congo,1381,0.16,67,349,0.04,100,1730,0.1,74,-1032,-762,35.43
1974,Zimbabwe,863,0.1,75,865,0.1,73,1728,0.1,75,2,-82,-102.44
1974,Kenya,603,0.07,83,1026,0.12,70,1629,0.1,76,423,142,197.89
1974,Ghana,738,0.09,79,821,0.1,75,1559,0.09,77,83,-205,-140.49
1974,Jamaica,604,0.07,82,936,0.11,72,1540,0.09,78,332,287,15.68
1974,Dominican Republic,637,0.08,81,808,0.09,76,1445,0.08,79,171,47,263.83
1974,Bangladesh,348,0.04,96,1078,0.13,69,1426,0.08,80,730,628,16.24
1974,Guatemala,572,0.07,84,700,0.08,81,1272,0.07,81,128,-5,-2660.0
1974,Sri Lanka,527,0.06,86,720,0.08,79,1247,0.07,82,193,20,865.0
1974,Oman,823,0.1,76,393,0.05,96,1216,0.07,83,-430,-123,249.59
1974,Papua New Guinea,654,0.08,80,518,0.06,87,1172,0.07,84,-136,-159,-14.47
1974,Brunei Darussalam,980,0.12,73,185,0.02,123,1165,0.07,85,-795,-215,269.77
1974,Costa Rica,440,0.05,89,720,0.08,79,1160,0.07,86,280,110,154.55
1974,Tanzania,403,0.05,90,753,0.09,78,1156,0.07,87,350,129,171.32
1974,Gabon,768,0.09,78,332,0.04,102,1100,0.06,88,-436,-141,209.22
1974,Panama,211,0.03,110,822,0.1,74,1033,0.06,89,611,364,67.86
1974,El Salvador,463,0.06,88,562,0.07,85,1025,0.06,90,99,25,296.0
1974,Sudan,350,0.04,95,642,0.07,83,992,0.06,91,292,2,14500.0
1974,"Bolivia, Plurinational State of",557,0.07,85,390,0.05,97,947,0.06,92,-167,-31,438.71
1974,Nicaragua,381,0.05,94,562,0.07,85,943,0.06,93,181,49,269.39
1974,Cameroon,478,0.06,87,437,0.05,93,915,0.05,94,-41,-19,115.79
1974,Senegal,391,0.05,92,498,0.06,89,889,0.05,95,107,166,-35.54
1974,Uruguay,382,0.05,93,487,0.06,91,869,0.05,96,105,-37,-383.78
1974,Iceland,331,0.04,97,518,0.06,87,849,0.05,97,187,69,171.01
1974,Mozambique,298,0.04,100,462,0.05,92,760,0.04,98,164,240,-31.67
1974,Liberia,400,0.05,91,288,0.03,106,688,0.04,99,-112,-131,-14.5
1974,"Yemen, People's Democratic Republic",263,0.03,106,419,0.05,94,682,0.04,100,156,53,194.34
1974,Honduras,289,0.03,101,382,0.04,98,671,0.04,101,93,3,3000.0
1974,Jordan,155,0.02,117,488,0.06,90,643,0.04,102,333,257,29.57
1974,Mauritius,312,0.04,99,309,0.04,104,621,0.04,103,-3,31,-109.68
1974,New Caledonia,279,0.03,102,282,0.03,109,561,0.03,104,3,24,-87.5
1974,Cyprus,152,0.02,118,407,0.05,95,559,0.03,105,255,278,-8.27
1974,Ethiopia,269,0.03,104,283,0.03,108,552,0.03,106,14,-25,-156.0
1974,Uganda,315,0.04,98,213,0.02,118,528,0.03,107,-102,-128,-20.31
1974,Guyana,270,0.03,103,255,0.03,113,525,0.03,108,-15,41,-136.59
1974,Madagascar,244,0.03,107,281,0.03,110,525,0.03,108,37,0,
1974,Suriname,269,0.03,104,230,0.03,115,499,0.03,110,-39,-21,85.71
1974,Malta,134,0.02,120,361,0.04,99,495,0.03,111,227,141,60.99
1974,Afghanistan,230,0.03,108,243,0.03,114,473,0.03,112,13,29,-55.17
1974,Fiji,190,0.02,111,273,0.03,111,463,0.03,113,83,100,-17.0
1974,Reunion,69,0.01,130,336,0.04,101,405,0.02,114,267,224,19.2
1974,Myanmar,189,0.02,112,177,0.02,127,366,0.02,115,-12,-25,-52.0
1974,Sierra Leone,144,0.02,119,222,0.03,117,366,0.02,115,78,24,225.0
1974,Martinique,72,0.01,128,293,0.03,105,365,0.02,117,221,189,16.93
1974,Paraguay,167,0.02,116,198,0.02,120,365,0.02,117,31,-2,-1650.0
1974,Congo,229,0.03,109,127,0.01,134,356,0.02,119,-102,39,-361.54
1974,Viet Nam,25,0.0,149,321,0.04,103,346,0.02,120,296,558,-46.95
1974,French Polynesia,32,0.0,144,287,0.03,107,319,0.02,121,255,192,32.81
1974,Eswatini,178,0.02,115,138,0.02,131,316,0.02,122,-40,-12,233.33
1974,Togo,189,0.02,112,119,0.01,139,308,0.02,123,-70,40,-275.0
1974,Malawi,120,0.01,122,188,0.02,122,308,0.02,123,68,42,61.9
1974,Botswana,121,0.01,121,184,0.02,124,305,0.02,125,63,81,-22.22
1974,Mauritania,180,0.02,114,120,0.01,137,300,0.02,126,-60,-27,122.22
1974,Barbados,86,0.01,126,204,0.02,119,290,0.02,127,118,114,3.51
1974,Guadeloupe,58,0.01,133,230,0.03,115,288,0.02,128,172,137,25.55
1974,Guinea,112,0.01,123,160,0.02,128,272,0.02,129,48,125,-61.6
1974,Mali,64,0.01,132,180,0.02,125,244,0.01,130,116,52,123.08
1974,"Macao, China",110,0.01,124,134,0.02,132,244,0.01,130,24,58,-58.62
1974,Yemen,13,0.0,156,190,0.02,121,203,0.01,132,177,115,53.91
1974,Nepal,66,0.01,131,134,0.02,132,200,0.01,133,68,41,65.85
1974,Cambodia,19,0.0,152,180,0.02,125,199,0.01,134,161,135,19.26
1974,Greenland,92,0.01,125,106,0.01,140,198,0.01,135,14,64,-78.13
1974,Haiti,72,0.01,128,125,0.01,135,197,0.01,136,53,30,76.67
1974,Benin,34,0.0,141,147,0.02,129,181,0.01,137,113,69,63.77
1974,Burkina Faso,36,0.0,139,144,0.02,130,180,0.01,138,108,73,47.95
1974,Niger,53,0.01,134,97,0.01,141,150,0.01,139,44,24,83.33
1974,Djibouti,21,0.0,150,122,0.01,136,143,0.01,140,101,51,98.04
1974,Lesotho,14,0.0,155,120,0.01,137,134,0.01,141,106,75,41.33
1974,American Samoa,83,0.01,127,47,0.01,149,130,0.01,142,-36,-31,16.13
1974,Chad,37,0.0,138,87,0.01,142,124,0.01,143,50,44,13.64
1974,Belize,45,0.01,136,64,0.01,145,109,0.01,144,19,12,58.33
1974,Antigua and Barbuda,29,0.0,147,70,0.01,143,99,0.01,145,41,22,86.36
1974,Central African Republic,48,0.01,135,46,0.01,151,94,0.01,146,-2,15,-113.33
1974,Rwanda,36,0.0,139,58,0.01,146,94,0.01,146,22,1,2100.0
1974,The Gambia,43,0.01,137,47,0.01,149,90,0.01,148,4,6,-33.33
1974,Vanuatu,31,0.0,145,50,0.01,148,81,0.0,149,19,15,26.67
1974,Lao People's Democratic Republic,10,0.0,159,65,0.01,144,75,0.0,150,55,52,5.77
1974,Burundi,31,0.0,145,43,0.0,153,74,0.0,151,12,1,1100.0
1974,Saint Lucia,16,0.0,154,44,0.01,152,60,0.0,152,28,28,0.0
1974,French Guiana,1,0.0,172,56,0.01,147,57,0.0,153,55,52,5.77
1974,Solomon Islands,26,0.0,148,27,0.0,158,53,0.0,154,1,4,-75.0
1974,Equatorial Guinea,34,0.0,141,15,0.0,167,49,0.0,155,-19,8,-337.5
1974,Guinea-Bissau,4,0.0,167,43,0.0,153,47,0.0,156,39,40,-2.5
1974,Kiribati,34,0.0,141,11,0.0,168,45,0.0,157,-23,-7,228.57
1974,Samoa,13,0.0,156,26,0.0,159,39,0.0,158,13,17,-23.53
1974,Cabo Verde,2,0.0,170,34,0.0,155,36,0.0,159,32,32,0.0
1974,Comoros,9,0.0,162,26,0.0,159,35,0.0,160,17,10,70.0
1974,Seychelles,7,0.0,163,28,0.0,157,35,0.0,160,21,21,0.0
1974,Montserrat,2,0.0,170,33,0.0,156,35,0.0,160,31,23,34.78
1974,Saint Vincent and the Grenadines,7,0.0,163,25,0.0,162,32,0.0,163,18,14,28.57
1974,Saint Pierre and Miquelon,5,0.0,166,26,0.0,159,31,0.0,164,21,12,75.0
1974,Saint Kitts and Nevis,11,0.0,158,19,0.0,163,30,0.0,165,8,11,-27.27
1974,Dominica,10,0.0,159,19,0.0,163,29,0.0,166,9,7,28.57
1974,Grenada,10,0.0,159,18,0.0,165,28,0.0,167,8,15,-46.67
1974,Sao Tomé and Principe,17,0.0,153,10,0.0,169,27,0.0,168,-7,-3,133.33
1974,Tonga,7,0.0,163,17,0.0,166,24,0.0,169,10,6,66.67
1974,Guam,20,0.0,151,0,0.0,172,20,0.0,170,-20,-20,0.0
1974,Cook Islands,4,0.0,167,9,0.0,170,13,0.0,171,5,4,25.0
1974,Maldives,4,0.0,167,7,0.0,171,11,0.0,172,3,3,0.0
1973,United States of America,70823,12.19,1,73572,12.37,1,144395,12.28,1,2749,9663,-71.55
1973,Germany,67563,11.63,2,54891,9.23,2,122454,10.41,2,-12672,-6359,99.28
1973,Japan,37017,6.37,3,38389,6.45,4,75406,6.41,3,1372,-5225,-126.26
1973,France,36669,6.31,4,37738,6.34,5,74407,6.33,4,1069,550,94.36
1973,United Kingdom,29637,5.1,5,38528,6.48,3,68165,5.8,5,8891,3676,141.87
1973,Netherlands,27352,4.71,6,28744,4.83,6,56096,4.77,6,1392,1513,-8.0
1973,Canada,26437,4.55,7,24713,4.15,8,51150,4.35,7,-1724,-1147,50.31
1973,Italy,22226,3.83,9,27798,4.67,7,50024,4.25,8,5572,710,684.79
1973,Belgium-Luxembourg,22455,3.86,8,22075,3.71,9,44530,3.79,9,-380,-662,-42.6
1973,U.S.S.R.,21463,3.69,10,21112,3.55,10,42575,3.62,10,-351,694,-150.58
1973,Sweden,12201,2.1,11,10907,1.83,12,23108,1.97,11,-1294,-659,96.36
1973,Switzerland,9528,1.64,13,11626,1.95,11,21154,1.8,12,2098,1626,29.03
1973,Australia,9559,1.65,12,7393,1.24,17,16952,1.44,13,-2166,-1433,51.15
1973,German Democratic Republic,7521,1.29,15,7854,1.32,14,15375,1.31,14,333,-279,-219.35
1973,Spain,5198,0.89,23,9667,1.62,13,14865,1.26,15,4469,3012,48.37
1973,Poland,6432,1.11,16,7814,1.31,15,14246,1.21,16,1382,408,238.73
1973,Denmark,6248,1.08,17,7802,1.31,16,14050,1.19,17,1554,655,137.25
1973,Brazil,6199,1.07,18,6999,1.18,19,13198,1.12,18,800,792,1.01
1973,Austria,5283,0.91,22,7119,1.2,18,12402,1.05,19,1836,1333,37.73
1973,Czech and Slovak Federal Republic,6035,1.04,20,6137,1.03,21,12172,1.04,20,102,-253,-140.32
1973,South Africa,6064,1.04,19,5163,0.87,24,11227,0.95,21,-901,-160,463.12
1973,China,5876,1.01,21,5208,0.88,23,11084,0.94,22,-668,-842,-20.67
1973,Norway,4725,0.81,26,6289,1.06,20,11014,0.94,23,1564,1090,43.49
1973,"Saudi Arabia, Kingdom of",8988,1.55,14,1972,0.33,48,10960,0.93,24,-7016,-4355,61.1
1973,"Hong Kong, China",5071,0.87,24,5655,0.95,22,10726,0.91,25,584,420,39.05
1973,Singapore,3653,0.63,33,5127,0.86,25,8780,0.75,26,1474,1206,22.22
1973,Hungary,4433,0.76,27,3919,0.66,30,8352,0.71,27,-514,-138,272.46
1973,Chinese Taipei,4383,0.75,28,3801,0.64,32,8184,0.7,28,-582,-396,46.97
1973,Finland,3837,0.66,30,4341,0.73,27,8178,0.7,29,504,252,100.0
1973,"Venezuela, Bolivarian Republic of",4891,0.84,25,2812,0.47,39,7703,0.66,30,-2079,-703,195.73
1973,"Korea, Republic of",3221,0.55,37,4240,0.71,28,7461,0.63,31,1019,897,13.6
1973,Romania,3691,0.64,32,3738,0.63,33,7429,0.63,32,47,226,-79.2
1973,"Yugoslavia, Socialist Federal Republic of",2853,0.49,41,4511,0.76,26,7364,0.63,33,1658,996,66.47
1973,Bulgaria,3301,0.57,35,3239,0.54,36,6540,0.56,34,-62,-60,3.33
1973,India,2917,0.5,40,3211,0.54,37,6128,0.52,35,294,-225,-230.67
1973,Mexico,2250,0.39,44,3814,0.64,31,6064,0.52,36,1564,1024,52.73
1973,Iran,2669,0.46,42,3393,0.57,35,6062,0.52,37,724,610,18.69
1973,Indonesia,3211,0.55,38,2729,0.46,41,5940,0.51,38,-482,-215,124.19
1973,Libya,4003,0.69,29,1806,0.3,50,5809,0.49,39,-2197,-1895,15.94
1973,Israel,1449,0.25,53,4240,0.71,28,5689,0.48,40,2791,1326,110.48
1973,Malaysia,3049,0.52,39,2450,0.41,42,5499,0.47,41,-599,-111,439.64
1973,Argentina,3266,0.56,36,2230,0.37,44,5496,0.47,42,-1036,-36,2777.78
1973,Nigeria,3462,0.6,34,1862,0.31,49,5324,0.45,43,-1600,-675,137.04
1973,Greece,1456,0.25,52,3477,0.58,34,4933,0.42,44,2021,1478,36.74
1973,Ireland,2131,0.37,45,2789,0.47,40,4920,0.42,45,658,495,32.93
1973,"Kuwait, the State of",3815,0.66,31,1049,0.18,59,4864,0.41,46,-2766,-2192,26.19
1973,Portugal,1842,0.32,49,3015,0.51,38,4857,0.41,47,1173,906,29.47
1973,New Zealand,2596,0.45,43,2176,0.37,45,4772,0.41,48,-420,-269,56.13
1973,Algeria,1887,0.32,47,2236,0.38,43,4123,0.35,49,349,190,83.68
1973,Philippines,1885,0.32,48,1800,0.3,51,3685,0.31,50,-85,318,-126.73
1973,Thailand,1564,0.27,51,2049,0.34,47,3613,0.31,51,485,403,20.35
1973,Türkiye,1317,0.23,56,2086,0.35,46,3403,0.29,52,769,678,13.42
1973,Cuba,1410,0.24,54,1793,0.3,52,3203,0.27,53,383,457,-16.19
1973,Netherlands Antilles,1369,0.24,55,1593,0.27,53,2962,0.25,54,224,112,100.0
1973,Iraq,1942,0.33,46,894,0.15,63,2836,0.24,55,-1048,-381,175.07
1973,United Arab Emirates,1807,0.31,50,821,0.14,64,2628,0.22,56,-986,-675,46.07
1973,Chile,1231,0.21,57,1290,0.22,54,2521,0.21,57,59,231,-74.46
1973,Colombia,1169,0.2,58,1062,0.18,58,2231,0.19,58,-107,51,-309.8
1973,Lebanese Republic,921,0.16,64,1286,0.22,55,2207,0.19,59,365,547,-33.27
1973,Pakistan,1060,0.18,62,1127,0.19,57,2187,0.19,60,67,-11,-709.09
1973,Peru,1112,0.19,61,1019,0.17,60,2131,0.18,61,-93,-148,-37.16
1973,Morocco,910,0.16,65,1144,0.19,56,2054,0.17,62,234,136,72.06
1973,Egypt,1121,0.19,60,915,0.15,62,2036,0.17,63,-206,74,-378.38
1973,Zambia,1144,0.2,59,533,0.09,75,1677,0.14,64,-611,-193,216.58
1973,Côte d'Ivoire,857,0.15,66,710,0.12,67,1567,0.13,65,-147,-99,48.48
1973,Trinidad and Tobago,699,0.12,68,797,0.13,65,1496,0.13,66,98,208,-52.88
1973,Angola,792,0.14,67,579,0.1,74,1371,0.12,67,-213,-87,144.83
1973,Bangladesh,358,0.06,84,986,0.17,61,1344,0.11,68,628,423,48.46
1973,Bahamas,530,0.09,73,764,0.13,66,1294,0.11,69,234,142,64.79
1973,Zimbabwe,688,0.12,69,606,0.1,73,1294,0.11,69,-82,-37,121.62
1973,Democratic Republic of the Congo,1013,0.17,63,251,0.04,98,1264,0.11,71,-762,-530,43.77
1973,Ghana,657,0.11,70,452,0.08,82,1109,0.09,72,-205,-150,36.67
1973,Tunisia,422,0.07,80,682,0.11,68,1104,0.09,73,260,151,72.19
1973,Kenya,477,0.08,76,619,0.1,70,1096,0.09,74,142,176,-19.32
1973,Jamaica,390,0.07,82,677,0.11,69,1067,0.09,75,287,247,16.19
1973,"Bahrain, Kingdom of",481,0.08,75,512,0.09,76,993,0.08,76,31,29,6.9
1973,Syrian Arab Republic,351,0.06,87,613,0.1,72,964,0.08,77,262,253,3.56
1973,Dominican Republic,442,0.08,77,489,0.08,79,931,0.08,78,47,40,17.5
1973,Ecuador,532,0.09,72,397,0.07,87,929,0.08,79,-135,-7,1828.57
1973,Papua New Guinea,515,0.09,74,356,0.06,91,871,0.07,80,-159,110,-244.55
1973,Sudan,434,0.07,79,436,0.07,84,870,0.07,81,2,-37,-105.41
1973,Guatemala,436,0.08,78,431,0.07,85,867,0.07,82,-5,-3,66.67
1973,Tanzania,368,0.06,83,497,0.08,78,865,0.07,83,129,80,61.25
1973,Sri Lanka,410,0.07,81,430,0.07,86,840,0.07,84,20,30,-33.33
1973,Qatar,628,0.11,71,195,0.03,108,823,0.07,85,-433,-256,69.14
1973,Costa Rica,345,0.06,89,455,0.08,81,800,0.07,86,110,92,19.57
1973,El Salvador,352,0.06,86,377,0.06,88,729,0.06,87,25,-1,-2600.0
1973,Mozambique,226,0.04,100,466,0.08,80,692,0.06,88,240,153,56.86
1973,Cameroon,353,0.06,85,334,0.06,92,687,0.06,89,-19,82,-123.17
1973,Viet Nam,58,0.01,130,616,0.1,71,674,0.06,90,558,679,-17.82
1973,Iceland,290,0.05,94,359,0.06,90,649,0.06,91,69,42,64.29
1973,Panama,138,0.02,108,502,0.08,77,640,0.05,92,364,317,14.83
1973,Cyprus,173,0.03,105,451,0.08,83,624,0.05,93,278,183,51.91
1973,Uruguay,322,0.06,92,285,0.05,96,607,0.05,94,-37,-2,1750.0
1973,Nicaragua,278,0.05,95,327,0.05,94,605,0.05,95,49,-31,-258.06
1973,Senegal,195,0.03,102,361,0.06,89,556,0.05,96,166,64,159.38
1973,Honduras,259,0.04,97,262,0.04,97,521,0.04,97,3,-12,-125.0
1973,Gabon,331,0.06,90,190,0.03,110,521,0.04,97,-141,-89,58.43
1973,Liberia,324,0.06,91,193,0.03,109,517,0.04,99,-131,-65,101.54
1973,"Bolivia, Plurinational State of",261,0.04,96,230,0.04,101,491,0.04,100,-31,-16,93.75
1973,Brunei Darussalam,347,0.06,88,132,0.02,124,479,0.04,101,-215,-70,207.14
1973,Uganda,291,0.05,93,163,0.03,118,454,0.04,102,-128,-121,5.79
1973,Ethiopia,239,0.04,98,214,0.04,104,453,0.04,103,-25,22,-213.64
1973,New Caledonia,195,0.03,102,219,0.04,103,414,0.04,104,24,19,26.32
1973,Madagascar,203,0.03,101,203,0.03,106,406,0.03,105,0,39,-100.0
1973,Jordan,73,0.01,123,330,0.06,93,403,0.03,106,257,226,13.72
1973,Reunion,82,0.01,122,306,0.05,95,388,0.03,107,224,148,51.35
1973,Oman,239,0.04,98,116,0.02,129,355,0.03,108,-123,-118,4.24
1973,Fiji,122,0.02,114,222,0.04,102,344,0.03,109,100,64,56.25
1973,Suriname,179,0.03,104,158,0.03,119,337,0.03,110,-21,-26,-19.23
1973,Malta,98,0.02,118,239,0.04,100,337,0.03,110,141,108,30.56
1973,Afghanistan,143,0.02,107,172,0.03,113,315,0.03,112,29,42,-30.95
1973,Guyana,136,0.02,110,177,0.03,112,313,0.03,113,41,-4,-1125.0
1973,Mauritius,137,0.02,109,168,0.03,115,305,0.03,114,31,13,138.46
1973,Martinique,55,0.01,132,244,0.04,99,299,0.03,115,189,128,47.66
1973,"Yemen, People's Democratic Republic",118,0.02,115,171,0.03,114,289,0.02,116,53,41,29.27
1973,Sierra Leone,131,0.02,111,155,0.03,121,286,0.02,117,24,4,500.0
1973,Mauritania,155,0.03,106,128,0.02,125,283,0.02,118,-27,-31,-12.9
1973,Guadeloupe,65,0.01,125,202,0.03,107,267,0.02,119,137,108,26.85
1973,"Macao, China",100,0.02,117,158,0.03,119,258,0.02,120,58,32,81.25
1973,Botswana,85,0.01,121,166,0.03,117,251,0.02,121,81,52,55.77
1973,Paraguay,124,0.02,113,122,0.02,128,246,0.02,122,-2,-2,0.0
1973,Guinea,60,0.01,129,185,0.03,111,245,0.02,123,125,47,165.96
1973,Malawi,98,0.02,118,140,0.02,123,238,0.02,124,42,49,-14.29
1973,Myanmar,131,0.02,111,106,0.02,132,237,0.02,125,-25,13,-292.31
1973,French Polynesia,19,0.0,147,211,0.04,105,230,0.02,126,192,141,36.17
1973,Barbados,54,0.01,133,168,0.03,115,222,0.02,127,114,97,17.53
1973,Congo,89,0.02,120,128,0.02,125,217,0.02,128,39,44,-11.36
1973,Eswatini,108,0.02,116,96,0.02,136,204,0.02,129,-12,-13,-7.69
1973,Mali,58,0.01,130,110,0.02,131,168,0.01,130,52,36,44.44
1973,Nepal,63,0.01,126,104,0.02,133,167,0.01,131,41,27,51.85
1973,Cambodia,15,0.0,151,150,0.03,122,165,0.01,132,135,73,84.93
1973,Togo,61,0.01,128,101,0.02,134,162,0.01,133,40,35,14.29
1973,Benin,43,0.01,135,112,0.02,130,155,0.01,134,69,56,23.21
1973,Niger,62,0.01,127,86,0.01,139,148,0.01,135,24,12,100.0
1973,Haiti,53,0.01,134,83,0.01,140,136,0.01,136,30,25,20.0
1973,Yemen,8,0.0,157,123,0.02,127,131,0.01,137,115,76,51.32
1973,Greenland,31,0.01,140,95,0.02,137,126,0.01,138,64,50,28.0
1973,Burkina Faso,25,0.0,143,98,0.02,135,123,0.01,139,73,49,48.98
1973,Chad,38,0.01,136,82,0.01,141,120,0.01,140,44,26,69.23
1973,American Samoa,67,0.01,124,36,0.01,150,103,0.01,141,-31,-175,-82.29
1973,Lesotho,13,0.0,153,88,0.01,138,101,0.01,142,75,48,56.25
1973,Central African Republic,37,0.01,137,52,0.01,145,89,0.01,143,15,-5,-400.0
1973,Djibouti,19,0.0,147,70,0.01,142,89,0.01,143,51,46,10.87
1973,Belize,32,0.01,139,44,0.01,147,76,0.01,145,12,17,-29.41
1973,Antigua and Barbuda,26,0.0,142,48,0.01,146,74,0.01,146,22,29,-24.14
1973,Rwanda,33,0.01,138,34,0.01,152,67,0.01,147,1,16,-93.75
1973,French Guiana,5,0.0,161,57,0.01,143,62,0.01,148,52,40,30.0
1973,Lao People's Democratic Republic,5,0.0,161,57,0.01,143,62,0.01,148,52,59,-11.86
1973,Burundi,30,0.01,141,31,0.01,154,61,0.01,150,1,6,-83.33
1973,Vanuatu,21,0.0,145,36,0.01,150,57,0.0,151,15,14,7.14
1973,The Gambia,25,0.0,143,31,0.01,154,56,0.0,152,6,6,0.0
1973,Guinea-Bissau,4,0.0,167,44,0.01,147,48,0.0,153,40,29,37.93
1973,Saint Lucia,10,0.0,155,38,0.01,149,48,0.0,153,28,28,0.0
1973,Equatorial Guinea,19,0.0,147,27,0.0,156,46,0.0,155,8,8,0.0
1973,Cabo Verde,2,0.0,171,34,0.01,152,36,0.0,156,32,22,45.45
1973,Solomon Islands,14,0.0,152,18,0.0,162,32,0.0,157,4,6,-33.33
1973,Samoa,7,0.0,158,24,0.0,158,31,0.0,158,17,14,21.43
1973,Seychelles,4,0.0,167,25,0.0,157,29,0.0,159,21,18,16.67
1973,Grenada,7,0.0,158,22,0.0,160,29,0.0,159,15,17,-11.76
1973,Kiribati,17,0.0,150,10,0.0,168,27,0.0,161,-7,-2,250.0
1973,Saint Kitts and Nevis,7,0.0,158,18,0.0,162,25,0.0,162,11,10,10.0
1973,Dominica,9,0.0,156,16,0.0,165,25,0.0,162,7,10,-30.0
1973,Montserrat,1,0.0,172,24,0.0,158,25,0.0,162,23,22,4.55
1973,Saint Vincent and the Grenadines,5,0.0,161,19,0.0,161,24,0.0,165,14,15,-6.67
1973,Sao Tomé and Principe,13,0.0,153,10,0.0,168,23,0.0,166,-3,1,-400.0
1973,Saint Pierre and Miquelon,5,0.0,161,17,0.0,164,22,0.0,167,12,11,9.09
1973,Comoros,5,0.0,161,15,0.0,166,20,0.0,168,10,6,66.67
1973,Guam,20,0.0,146,0,0.0,172,20,0.0,168,-20,-16,25.0
1973,Tonga,5,0.0,161,11,0.0,167,16,0.0,170,6,6,0.0
1973,Maldives,4,0.0,167,7,0.0,170,11,0.0,171,3,2,50.0
1973,Cook Islands,3,0.0,170,7,0.0,170,10,0.0,172,4,5,-20.0
1972,United States of America,49199,11.72,1,58862,13.61,1,108061,12.68,1,9663,4793,101.61
1972,Germany,46737,11.14,2,40378,9.33,2,87115,10.22,2,-6359,-4552,39.7
1972,France,26449,6.3,4,26999,6.24,4,53448,6.27,3,550,525,4.76
1972,Japan,29088,6.93,3,23863,5.52,5,52951,6.21,4,-5225,-4283,21.99
1972,United Kingdom,23985,5.72,5,27661,6.39,3,51646,6.06,5,3676,1760,108.86
1972,Canada,21185,5.05,6,20038,4.63,7,41223,4.84,6,-1147,-1902,-39.7
1972,Netherlands,19154,4.56,7,20667,4.78,6,39821,4.67,7,1513,2094,-27.75
1972,Italy,18609,4.43,8,19319,4.47,8,37928,4.45,8,710,864,-17.82
1972,Belgium-Luxembourg,16152,3.85,9,15490,3.58,10,31642,3.71,9,-662,174,-480.46
1972,U.S.S.R.,15361,3.66,10,16055,3.71,9,31416,3.69,10,694,-1326,-152.34
1972,Sweden,8769,2.09,11,8110,1.87,12,16879,1.98,11,-659,-396,66.41
1972,Switzerland,6842,1.63,12,8468,1.96,11,15310,1.8,12,1626,1453,11.91
1972,German Democratic Republic,6184,1.47,14,5905,1.37,14,12089,1.42,13,-279,-95,193.68
1972,Australia,6461,1.54,13,5028,1.16,18,11489,1.35,14,-1433,15,-9653.33
1972,Spain,3817,0.91,22,6829,1.58,13,10646,1.25,15,3012,2045,47.29
1972,Poland,4927,1.17,16,5335,1.23,15,10262,1.2,16,408,166,145.78
1972,Czech and Slovak Federal Republic,4915,1.17,17,4662,1.08,20,9577,1.12,17,-253,-170,48.82
1972,Denmark,4432,1.06,18,5087,1.18,17,9519,1.12,18,655,928,-29.42
1972,Austria,3883,0.93,21,5216,1.21,16,9099,1.07,19,1333,1022,30.43
1972,Brazil,3991,0.95,20,4783,1.11,19,8774,1.03,20,792,797,-0.63
1972,South Africa,4108,0.98,19,3948,0.91,22,8056,0.95,21,-160,881,-118.16
1972,Norway,3283,0.78,26,4373,1.01,21,7656,0.9,22,1090,1520,-28.29
1972,"Hong Kong, China",3436,0.82,24,3856,0.89,23,7292,0.86,23,420,516,-18.6
1972,"Saudi Arabia, Kingdom of",5491,1.31,15,1136,0.26,52,6627,0.78,24,-4355,-3042,43.16
1972,China,3693,0.88,23,2851,0.66,28,6544,0.77,25,-842,-654,28.75
1972,Hungary,3292,0.78,25,3154,0.73,27,6446,0.76,26,-138,490,-128.16
1972,Finland,2913,0.69,31,3165,0.73,26,6078,0.71,27,252,440,-42.73
1972,"Venezuela, Bolivarian Republic of",3166,0.75,27,2463,0.57,35,5629,0.66,28,-703,-1021,-31.15
1972,Singapore,2189,0.52,36,3395,0.78,24,5584,0.66,29,1206,1077,11.98
1972,"Yugoslavia, Socialist Federal Republic of",2237,0.53,35,3233,0.75,25,5470,0.64,30,996,1438,-30.74
1972,Chinese Taipei,2914,0.69,30,2518,0.58,33,5432,0.64,31,-396,-149,165.77
1972,Romania,2601,0.62,33,2827,0.65,29,5428,0.64,32,226,171,32.16
1972,Bulgaria,2627,0.63,32,2567,0.59,31,5194,0.61,33,-60,-62,-3.23
1972,India,2448,0.58,34,2223,0.51,38,4671,0.55,34,-225,388,-157.99
1972,Mexico,1694,0.4,43,2718,0.63,30,4412,0.52,35,1024,903,13.4
1972,Iran,1799,0.43,39,2409,0.56,36,4208,0.49,36,610,-1951,-131.27
1972,"Korea, Republic of",1625,0.39,44,2522,0.58,32,4147,0.49,37,897,1327,-32.4
1972,Libya,2938,0.7,29,1043,0.24,54,3981,0.47,38,-1895,-1991,-4.82
1972,Argentina,1941,0.46,38,1905,0.44,41,3846,0.45,39,-36,128,-128.13
1972,"Kuwait, the State of",2989,0.71,28,797,0.18,59,3786,0.44,40,-2192,-1855,18.17
1972,Ireland,1607,0.38,45,2102,0.49,40,3709,0.44,41,495,525,-5.71
1972,Nigeria,2180,0.52,37,1505,0.35,46,3685,0.43,42,-675,-301,124.25
1972,Israel,1147,0.27,50,2473,0.57,34,3620,0.42,43,1326,1405,-5.62
1972,Portugal,1298,0.31,47,2204,0.51,39,3502,0.41,44,906,754,20.16
1972,Indonesia,1777,0.42,41,1562,0.36,44,3339,0.39,45,-215,-131,64.12
1972,Malaysia,1722,0.41,42,1611,0.37,42,3333,0.39,46,-111,-197,-43.65
1972,New Zealand,1792,0.43,40,1523,0.35,45,3315,0.39,47,-269,-13,1969.23
1972,Greece,870,0.21,56,2348,0.54,37,3218,0.38,48,1478,1436,2.92
1972,Algeria,1304,0.31,46,1494,0.35,47,2798,0.33,49,190,370,-48.65
1972,Thailand,1081,0.26,53,1484,0.34,48,2565,0.3,50,403,457,-11.82
1972,Philippines,1100,0.26,51,1418,0.33,49,2518,0.3,51,318,227,40.09
1972,Türkiye,885,0.21,55,1563,0.36,43,2448,0.29,52,678,494,37.25
1972,Pakistan,1169,0.28,48,1158,0.27,51,2327,0.27,53,-11,116,-109.48
1972,Cuba,835,0.2,58,1292,0.3,50,2127,0.25,54,457,527,-13.28
1972,Chile,855,0.2,57,1086,0.25,53,1941,0.23,55,231,112,106.25
1972,Iraq,1086,0.26,52,705,0.16,63,1791,0.21,56,-381,-855,-55.44
1972,Peru,944,0.22,54,796,0.18,60,1740,0.2,57,-148,-130,13.85
1972,Egypt,825,0.2,59,899,0.21,56,1724,0.2,58,74,131,-43.51
1972,Colombia,808,0.19,60,859,0.2,58,1667,0.2,59,51,243,-79.01
1972,United Arab Emirates,1157,0.28,49,482,0.11,71,1639,0.19,60,-675,-562,20.11
1972,Netherlands Antilles,758,0.18,61,870,0.2,57,1628,0.19,61,112,157,-28.66
1972,Morocco,643,0.15,64,779,0.18,61,1422,0.17,62,136,199,-31.66
1972,Trinidad and Tobago,558,0.13,65,766,0.18,62,1324,0.16,63,208,139,49.64
1972,Zambia,758,0.18,61,565,0.13,67,1323,0.16,64,-193,-670,-71.19
1972,Lebanese Republic,377,0.09,72,924,0.21,55,1301,0.15,65,547,486,12.55
1972,Jamaica,391,0.09,71,638,0.15,66,1029,0.12,66,247,213,15.96
1972,Côte d'Ivoire,553,0.13,66,454,0.1,74,1007,0.12,67,-99,-57,73.68
1972,Zimbabwe,515,0.12,67,478,0.11,72,993,0.12,68,-37,52,-171.15
1972,Democratic Republic of the Congo,738,0.18,63,208,0.05,97,946,0.11,69,-530,-484,9.5
1972,Bangladesh,260,0.06,87,683,0.16,65,943,0.11,70,423,,
1972,Kenya,359,0.09,73,535,0.12,69,894,0.1,71,176,246,-28.46
1972,Angola,479,0.11,68,392,0.09,77,871,0.1,72,-87,-10,770.0
1972,Bahamas,343,0.08,77,485,0.11,70,828,0.1,73,142,244,-41.8
1972,Syrian Arab Republic,287,0.07,83,540,0.12,68,827,0.1,74,253,244,3.69
1972,Tunisia,315,0.08,82,466,0.11,73,781,0.09,75,151,128,17.97
1972,Dominican Republic,348,0.08,75,388,0.09,78,736,0.09,76,40,115,-65.22
1972,Ghana,441,0.11,69,291,0.07,89,732,0.09,77,-150,-62,141.94
1972,Tanzania,324,0.08,81,404,0.09,76,728,0.09,78,80,114,-29.82
1972,"Bahrain, Kingdom of",347,0.08,76,376,0.09,79,723,0.08,79,29,43,-32.56
1972,Sri Lanka,338,0.08,78,368,0.09,81,706,0.08,80,30,10,200.0
1972,Viet Nam,13,0.0,148,692,0.16,64,705,0.08,81,679,586,15.87
1972,Sudan,357,0.09,74,320,0.07,85,677,0.08,82,-37,3,-1333.33
1972,Costa Rica,281,0.07,85,373,0.09,80,654,0.08,83,92,125,-26.4
1972,Guatemala,327,0.08,79,324,0.07,84,651,0.08,84,-3,14,-121.43
1972,Ecuador,326,0.08,80,319,0.07,86,645,0.08,85,-7,141,-104.96
1972,Panama,123,0.03,108,440,0.1,75,563,0.07,86,317,279,13.62
1972,Papua New Guinea,222,0.05,91,332,0.08,82,554,0.07,87,110,236,-53.39
1972,El Salvador,273,0.07,86,272,0.06,92,545,0.06,88,-1,21,-104.76
1972,Qatar,397,0.09,70,141,0.03,114,538,0.06,89,-256,-206,24.27
1972,Cameroon,221,0.05,92,303,0.07,88,524,0.06,90,82,44,86.36
1972,Mozambique,177,0.04,100,330,0.08,83,507,0.06,91,153,178,-14.04
1972,Senegal,216,0.05,93,280,0.06,90,496,0.06,92,64,94,-31.91
1972,Nicaragua,249,0.06,88,218,0.05,94,467,0.05,93,-31,23,-234.78
1972,Cyprus,134,0.03,107,317,0.07,87,451,0.05,94,183,145,26.21
1972,Uganda,283,0.07,84,162,0.04,107,445,0.05,95,-121,-10,1110.0
1972,Uruguay,214,0.05,94,212,0.05,95,426,0.05,96,-2,23,-108.7
1972,Liberia,244,0.06,89,179,0.04,103,423,0.05,97,-65,-65,0.0
1972,Iceland,189,0.05,99,231,0.05,93,420,0.05,98,42,60,-30.0
1972,New Caledonia,190,0.05,98,209,0.05,96,399,0.05,99,19,34,-44.12
1972,Honduras,205,0.05,95,193,0.04,100,398,0.05,100,-12,5,-340.0
1972,"Bolivia, Plurinational State of",201,0.05,96,185,0.04,102,386,0.05,101,-16,-11,45.45
1972,Madagascar,166,0.04,105,205,0.05,98,371,0.04,102,39,67,-41.79
1972,Gabon,228,0.05,90,139,0.03,116,367,0.04,103,-89,-87,2.3
1972,Ethiopia,167,0.04,103,189,0.04,101,356,0.04,104,22,62,-64.52
1972,Jordan,48,0.01,128,274,0.06,91,322,0.04,105,226,183,23.5
1972,Suriname,171,0.04,102,145,0.03,112,316,0.04,106,-26,-31,-16.13
1972,Guyana,147,0.04,106,143,0.03,113,290,0.03,107,-4,-16,-75.0
1972,Afghanistan,122,0.03,109,164,0.04,106,286,0.03,108,42,41,2.44
1972,Brunei Darussalam,176,0.04,101,106,0.02,123,282,0.03,109,-70,87,-180.46
1972,"Yemen, People's Democratic Republic",108,0.03,112,149,0.03,110,257,0.03,110,41,51,-19.61
1972,Fiji,95,0.02,115,159,0.04,108,254,0.03,111,64,42,52.38
1972,Myanmar,120,0.03,110,133,0.03,117,253,0.03,112,13,44,-70.45
1972,Reunion,50,0.01,126,198,0.05,99,248,0.03,113,148,146,1.37
1972,Malta,68,0.02,120,176,0.04,104,244,0.03,114,108,115,-6.09
1972,Sierra Leone,115,0.03,111,119,0.03,119,234,0.03,115,4,15,-73.33
1972,Mauritius,106,0.03,113,119,0.03,119,225,0.03,116,13,18,-27.78
1972,American Samoa,199,0.05,97,24,0.01,155,223,0.03,117,-175,-107,63.55
1972,Martinique,45,0.01,129,173,0.04,105,218,0.03,118,128,121,5.79
1972,Oman,167,0.04,103,49,0.01,143,216,0.03,119,-118,-121,-2.48
1972,Malawi,80,0.02,118,129,0.03,118,209,0.02,120,49,37,32.43
1972,Guadeloupe,40,0.01,132,148,0.03,111,188,0.02,121,108,83,30.12
1972,Barbados,44,0.01,130,141,0.03,114,185,0.02,122,97,83,16.87
1972,"Macao, China",72,0.02,119,104,0.02,124,176,0.02,123,32,26,23.08
1972,French Polynesia,15,0.0,146,156,0.04,109,171,0.02,124,141,123,14.63
1972,Mauritania,100,0.02,114,69,0.02,134,169,0.02,125,-31,-37,-16.22
1972,Botswana,58,0.01,123,110,0.03,121,168,0.02,126,52,41,26.83
1972,Paraguay,85,0.02,116,83,0.02,129,168,0.02,126,-2,19,-110.53
1972,Guinea,60,0.01,121,107,0.02,122,167,0.02,128,47,30,56.67
1972,Congo,60,0.01,121,104,0.02,124,164,0.02,129,44,42,4.76
1972,Eswatini,82,0.02,117,69,0.02,134,151,0.02,130,-13,-11,18.18
1972,Nepal,58,0.01,123,85,0.02,127,143,0.02,131,27,37,-27.03
1972,Togo,50,0.01,126,85,0.02,127,135,0.02,132,35,20,75.0
1972,Benin,36,0.01,134,92,0.02,126,128,0.02,133,56,35,60.0
1972,Niger,54,0.01,125,66,0.02,138,120,0.01,134,12,15,-20.0
1972,Haiti,44,0.01,130,69,0.02,134,113,0.01,135,25,13,92.31
1972,Mali,34,0.01,136,70,0.02,133,104,0.01,136,36,34,5.88
1972,Chad,36,0.01,134,62,0.01,140,98,0.01,137,26,34,-23.53
1972,Greenland,22,0.01,139,72,0.02,132,94,0.01,138,50,42,19.05
1972,Burkina Faso,20,0.0,140,69,0.02,134,89,0.01,139,49,40,22.5
1972,Cambodia,7,0.0,154,80,0.02,130,87,0.01,140,73,46,58.7
1972,Yemen,4,0.0,162,80,0.02,130,84,0.01,141,76,30,153.33
1972,Central African Republic,39,0.01,133,34,0.01,149,73,0.01,142,-5,1,-600.0
1972,Belize,26,0.01,137,43,0.01,146,69,0.01,143,17,17,0.0
1972,Lao People's Democratic Republic,4,0.0,162,63,0.01,139,67,0.01,144,59,76,-22.37
1972,Antigua and Barbuda,18,0.0,144,47,0.01,144,65,0.01,145,29,28,3.57
1972,Lesotho,8,0.0,150,56,0.01,141,64,0.01,146,48,35,37.14
1972,Djibouti,8,0.0,150,54,0.01,142,62,0.01,147,46,38,21.05
1972,Burundi,26,0.01,137,32,0.01,150,58,0.01,148,6,11,-45.45
1972,Rwanda,19,0.0,141,35,0.01,148,54,0.01,149,16,11,45.45
1972,French Guiana,5,0.0,159,45,0.01,145,50,0.01,150,40,37,8.11
1972,Equatorial Guinea,19,0.0,141,27,0.01,153,46,0.01,151,8,0,
1972,Vanuatu,15,0.0,146,29,0.01,152,44,0.01,152,14,5,180.0
1972,The Gambia,19,0.0,141,25,0.01,154,44,0.01,152,6,8,-25.0
1972,Saint Lucia,8,0.0,150,36,0.01,147,44,0.01,152,28,29,-3.45
1972,Guinea-Bissau,3,0.0,165,32,0.01,150,35,0.0,155,29,29,0.0
1972,Solomon Islands,11,0.0,149,17,0.0,162,28,0.0,156,6,5,20.0
1972,Grenada,5,0.0,159,22,0.01,158,27,0.0,157,17,18,-5.56
1972,Cabo Verde,2,0.0,170,24,0.01,155,26,0.0,158,22,18,22.22
1972,Samoa,5,0.0,159,19,0.0,160,24,0.0,159,14,7,100.0
1972,Seychelles,3,0.0,165,21,0.0,159,24,0.0,159,18,13,38.46
1972,Dominica,7,0.0,154,17,0.0,162,24,0.0,159,10,11,-9.09
1972,Montserrat,1,0.0,172,23,0.01,157,24,0.0,159,22,16,37.5
1972,Saint Kitts and Nevis,6,0.0,157,16,0.0,164,22,0.0,163,10,11,-9.09
1972,Saint Vincent and the Grenadines,3,0.0,165,18,0.0,161,21,0.0,164,15,15,0.0
1972,Saint Pierre and Miquelon,4,0.0,162,15,0.0,165,19,0.0,165,11,8,37.5
1972,Comoros,6,0.0,157,12,0.0,166,18,0.0,166,6,4,50.0
1972,Guam,16,0.0,145,0,0.0,172,16,0.0,167,-16,-10,60.0
1972,Sao Tomé and Principe,7,0.0,154,8,0.0,168,15,0.0,168,1,1,0.0
1972,Kiribati,8,0.0,150,6,0.0,170,14,0.0,169,-2,-5,-60.0
1972,Tonga,3,0.0,165,9,0.0,167,12,0.0,170,6,5,20.0
1972,Cook Islands,2,0.0,170,7,0.0,169,9,0.0,171,5,5,0.0
1972,Maldives,3,0.0,165,5,0.0,171,8,0.0,172,2,0,
1971,United States of America,43549,12.3,1,48342,13.21,1,91891,12.76,1,4793,-797,-701.38
1971,Germany,38845,10.97,2,34293,9.37,2,73138,10.16,2,-4552,-4281,6.33
1971,United Kingdom,22098,6.24,4,23858,6.52,3,45956,6.38,3,1760,2441,-27.9
1971,Japan,23995,6.78,3,19712,5.39,5,43707,6.07,4,-4283,-437,880.09
1971,France,20811,5.88,5,21336,5.83,4,42147,5.85,5,525,1032,-49.13
1971,Canada,18374,5.19,6,16472,4.5,7,34846,4.84,6,-1902,-2501,-23.95
1971,Netherlands,15773,4.45,7,17867,4.88,6,33640,4.67,7,2094,2333,-10.24
1971,Italy,15105,4.27,8,15969,4.36,8,31074,4.32,8,864,1769,-51.16
1971,U.S.S.R.,13806,3.9,9,12480,3.41,10,26286,3.65,9,-1326,-1068,24.16
1971,Belgium-Luxembourg,12726,3.59,10,12900,3.53,9,25626,3.56,10,174,-188,-192.55
1971,Sweden,7463,2.11,11,7067,1.93,12,14530,2.02,11,-396,212,-286.79
1971,Switzerland,5738,1.62,12,7191,1.97,11,12929,1.8,12,1453,1311,10.83
1971,Australia,5213,1.47,13,5228,1.43,13,10441,1.45,13,15,286,-94.76
1971,German Democratic Republic,5076,1.43,14,4981,1.36,15,10057,1.4,14,-95,266,-135.71
1971,Denmark,3680,1.04,19,4608,1.26,16,8288,1.15,15,928,1051,-11.7
1971,Czech and Slovak Federal Republic,4180,1.18,15,4010,1.1,21,8190,1.14,16,-170,-97,75.26
1971,Spain,2964,0.84,23,5009,1.37,14,7973,1.11,17,2045,2359,-13.31
1971,Poland,3872,1.09,16,4038,1.1,20,7910,1.1,18,166,60,176.67
1971,South Africa,3483,0.98,20,4364,1.19,17,7847,1.09,19,881,499,76.55
1971,Austria,3168,0.89,21,4190,1.15,18,7358,1.02,20,1022,692,47.69
1971,Norway,2555,0.72,28,4075,1.11,19,6630,0.92,21,1520,1245,22.09
1971,Brazil,2904,0.82,24,3701,1.01,22,6605,0.92,22,797,110,624.55
1971,"Hong Kong, China",2875,0.81,25,3391,0.93,23,6266,0.87,23,516,390,32.31
1971,Iran,3824,1.08,18,1873,0.51,37,5697,0.79,24,-1951,-741,163.29
1971,Hungary,2500,0.71,30,2990,0.82,25,5490,0.76,25,490,189,159.26
1971,"Venezuela, Bolivarian Republic of",3124,0.88,22,2103,0.57,35,5227,0.73,26,-1021,-1300,-21.46
1971,Finland,2367,0.67,31,2807,0.77,27,5174,0.72,27,440,332,32.53
1971,"Yugoslavia, Socialist Federal Republic of",1814,0.51,37,3252,0.89,24,5066,0.7,28,1438,1195,20.33
1971,China,2783,0.79,26,2129,0.58,33,4912,0.68,29,-654,-28,2235.71
1971,"Saudi Arabia, Kingdom of",3850,1.09,17,808,0.22,55,4658,0.65,30,-3042,-1678,81.29
1971,Singapore,1761,0.5,38,2838,0.78,26,4599,0.64,31,1077,907,18.74
1971,India,2036,0.57,34,2424,0.66,28,4460,0.62,32,388,98,295.92
1971,Romania,2107,0.59,33,2278,0.62,32,4385,0.61,33,171,266,-35.71
1971,Bulgaria,2182,0.62,32,2120,0.58,34,4302,0.6,34,-62,-173,-64.16
1971,Mexico,1504,0.42,42,2407,0.66,29,3911,0.54,35,903,1059,-14.73
1971,Chinese Taipei,1998,0.56,35,1849,0.51,39,3847,0.53,36,-149,100,-249.0
1971,Argentina,1740,0.49,39,1868,0.51,38,3608,0.5,37,128,-79,-262.03
1971,"Korea, Republic of",1067,0.3,48,2394,0.65,30,3461,0.48,38,1327,1148,15.59
1971,Libya,2694,0.76,27,703,0.19,58,3397,0.47,39,-1991,-1803,10.43
1971,Nigeria,1815,0.51,36,1514,0.41,42,3329,0.46,40,-301,-181,66.3
1971,Israel,958,0.27,51,2363,0.65,31,3321,0.46,41,1405,1300,8.08
1971,"Kuwait, the State of",2507,0.71,29,652,0.18,62,3159,0.44,42,-1855,-1068,73.69
1971,Ireland,1312,0.37,44,1837,0.5,40,3149,0.44,43,525,501,4.79
1971,Malaysia,1644,0.46,40,1447,0.4,43,3091,0.43,44,-197,-286,-31.12
1971,Portugal,1049,0.3,49,1803,0.49,41,2852,0.4,45,754,610,23.61
1971,Greece,662,0.19,62,2098,0.57,36,2760,0.38,46,1436,1315,9.2
1971,New Zealand,1361,0.38,43,1348,0.37,45,2709,0.38,47,-13,22,-159.09
1971,Philippines,1098,0.31,47,1325,0.36,46,2423,0.34,48,227,195,16.41
1971,Indonesia,1234,0.35,45,1103,0.3,51,2337,0.32,49,-131,-106,23.58
1971,Iraq,1556,0.44,41,701,0.19,59,2257,0.31,50,-855,-589,45.16
1971,Cuba,860,0.24,54,1387,0.38,44,2247,0.31,51,527,265,98.87
1971,Thailand,831,0.23,56,1288,0.35,47,2119,0.29,52,457,589,-22.41
1971,Chile,997,0.28,50,1109,0.3,50,2106,0.29,53,112,-186,-160.22
1971,Algeria,857,0.24,55,1227,0.34,48,2084,0.29,54,370,248,49.19
1971,Türkiye,677,0.19,61,1171,0.32,49,1848,0.26,55,494,360,37.22
1971,Zambia,1226,0.35,46,556,0.15,66,1782,0.25,56,-670,-524,27.86
1971,Egypt,789,0.22,57,920,0.25,53,1709,0.24,57,131,25,424.0
1971,Peru,893,0.25,52,763,0.21,56,1656,0.23,58,-130,-425,-69.41
1971,Colombia,686,0.19,60,929,0.25,52,1615,0.22,59,243,116,109.48
1971,Netherlands Antilles,725,0.2,58,882,0.24,54,1607,0.22,60,157,122,28.69
1971,Morocco,502,0.14,64,701,0.19,59,1203,0.17,61,199,196,1.53
1971,Trinidad and Tobago,527,0.15,63,666,0.18,61,1193,0.17,62,139,62,124.19
1971,United Arab Emirates,871,0.25,53,309,0.08,85,1180,0.16,63,-562,-256,119.53
1971,Pakistan,492,0.14,65,608,0.17,63,1100,0.15,64,116,326,-64.42
1971,Lebanese Republic,245,0.07,80,731,0.2,57,976,0.14,65,486,469,3.62
1971,Ghana,492,0.14,65,430,0.12,72,922,0.13,66,-62,-47,31.91
1971,Angola,455,0.13,68,445,0.12,70,900,0.12,67,-10,-55,-81.82
1971,Jamaica,339,0.1,71,552,0.15,67,891,0.12,68,213,183,16.39
1971,Democratic Republic of the Congo,687,0.19,59,203,0.06,99,890,0.12,69,-484,-602,-19.6
1971,Kenya,314,0.09,74,560,0.15,65,874,0.12,70,246,137,79.56
1971,Zimbabwe,404,0.11,69,456,0.12,69,860,0.12,71,52,8,550.0
1971,Côte d'Ivoire,457,0.13,67,400,0.11,73,857,0.12,72,-57,-81,-29.63
1971,Bahamas,267,0.08,78,511,0.14,68,778,0.11,73,244,247,-1.21
1971,Sri Lanka,344,0.1,70,354,0.1,78,698,0.1,74,10,44,-77.27
1971,Sudan,328,0.09,72,331,0.09,83,659,0.09,75,3,-10,-130.0
1971,Tanzania,268,0.08,77,382,0.1,75,650,0.09,76,114,66,72.73
1971,Syrian Arab Republic,195,0.06,91,439,0.12,71,634,0.09,77,244,157,55.41
1971,Viet Nam,8,0.0,150,594,0.16,64,602,0.08,78,586,365,60.55
1971,Dominican Republic,243,0.07,81,358,0.1,76,601,0.08,79,115,55,109.09
1971,"Bahrain, Kingdom of",269,0.08,76,312,0.09,84,581,0.08,80,43,29,48.28
1971,Guatemala,283,0.08,75,297,0.08,87,580,0.08,81,14,-6,-333.33
1971,Costa Rica,225,0.06,83,350,0.1,79,575,0.08,82,125,86,45.35
1971,Tunisia,217,0.06,85,345,0.09,80,562,0.08,83,128,124,3.23
1971,Ecuador,199,0.06,90,340,0.09,82,539,0.07,84,141,84,67.86
1971,Panama,117,0.03,107,396,0.11,74,513,0.07,85,279,248,12.5
1971,Brunei Darussalam,212,0.06,86,299,0.08,86,511,0.07,86,87,-11,-890.91
1971,Uganda,260,0.07,79,250,0.07,90,510,0.07,87,-10,-110,-90.91
1971,Mozambique,163,0.05,96,341,0.09,81,504,0.07,88,178,168,5.95
1971,El Salvador,228,0.06,82,249,0.07,91,477,0.07,89,21,-15,-240.0
1971,Papua New Guinea,120,0.03,106,356,0.1,77,476,0.07,90,236,198,19.19
1971,Cameroon,207,0.06,87,251,0.07,89,458,0.06,91,44,16,175.0
1971,Uruguay,206,0.06,88,229,0.06,93,435,0.06,92,23,-2,-1250.0
1971,New Caledonia,200,0.06,89,234,0.06,92,434,0.06,93,34,38,-10.53
1971,Qatar,315,0.09,73,109,0.03,117,424,0.06,94,-206,-176,17.05
1971,Nicaragua,187,0.05,93,210,0.06,97,397,0.06,95,23,20,15.0
1971,Honduras,189,0.05,92,194,0.05,100,383,0.05,96,5,42,-88.1
1971,Liberia,222,0.06,84,157,0.04,106,379,0.05,97,-65,-64,1.56
1971,Cyprus,115,0.03,108,260,0.07,88,375,0.05,98,145,128,13.28
1971,Madagascar,147,0.04,101,214,0.06,96,361,0.05,99,67,25,168.0
1971,Iceland,150,0.04,100,210,0.06,97,360,0.05,100,60,10,500.0
1971,"Bolivia, Plurinational State of",181,0.05,94,170,0.05,103,351,0.05,101,-11,-31,-64.52
1971,Senegal,125,0.04,104,219,0.06,94,344,0.05,102,94,42,123.81
1971,Ethiopia,126,0.04,103,188,0.05,102,314,0.04,103,62,50,24.0
1971,Myanmar,125,0.04,104,169,0.05,104,294,0.04,104,44,47,-6.38
1971,Guyana,151,0.04,99,135,0.04,111,286,0.04,105,-16,-2,700.0
1971,Suriname,157,0.04,97,126,0.03,113,283,0.04,106,-31,-29,6.9
1971,Gabon,179,0.05,95,92,0.03,119,271,0.04,107,-87,-64,35.94
1971,"Yemen, People's Democratic Republic",105,0.03,109,156,0.04,107,261,0.04,108,51,55,-7.27
1971,Jordan,32,0.01,132,215,0.06,95,247,0.03,109,183,150,22.0
1971,Afghanistan,100,0.03,110,141,0.04,109,241,0.03,110,41,28,46.43
1971,Reunion,44,0.01,124,190,0.05,101,234,0.03,111,146,110,32.73
1971,Fiji,87,0.02,113,129,0.04,112,216,0.03,112,42,17,147.06
1971,Sierra Leone,98,0.03,111,113,0.03,116,211,0.03,113,15,15,0.0
1971,Malta,46,0.01,123,161,0.04,105,207,0.03,114,115,122,-5.74
1971,Martinique,34,0.01,131,155,0.04,108,189,0.03,115,121,116,4.31
1971,Oman,154,0.04,98,33,0.01,146,187,0.03,116,-121,-125,-3.2
1971,Malawi,71,0.02,115,108,0.03,118,179,0.02,117,37,49,-24.49
1971,Guadeloupe,42,0.01,125,125,0.03,114,167,0.02,118,83,90,-7.78
1971,Barbados,41,0.01,128,124,0.03,115,165,0.02,119,83,78,6.41
1971,French Polynesia,17,0.0,141,140,0.04,110,157,0.02,120,123,117,5.13
1971,Mauritania,94,0.03,112,57,0.02,135,151,0.02,121,-37,-33,12.12
1971,Mauritius,66,0.02,116,84,0.02,121,150,0.02,122,18,7,157.14
1971,American Samoa,127,0.04,102,20,0.01,154,147,0.02,123,-107,-107,0.0
1971,Paraguay,64,0.02,117,83,0.02,122,147,0.02,123,19,13,46.15
1971,Eswatini,78,0.02,114,67,0.02,130,145,0.02,125,-11,-11,0.0
1971,Nepal,48,0.01,121,85,0.02,120,133,0.02,126,37,33,12.12
1971,Guinea,50,0.01,118,80,0.02,126,130,0.02,127,30,22,36.36
1971,Botswana,42,0.01,125,83,0.02,122,125,0.02,128,41,31,32.26
1971,"Macao, China",49,0.01,120,75,0.02,128,124,0.02,129,26,23,13.04
1971,Congo,40,0.01,129,82,0.02,124,122,0.02,130,42,28,50.0
1971,Togo,50,0.01,118,70,0.02,129,120,0.02,131,20,10,100.0
1971,Benin,42,0.01,125,77,0.02,127,119,0.02,132,35,31,12.9
1971,Haiti,47,0.01,122,60,0.02,134,107,0.01,133,13,15,-13.33
1971,Niger,39,0.01,130,54,0.01,138,93,0.01,134,15,26,-42.31
1971,Mali,29,0.01,134,63,0.02,131,92,0.01,135,34,14,142.86
1971,Chad,28,0.01,135,62,0.02,132,90,0.01,136,34,32,6.25
1971,Lao People's Democratic Republic,6,0.0,152,82,0.02,124,88,0.01,137,76,107,-28.97
1971,Greenland,19,0.01,138,61,0.02,133,80,0.01,138,42,39,7.69
1971,Burkina Faso,16,0.0,142,56,0.02,137,72,0.01,139,40,31,29.03
1971,Cambodia,11,0.0,146,57,0.02,135,68,0.01,140,46,15,206.67
1971,Central African Republic,32,0.01,132,33,0.01,146,65,0.01,141,1,4,-75.0
1971,Antigua and Barbuda,16,0.0,142,44,0.01,139,60,0.01,142,28,25,12.0
1971,Equatorial Guinea,28,0.01,135,28,0.01,151,56,0.01,143,0,-1,-100.0
1971,Belize,19,0.01,138,36,0.01,143,55,0.01,144,17,14,21.43
1971,Rwanda,22,0.01,137,33,0.01,146,55,0.01,144,11,4,175.0
1971,Burundi,19,0.01,138,30,0.01,150,49,0.01,146,11,-2,-650.0
1971,Djibouti,5,0.0,157,43,0.01,140,48,0.01,147,38,28,35.71
1971,Lesotho,4,0.0,159,39,0.01,142,43,0.01,148,35,26,34.62
1971,French Guiana,3,0.0,163,40,0.01,141,43,0.01,148,37,41,-9.76
1971,Saint Lucia,6,0.0,152,35,0.01,144,41,0.01,150,29,18,61.11
1971,Yemen,4,0.0,159,34,0.01,145,38,0.01,151,30,30,0.0
1971,The Gambia,13,0.0,144,21,0.01,153,34,0.0,152,8,1,700.0
1971,Guinea-Bissau,2,0.0,166,31,0.01,149,33,0.0,153,29,23,26.09
1971,Vanuatu,13,0.0,144,18,0.0,156,31,0.0,154,5,1,400.0
1971,Grenada,5,0.0,157,23,0.01,152,28,0.0,155,18,16,12.5
1971,Solomon Islands,10,0.0,147,15,0.0,160,25,0.0,156,5,5,0.0
1971,Dominica,6,0.0,152,17,0.0,158,23,0.0,157,11,10,10.0
1971,Cabo Verde,2,0.0,166,20,0.01,154,22,0.0,158,18,14,28.57
1971,Saint Vincent and the Grenadines,3,0.0,163,18,0.0,156,21,0.0,159,15,11,36.36
1971,Saint Kitts and Nevis,4,0.0,159,15,0.0,160,19,0.0,160,11,8,37.5
1971,Samoa,6,0.0,152,13,0.0,163,19,0.0,160,7,9,-22.22
1971,Montserrat,1,0.0,171,17,0.0,158,18,0.0,162,16,17,-5.88
1971,Seychelles,2,0.0,166,15,0.0,160,17,0.0,163,13,8,62.5
1971,Comoros,6,0.0,152,10,0.0,165,16,0.0,164,4,4,0.0
1971,Sao Tomé and Principe,7,0.0,151,8,0.0,166,15,0.0,165,1,1,0.0
1971,Kiribati,10,0.0,147,5,0.0,169,15,0.0,165,-5,-4,25.0
1971,Saint Pierre and Miquelon,3,0.0,163,11,0.0,164,14,0.0,167,8,9,-11.11
1971,Guam,10,0.0,147,0,0.0,171,10,0.0,168,-10,-6,66.67
1971,Tonga,2,0.0,166,7,0.0,167,9,0.0,169,5,3,66.67
1971,Cook Islands,2,0.0,166,7,0.0,167,9,0.0,169,5,3,66.67
1971,Maldives,4,0.0,159,4,0.0,170,8,0.0,171,0,-2,-100.0
1970,United States of America,43225,13.63,1,42428,12.89,1,85653,13.25,1,-797,980,-181.33
1970,Germany,34228,10.79,2,29947,9.1,2,64175,9.93,2,-4281,-3976,7.67
1970,United Kingdom,19430,6.13,3,21871,6.64,3,41301,6.39,3,2441,2316,5.4
1970,Japan,19318,6.09,4,18881,5.74,5,38199,5.91,4,-437,-967,-54.81
1970,France,18099,5.71,5,19131,5.81,4,37230,5.76,5,1032,2177,-52.6
1970,Canada,16787,5.29,6,14286,4.34,8,31073,4.81,6,-2501,-331,655.59
1970,Netherlands,13355,4.21,7,15688,4.77,6,29043,4.49,7,2333,1600,45.81
1970,Italy,13205,4.16,8,14974,4.55,7,28179,4.36,8,1769,742,138.41
1970,U.S.S.R.,12800,4.04,9,11732,3.56,9,24532,3.8,9,-1068,-1328,-19.58
1970,Belgium-Luxembourg,11600,3.66,10,11412,3.47,10,23012,3.56,10,-188,-68,176.47
1970,Sweden,6795,2.14,11,7007,2.13,11,13802,2.14,11,212,214,-0.93
1970,Switzerland,5063,1.6,12,6374,1.94,12,11437,1.77,12,1311,623,110.43
1970,Australia,4770,1.5,13,5056,1.54,13,9826,1.52,13,286,318,-10.06
1970,German Democratic Republic,4581,1.44,14,4847,1.47,14,9428,1.46,14,266,-30,-986.67
1970,Denmark,3356,1.06,17,4407,1.34,16,7763,1.2,15,1051,794,32.37
1970,Czech and Slovak Federal Republic,3792,1.2,15,3695,1.12,19,7487,1.16,16,-97,-25,288.0
1970,South Africa,3344,1.05,18,3843,1.17,17,7187,1.11,17,499,-168,-397.02
1970,Poland,3548,1.12,16,3608,1.1,20,7156,1.11,18,60,68,-11.76
1970,Spain,2388,0.75,25,4747,1.44,15,7135,1.1,19,2359,2333,1.11
1970,Austria,2857,0.9,20,3549,1.08,21,6406,0.99,20,692,413,67.55
1970,Norway,2457,0.77,23,3702,1.12,18,6159,0.95,21,1245,738,68.7
1970,Brazil,2739,0.86,21,2849,0.87,24,5588,0.86,22,110,-46,-339.13
1970,"Hong Kong, China",2515,0.79,22,2905,0.88,22,5420,0.84,23,390,281,38.79
1970,"Venezuela, Bolivarian Republic of",3169,1.0,19,1869,0.57,35,5038,0.78,24,-1300,-1363,-4.62
1970,Finland,2306,0.73,30,2638,0.8,25,4944,0.76,25,332,38,773.68
1970,Hungary,2317,0.73,28,2506,0.76,26,4823,0.75,26,189,-156,-221.15
1970,China,2307,0.73,29,2279,0.69,29,4586,0.71,27,-28,-512,-94.53
1970,"Yugoslavia, Socialist Federal Republic of",1679,0.53,37,2874,0.87,23,4553,0.7,28,1195,659,81.34
1970,India,2026,0.64,31,2124,0.65,30,4150,0.64,29,98,377,-74.01
1970,Iran,2403,0.76,24,1662,0.5,38,4065,0.63,30,-741,-573,29.32
1970,Singapore,1554,0.49,38,2461,0.75,27,4015,0.62,31,907,490,85.1
1970,Romania,1851,0.58,33,2117,0.64,31,3968,0.61,32,266,247,7.69
1970,Mexico,1402,0.44,40,2461,0.75,27,3863,0.6,33,1059,650,62.92
1970,Bulgaria,2004,0.63,32,1831,0.56,36,3835,0.59,34,-173,-45,284.44
1970,Argentina,1773,0.56,34,1694,0.51,37,3467,0.54,35,-79,-36,119.44
1970,Malaysia,1687,0.53,36,1401,0.43,42,3088,0.48,36,-286,-473,-39.53
1970,"Saudi Arabia, Kingdom of",2371,0.75,26,693,0.21,56,3064,0.47,37,-1678,-1318,27.31
1970,Chinese Taipei,1428,0.45,39,1528,0.46,41,2956,0.46,38,100,167,-40.12
1970,Libya,2357,0.74,27,554,0.17,61,2911,0.45,39,-1803,-1488,21.17
1970,Israel,779,0.25,55,2079,0.63,32,2858,0.44,40,1300,924,40.69
1970,"Korea, Republic of",836,0.26,53,1984,0.6,33,2820,0.44,41,1148,1200,-4.33
1970,Ireland,1120,0.35,44,1621,0.49,39,2741,0.42,42,501,525,-4.57
1970,Greece,643,0.2,60,1958,0.59,34,2601,0.4,43,1315,1040,26.44
1970,Portugal,946,0.3,52,1556,0.47,40,2502,0.39,44,610,409,49.14
1970,New Zealand,1223,0.39,43,1245,0.38,46,2468,0.38,45,22,-208,-110.58
1970,Cuba,1046,0.33,48,1311,0.4,43,2357,0.36,46,265,551,-51.91
1970,"Kuwait, the State of",1693,0.53,35,625,0.19,59,2318,0.36,47,-1068,-894,19.46
1970,Chile,1249,0.39,41,1063,0.32,48,2312,0.36,48,-186,-47,295.74
1970,Nigeria,1240,0.39,42,1059,0.32,49,2299,0.36,49,-181,-195,-7.18
1970,Philippines,1041,0.33,49,1236,0.38,47,2277,0.35,50,195,411,-52.55
1970,Algeria,1009,0.32,50,1257,0.38,45,2266,0.35,51,248,75,230.67
1970,Indonesia,1108,0.35,45,1002,0.3,50,2110,0.33,52,-106,-73,45.21
1970,Thailand,710,0.22,58,1299,0.39,44,2009,0.31,53,589,541,8.87
1970,Peru,1048,0.33,47,623,0.19,60,1671,0.26,54,-425,-253,67.98
1970,Iraq,1098,0.35,46,509,0.15,64,1607,0.25,55,-589,-605,-2.64
1970,Colombia,727,0.23,57,843,0.26,52,1570,0.24,56,116,78,48.72
1970,Egypt,762,0.24,56,787,0.24,54,1549,0.24,57,25,-107,-123.36
1970,Türkiye,588,0.19,61,948,0.29,51,1536,0.24,58,360,264,36.36
1970,Zambia,1001,0.32,51,477,0.14,65,1478,0.23,59,-524,-636,-17.61
1970,Netherlands Antilles,676,0.21,59,798,0.24,53,1474,0.23,60,122,186,-34.41
1970,Pakistan,449,0.14,67,775,0.24,55,1224,0.19,61,326,381,-14.44
1970,Morocco,488,0.15,63,684,0.21,57,1172,0.18,62,196,77,154.55
1970,Trinidad and Tobago,482,0.15,64,544,0.17,62,1026,0.16,63,62,9,588.89
1970,Democratic Republic of the Congo,781,0.25,54,179,0.05,97,960,0.15,64,-602,-548,9.85
1970,Ghana,458,0.14,66,411,0.12,67,869,0.13,65,-47,20,-335.0
1970,Jamaica,342,0.11,70,525,0.16,63,867,0.13,66,183,182,0.55
1970,Côte d'Ivoire,469,0.15,65,388,0.12,68,857,0.13,67,-81,-119,-31.93
1970,Lebanese Republic,190,0.06,87,659,0.2,58,849,0.13,68,469,420,11.67
1970,Angola,423,0.13,68,368,0.11,72,791,0.12,69,-55,-5,1000.0
1970,United Arab Emirates,523,0.16,62,267,0.08,85,790,0.12,70,-256,-100,156.0
1970,Zimbabwe,370,0.12,69,378,0.11,70,748,0.12,71,8,-4,-300.0
1970,Kenya,305,0.1,72,442,0.13,66,747,0.12,72,137,90,52.22
1970,Sri Lanka,342,0.11,70,386,0.12,69,728,0.11,73,44,98,-55.1
1970,Sudan,298,0.09,73,288,0.09,82,586,0.09,74,-10,9,-211.11
1970,Guatemala,290,0.09,74,284,0.09,83,574,0.09,75,-6,-5,20.0
1970,Tanzania,252,0.08,76,318,0.1,77,570,0.09,76,66,-7,-1042.86
1970,Syrian Arab Republic,203,0.06,85,360,0.11,73,563,0.09,77,157,163,-3.68
1970,Dominican Republic,249,0.08,77,304,0.09,80,553,0.09,78,55,62,-11.29
1970,Costa Rica,231,0.07,80,317,0.1,78,548,0.08,79,86,55,56.36
1970,Tunisia,182,0.06,90,306,0.09,79,488,0.08,80,124,100,24.0
1970,Mozambique,156,0.05,93,324,0.1,76,480,0.07,81,168,119,41.18
1970,Cameroon,226,0.07,82,242,0.07,87,468,0.07,82,16,-21,-176.19
1970,Panama,109,0.03,104,357,0.11,74,466,0.07,83,248,186,33.33
1970,"Bahrain, Kingdom of",218,0.07,83,247,0.08,86,465,0.07,84,29,-17,-270.59
1970,Ecuador,190,0.06,87,274,0.08,84,464,0.07,85,84,49,71.43
1970,Uruguay,233,0.07,79,231,0.07,89,464,0.07,85,-2,-3,-33.33
1970,Uganda,282,0.09,75,172,0.05,98,454,0.07,87,-110,-58,89.66
1970,El Salvador,229,0.07,81,214,0.07,92,443,0.07,88,-15,6,-350.0
1970,Bahamas,90,0.03,110,337,0.1,75,427,0.07,89,247,243,1.65
1970,New Caledonia,192,0.06,86,230,0.07,90,422,0.07,90,38,-7,-642.86
1970,Papua New Guinea,104,0.03,107,302,0.09,81,406,0.06,91,198,121,63.64
1970,Honduras,179,0.06,91,221,0.07,91,400,0.06,92,42,16,162.5
1970,Viet Nam,8,0.0,149,373,0.11,71,381,0.06,93,365,445,-17.98
1970,Nicaragua,179,0.06,91,199,0.06,94,378,0.06,94,20,18,11.11
1970,Liberia,214,0.07,84,150,0.05,106,364,0.06,95,-64,-81,-20.99
1970,"Bolivia, Plurinational State of",190,0.06,87,159,0.05,103,349,0.05,96,-31,-7,342.86
1970,Senegal,152,0.05,94,194,0.06,95,346,0.05,97,42,69,-39.13
1970,"Yemen, People's Democratic Republic",145,0.05,96,200,0.06,93,345,0.05,98,55,70,-21.43
1970,Cyprus,108,0.03,105,236,0.07,88,344,0.05,99,128,110,16.36
1970,Madagascar,145,0.05,96,170,0.05,100,315,0.05,100,25,71,-64.79
1970,Iceland,147,0.05,95,157,0.05,104,304,0.05,101,10,15,-33.33
1970,Qatar,240,0.08,78,64,0.02,126,304,0.05,101,-176,-170,3.53
1970,Ethiopia,122,0.04,103,172,0.05,98,294,0.05,103,50,36,38.89
1970,Guyana,136,0.04,101,134,0.04,109,270,0.04,104,-2,-8,-75.0
1970,Myanmar,108,0.03,105,155,0.05,105,263,0.04,105,47,33,42.42
1970,Suriname,144,0.05,98,115,0.03,113,259,0.04,106,-29,-19,52.63
1970,Gabon,144,0.05,98,80,0.02,119,224,0.03,107,-64,-65,-1.54
1970,Jordan,34,0.01,128,184,0.06,96,218,0.03,108,150,149,0.67
1970,Sierra Leone,101,0.03,108,116,0.04,112,217,0.03,109,15,6,150.0
1970,Reunion,51,0.02,120,161,0.05,101,212,0.03,110,110,100,10.0
1970,Malta,39,0.01,125,161,0.05,101,200,0.03,111,122,110,10.91
1970,Afghanistan,86,0.03,113,114,0.03,114,200,0.03,111,28,44,-36.36
1970,Fiji,87,0.03,112,104,0.03,117,191,0.03,113,17,17,0.0
1970,Brunei Darussalam,95,0.03,109,84,0.03,118,179,0.03,114,-11,-15,-26.67
1970,Martinique,30,0.01,133,146,0.04,107,176,0.03,115,116,90,28.89
1970,Malawi,60,0.02,117,109,0.03,116,169,0.03,116,49,33,48.48
1970,Guadeloupe,38,0.01,127,128,0.04,110,166,0.03,117,90,71,26.76
1970,Oman,143,0.05,100,18,0.01,152,161,0.02,118,-125,-128,-2.34
1970,Barbados,40,0.01,123,118,0.04,111,158,0.02,119,78,60,30.0
1970,French Polynesia,18,0.01,141,135,0.04,108,153,0.02,120,117,95,23.16
1970,Mauritania,89,0.03,111,56,0.02,133,145,0.02,121,-33,-34,-2.94
1970,Mauritius,69,0.02,115,76,0.02,121,145,0.02,121,7,2,250.0
1970,American Samoa,125,0.04,102,18,0.01,152,143,0.02,123,-107,-16,568.75
1970,Paraguay,63,0.02,116,76,0.02,121,139,0.02,124,13,32,-59.38
1970,Guinea,56,0.02,118,78,0.02,120,134,0.02,125,22,8,175.0
1970,Eswatini,71,0.02,114,60,0.02,129,131,0.02,126,-11,-12,-8.33
1970,Lao People's Democratic Republic,7,0.0,153,114,0.03,114,121,0.02,127,107,79,35.44
1970,Togo,55,0.02,119,65,0.02,124,120,0.02,128,10,11,-9.09
1970,Nepal,42,0.01,121,75,0.02,123,117,0.02,129,33,31,6.45
1970,"Macao, China",42,0.01,121,65,0.02,124,107,0.02,130,23,23,0.0
1970,Benin,33,0.01,129,64,0.02,126,97,0.02,131,31,28,10.71
1970,Haiti,40,0.01,123,55,0.02,134,95,0.01,132,15,2,650.0
1970,Cambodia,39,0.01,125,54,0.02,135,93,0.01,133,15,38,-60.53
1970,Chad,30,0.01,133,62,0.02,128,92,0.01,134,32,23,39.13
1970,Niger,32,0.01,131,58,0.02,131,90,0.01,135,26,24,8.33
1970,Congo,31,0.01,132,59,0.02,130,90,0.01,135,28,36,-22.22
1970,Botswana,26,0.01,136,57,0.02,132,83,0.01,137,31,28,10.71
1970,Mali,33,0.01,129,47,0.01,138,80,0.01,138,14,22,-36.36
1970,Burkina Faso,18,0.01,141,49,0.01,137,67,0.01,139,31,33,-6.06
1970,Greenland,14,0.0,144,53,0.02,136,67,0.01,139,39,36,8.33
1970,Central African Republic,30,0.01,133,34,0.01,142,64,0.01,141,4,2,100.0
1970,Rwanda,25,0.01,137,29,0.01,146,54,0.01,142,4,10,-60.0
1970,Belize,19,0.01,140,33,0.01,143,52,0.01,143,14,13,7.69
1970,Equatorial Guinea,25,0.01,137,24,0.01,149,49,0.01,144,-1,-5,-80.0
1970,French Guiana,4,0.0,160,45,0.01,139,49,0.01,144,41,45,-8.89
1970,Djibouti,10,0.0,147,38,0.01,140,48,0.01,146,28,37,-24.32
1970,Antigua and Barbuda,11,0.0,146,36,0.01,141,47,0.01,147,25,23,8.7
1970,Burundi,24,0.01,139,22,0.01,150,46,0.01,148,-2,9,-122.22
1970,Lesotho,6,0.0,154,32,0.01,145,38,0.01,149,26,26,0.0
1970,Yemen,3,0.0,165,33,0.01,143,36,0.01,150,30,32,-6.25
1970,Saint Lucia,9,0.0,148,27,0.01,147,36,0.01,150,18,13,38.46
1970,The Gambia,17,0.01,143,18,0.01,152,35,0.01,152,1,4,-75.0
1970,Guinea-Bissau,4,0.0,160,27,0.01,147,31,0.0,153,23,19,21.05
1970,Grenada,6,0.0,154,22,0.01,150,28,0.0,154,16,9,77.78
1970,Vanuatu,12,0.0,145,13,0.0,160,25,0.0,155,1,0,
1970,Dominica,6,0.0,154,16,0.0,156,22,0.0,156,10,5,100.0
1970,Solomon Islands,8,0.0,149,13,0.0,160,21,0.0,157,5,4,25.0
1970,Saint Vincent and the Grenadines,4,0.0,160,15,0.0,158,19,0.0,158,11,8,37.5
1970,Samoa,5,0.0,158,14,0.0,159,19,0.0,158,9,4,125.0
1970,Montserrat,1,0.0,171,18,0.01,152,19,0.0,158,17,16,6.25
1970,Cabo Verde,2,0.0,169,16,0.0,156,18,0.0,161,14,9,55.56
1970,Sao Tomé and Principe,8,0.0,149,9,0.0,165,17,0.0,162,1,-1,-200.0
1970,Saint Kitts and Nevis,4,0.0,160,12,0.0,162,16,0.0,163,8,1,700.0
1970,Saint Pierre and Miquelon,3,0.0,165,12,0.0,162,15,0.0,164,9,9,0.0
1970,Comoros,5,0.0,158,9,0.0,165,14,0.0,165,4,3,33.33
1970,Kiribati,8,0.0,149,4,0.0,169,12,0.0,166,-4,-4,0.0
1970,Seychelles,2,0.0,169,10,0.0,164,12,0.0,166,8,4,100.0
1970,Tonga,3,0.0,165,6,0.0,167,9,0.0,168,3,2,50.0
1970,Cook Islands,3,0.0,165,6,0.0,167,9,0.0,168,3,1,200.0
1970,Guam,6,0.0,154,0,0.0,171,6,0.0,170,-6,-1,500.0
1970,Maldives,4,0.0,160,2,0.0,170,6,0.0,170,-2,0,
1969,United States of America,37332,13.5,1,38312,13.37,1,75644,13.43,1,980,1287,-23.85
1969,Germany,28852,10.43,2,24876,8.68,2,53728,9.54,2,-3976,-4593,-13.43
1969,United Kingdom,17645,6.38,3,19961,6.97,3,37606,6.68,3,2316,3499,-33.81
1969,France,15194,5.49,5,17371,6.06,4,32565,5.78,4,2177,1116,95.07
1969,Japan,15990,5.78,4,15023,5.24,5,31013,5.51,5,-967,17,-5788.24
1969,Canada,14350,5.19,6,14019,4.89,6,28369,5.04,6,-331,-891,-62.85
1969,Netherlands,11383,4.12,9,12983,4.53,7,24366,4.33,7,1600,1428,12.04
1969,Italy,11728,4.24,7,12470,4.35,8,24198,4.3,8,742,99,649.49
1969,U.S.S.R.,11655,4.21,8,10327,3.6,9,21982,3.9,9,-1328,-1224,8.5
1969,Belgium-Luxembourg,10090,3.65,10,10022,3.5,10,20112,3.57,10,-68,224,-130.36
1969,Sweden,5695,2.06,11,5909,2.06,11,11604,2.06,11,214,216,-0.93
1969,Switzerland,4576,1.65,12,5199,1.81,12,9775,1.74,12,623,475,31.16
1969,Australia,4220,1.53,13,4538,1.58,13,8758,1.56,13,318,840,-62.14
1969,German Democratic Republic,4153,1.5,14,4123,1.44,15,8276,1.47,14,-30,-398,-92.46
1969,Denmark,3019,1.09,19,3813,1.33,16,6832,1.21,15,794,596,33.22
1969,Czech and Slovak Federal Republic,3319,1.2,16,3294,1.15,17,6613,1.17,16,-25,72,-134.72
1969,South Africa,3357,1.21,15,3189,1.11,19,6546,1.16,17,-168,-415,-59.52
1969,Poland,3142,1.14,17,3210,1.12,18,6352,1.13,18,68,-5,-1460.0
1969,Spain,1900,0.69,30,4233,1.48,14,6133,1.09,19,2333,1916,21.76
1969,Austria,2412,0.87,21,2825,0.99,21,5237,0.93,20,413,507,-18.54
1969,Norway,2204,0.8,23,2942,1.03,20,5146,0.91,21,738,768,-3.91
1969,"Venezuela, Bolivarian Republic of",3083,1.11,18,1720,0.6,34,4803,0.85,22,-1363,-1114,22.35
1969,"Hong Kong, China",2177,0.79,24,2458,0.86,22,4635,0.82,23,281,314,-10.51
1969,Brazil,2311,0.84,22,2265,0.79,23,4576,0.81,24,-46,251,-118.33
1969,China,2429,0.88,20,1917,0.67,30,4346,0.77,25,-512,-272,88.24
1969,India,1835,0.66,31,2212,0.77,24,4047,0.72,26,377,809,-53.4
1969,Finland,1987,0.72,29,2025,0.71,28,4012,0.71,27,38,-43,-188.37
1969,Hungary,2084,0.75,27,1928,0.67,29,4012,0.71,27,-156,13,-1300.0
1969,Iran,2100,0.76,26,1527,0.53,38,3627,0.64,29,-573,-497,15.29
1969,"Yugoslavia, Socialist Federal Republic of",1475,0.53,38,2134,0.74,25,3609,0.64,30,659,533,23.64
1969,Singapore,1549,0.56,36,2039,0.71,27,3588,0.64,31,490,389,25.96
1969,Bulgaria,1795,0.65,32,1750,0.61,33,3545,0.63,32,-45,167,-126.95
1969,Romania,1633,0.59,34,1880,0.66,31,3513,0.62,33,247,269,-8.18
1969,Mexico,1430,0.52,39,2080,0.73,26,3510,0.62,34,650,706,-7.93
1969,Argentina,1612,0.58,35,1576,0.55,37,3188,0.57,35,-36,-199,-81.91
1969,Libya,2164,0.78,25,676,0.24,56,2840,0.5,36,-1488,-1226,21.37
1969,Malaysia,1651,0.6,33,1178,0.41,45,2829,0.5,37,-473,-187,152.94
1969,"Saudi Arabia, Kingdom of",2053,0.74,28,735,0.26,52,2788,0.5,38,-1318,-1391,-5.25
1969,"Korea, Republic of",624,0.23,58,1824,0.64,32,2448,0.43,39,1200,1006,19.28
1969,Israel,729,0.26,53,1653,0.58,35,2382,0.42,40,924,668,38.32
1969,Ireland,891,0.32,46,1416,0.49,39,2307,0.41,41,525,377,39.26
1969,Chinese Taipei,1049,0.38,43,1216,0.42,44,2265,0.4,42,167,104,60.58
1969,New Zealand,1211,0.44,40,1003,0.35,48,2214,0.39,43,-208,-115,80.87
1969,"Kuwait, the State of",1540,0.56,37,646,0.23,57,2186,0.39,44,-894,-828,7.97
1969,Greece,554,0.2,60,1594,0.56,36,2148,0.38,45,1040,925,12.43
1969,Philippines,854,0.31,49,1265,0.44,40,2119,0.38,46,411,432,-4.86
1969,Chile,1075,0.39,41,1028,0.36,46,2103,0.37,47,-47,-6,683.33
1969,Portugal,823,0.3,51,1232,0.43,42,2055,0.36,48,409,309,32.36
1969,Thailand,707,0.26,54,1248,0.44,41,1955,0.35,49,541,501,7.98
1969,Algeria,934,0.34,45,1009,0.35,47,1943,0.35,50,75,-15,-600.0
1969,Cuba,671,0.24,56,1222,0.43,43,1893,0.34,51,551,451,22.17
1969,Indonesia,854,0.31,49,781,0.27,51,1635,0.29,52,-73,-15,386.67
1969,Nigeria,891,0.32,46,696,0.24,54,1587,0.28,53,-195,-51,282.35
1969,Zambia,1073,0.39,42,437,0.15,65,1510,0.27,54,-636,-302,110.6
1969,Iraq,1045,0.38,44,440,0.15,64,1485,0.26,55,-605,-635,-4.72
1969,Peru,866,0.31,48,613,0.21,59,1479,0.26,56,-253,-220,15.0
1969,Netherlands Antilles,625,0.23,57,811,0.28,49,1436,0.26,57,186,187,-0.53
1969,Egypt,745,0.27,52,638,0.22,58,1383,0.25,58,-107,44,-343.18
1969,Türkiye,537,0.19,61,801,0.28,50,1338,0.24,59,264,268,-1.49
1969,Colombia,607,0.22,59,685,0.24,55,1292,0.23,60,78,84,-7.14
1969,Morocco,485,0.18,62,562,0.2,61,1047,0.19,61,77,102,-24.51
1969,Pakistan,332,0.12,66,713,0.25,53,1045,0.19,62,381,241,58.09
1969,Trinidad and Tobago,474,0.17,63,483,0.17,62,957,0.17,63,9,-52,-117.31
1969,Democratic Republic of the Congo,680,0.25,55,132,0.05,103,812,0.14,64,-548,-467,17.34
1969,Côte d'Ivoire,452,0.16,64,333,0.12,71,785,0.14,65,-119,-118,0.85
1969,Lebanese Republic,165,0.06,90,585,0.2,60,750,0.13,66,420,449,-6.46
1969,Sri Lanka,322,0.12,70,420,0.15,67,742,0.13,67,98,17,476.47
1969,United Arab Emirates,407,0.15,65,307,0.11,74,714,0.13,68,-100,-55,81.82
1969,Jamaica,254,0.09,73,436,0.15,66,690,0.12,69,182,164,10.98
1969,Ghana,327,0.12,67,347,0.12,70,674,0.12,70,20,-24,-183.33
1969,Angola,326,0.12,68,321,0.11,72,647,0.11,71,-5,32,-115.63
1969,Zimbabwe,325,0.12,69,321,0.11,72,646,0.11,72,-4,70,-105.71
1969,Kenya,271,0.1,71,361,0.13,69,632,0.11,73,90,104,-13.46
1969,Syrian Arab Republic,207,0.07,80,370,0.13,68,577,0.1,74,163,145,12.41
1969,Guatemala,255,0.09,72,250,0.09,80,505,0.09,75,-5,22,-122.73
1969,Sudan,248,0.09,74,257,0.09,79,505,0.09,75,9,25,-64.0
1969,Tanzania,246,0.09,75,239,0.08,84,485,0.09,77,-7,16,-143.75
1969,Viet Nam,8,0.0,149,453,0.16,63,461,0.08,78,445,308,44.48
1969,Ecuador,193,0.07,84,242,0.08,83,435,0.08,79,49,29,68.97
1969,Costa Rica,190,0.07,85,245,0.09,82,435,0.08,79,55,43,27.91
1969,"Bahrain, Kingdom of",226,0.08,77,209,0.07,87,435,0.08,79,-17,-18,-5.56
1969,Tunisia,166,0.06,89,266,0.09,77,432,0.08,82,100,60,66.67
1969,Dominican Republic,184,0.07,86,246,0.09,81,430,0.08,83,62,39,58.97
1969,Cameroon,225,0.08,78,204,0.07,90,429,0.08,84,-21,-1,2000.0
1969,El Salvador,202,0.07,81,208,0.07,88,410,0.07,85,6,1,500.0
1969,Uganda,233,0.08,76,175,0.06,97,408,0.07,86,-58,-51,13.73
1969,Mozambique,142,0.05,93,261,0.09,78,403,0.07,87,119,80,48.75
1969,Panama,108,0.04,103,294,0.1,76,402,0.07,88,186,174,6.9
1969,Uruguay,200,0.07,82,197,0.07,91,397,0.07,89,-3,-22,-86.36
1969,"Yemen, People's Democratic Republic",148,0.05,92,218,0.08,86,366,0.06,90,70,90,-22.22
1969,Honduras,168,0.06,88,184,0.06,94,352,0.06,91,16,5,220.0
1969,Bahamas,53,0.02,117,296,0.1,75,349,0.06,92,243,125,94.4
1969,"Bolivia, Plurinational State of",172,0.06,87,165,0.06,98,337,0.06,93,-7,1,-800.0
1969,Nicaragua,159,0.06,91,177,0.06,96,336,0.06,94,18,23,-21.74
1969,Papua New Guinea,100,0.04,106,221,0.08,85,321,0.06,95,121,94,28.72
1969,Senegal,125,0.05,100,194,0.07,92,319,0.06,96,69,33,109.09
1969,Liberia,196,0.07,83,115,0.04,109,311,0.06,97,-81,-61,32.79
1969,Cyprus,98,0.04,107,208,0.07,88,306,0.05,98,110,81,35.8
1969,Myanmar,132,0.05,97,165,0.06,98,297,0.05,99,33,3,1000.0
1969,Madagascar,111,0.04,102,182,0.06,95,293,0.05,100,71,54,31.48
1969,Qatar,223,0.08,79,53,0.02,131,276,0.05,101,-170,-168,1.19
1969,Ethiopia,119,0.04,101,155,0.05,100,274,0.05,102,36,67,-46.27
1969,New Caledonia,134,0.05,96,127,0.04,104,261,0.05,103,-7,-20,-65.0
1969,Guyana,126,0.05,99,118,0.04,108,244,0.04,104,-8,-5,60.0
1969,Suriname,130,0.05,98,111,0.04,111,241,0.04,105,-19,-16,18.75
1969,Iceland,108,0.04,103,123,0.04,107,231,0.04,106,15,54,-72.22
1969,Jordan,41,0.01,123,190,0.07,93,231,0.04,106,149,119,25.21
1969,Gabon,142,0.05,93,77,0.03,122,219,0.04,108,-65,-60,8.33
1969,Sierra Leone,106,0.04,105,112,0.04,110,218,0.04,109,6,-6,-200.0
1969,Afghanistan,82,0.03,109,126,0.04,105,208,0.04,110,44,42,4.76
1969,Reunion,46,0.02,120,146,0.05,102,192,0.03,111,100,77,29.87
1969,Malta,38,0.01,124,148,0.05,101,186,0.03,112,110,89,23.6
1969,Cambodia,64,0.02,113,102,0.04,114,166,0.03,113,38,27,40.74
1969,Martinique,36,0.01,129,126,0.04,105,162,0.03,114,90,69,30.43
1969,Fiji,72,0.03,111,89,0.03,116,161,0.03,115,17,11,54.55
1969,Brunei Darussalam,88,0.03,108,73,0.03,123,161,0.03,115,-15,-23,-34.78
1969,Oman,141,0.05,95,13,0.0,154,154,0.03,117,-128,-95,34.74
1969,Guadeloupe,35,0.01,131,106,0.04,113,141,0.03,118,71,64,10.94
1969,Nepal,54,0.02,116,85,0.03,118,139,0.02,119,31,7,342.86
1969,Malawi,53,0.02,117,86,0.03,117,139,0.02,119,33,26,26.92
1969,Barbados,37,0.01,126,97,0.03,115,134,0.02,121,60,44,36.36
1969,Mauritius,66,0.02,112,68,0.02,124,134,0.02,121,2,12,-83.33
1969,Paraguay,50,0.02,119,82,0.03,120,132,0.02,123,32,27,18.52
1969,Congo,44,0.02,122,80,0.03,121,124,0.02,124,36,37,-2.7
1969,French Polynesia,14,0.01,141,109,0.04,112,123,0.02,125,95,162,-41.36
1969,Guinea,57,0.02,115,65,0.02,125,122,0.02,126,8,-3,-366.67
1969,Mauritania,76,0.03,110,42,0.01,138,118,0.02,127,-34,-37,-8.11
1969,Eswatini,62,0.02,114,50,0.02,132,112,0.02,128,-12,-7,71.43
1969,Togo,45,0.02,121,56,0.02,127,101,0.02,129,11,8,37.5
1969,"Macao, China",37,0.01,126,60,0.02,126,97,0.02,130,23,22,4.55
1969,Lao People's Democratic Republic,4,0.0,160,83,0.03,119,87,0.02,131,79,48,64.58
1969,Chad,31,0.01,132,54,0.02,129,85,0.02,132,23,23,0.0
1969,Benin,27,0.01,134,55,0.02,128,82,0.01,133,28,28,0.0
1969,Haiti,37,0.01,126,39,0.01,139,76,0.01,134,2,2,0.0
1969,Burkina Faso,21,0.01,136,54,0.02,129,75,0.01,135,33,23,43.48
1969,Central African Republic,36,0.01,129,38,0.01,141,74,0.01,136,2,4,-50.0
1969,Niger,24,0.01,135,48,0.02,136,72,0.01,137,24,12,100.0
1969,Equatorial Guinea,38,0.01,124,33,0.01,143,71,0.01,138,-5,-4,25.0
1969,Botswana,18,0.01,137,46,0.02,137,64,0.01,139,28,23,21.74
1969,Greenland,14,0.01,141,50,0.02,132,64,0.01,139,36,36,0.0
1969,Djibouti,12,0.0,144,49,0.02,135,61,0.01,141,37,38,-2.63
1969,Mali,17,0.01,138,39,0.01,139,56,0.01,142,22,23,-4.35
1969,French Guiana,5,0.0,158,50,0.02,132,55,0.01,143,45,49,-8.16
1969,Belize,17,0.01,138,30,0.01,145,47,0.01,144,13,12,8.33
1969,Lesotho,7,0.0,153,33,0.01,143,40,0.01,145,26,28,-7.14
1969,Yemen,4,0.0,160,36,0.01,142,40,0.01,145,32,16,100.0
1969,American Samoa,28,0.01,133,12,0.0,155,40,0.01,145,-16,-18,-11.11
1969,Rwanda,14,0.01,141,24,0.01,147,38,0.01,148,10,7,42.86
1969,The Gambia,16,0.01,140,20,0.01,151,36,0.01,149,4,8,-50.0
1969,Antigua and Barbuda,6,0.0,156,29,0.01,146,35,0.01,150,23,18,27.78
1969,Burundi,12,0.0,144,21,0.01,149,33,0.01,151,9,8,12.5
1969,Saint Lucia,8,0.0,149,21,0.01,149,29,0.01,152,13,9,44.44
1969,Guinea-Bissau,4,0.0,160,23,0.01,148,27,0.0,153,19,14,35.71
1969,Grenada,8,0.0,149,17,0.01,152,25,0.0,154,9,8,12.5
1969,Vanuatu,11,0.0,146,11,0.0,158,22,0.0,155,0,-2,-100.0
1969,Saint Kitts and Nevis,9,0.0,147,10,0.0,161,19,0.0,156,1,2,-50.0
1969,Dominica,7,0.0,153,12,0.0,155,19,0.0,156,5,4,25.0
1969,Solomon Islands,7,0.0,153,11,0.0,158,18,0.0,158,4,6,-33.33
1969,Montserrat,1,0.0,169,17,0.01,152,18,0.0,158,16,15,6.67
1969,Sao Tomé and Principe,9,0.0,147,8,0.0,164,17,0.0,160,-1,-3,-66.67
1969,Saint Vincent and the Grenadines,4,0.0,160,12,0.0,155,16,0.0,161,8,6,33.33
1969,Samoa,6,0.0,156,10,0.0,161,16,0.0,161,4,3,33.33
1969,Comoros,5,0.0,158,8,0.0,164,13,0.0,163,3,3,0.0
1969,Cabo Verde,2,0.0,168,11,0.0,158,13,0.0,163,9,6,50.0
1969,Kiribati,8,0.0,149,4,0.0,168,12,0.0,165,-4,-3,33.33
1969,Saint Pierre and Miquelon,1,0.0,169,10,0.0,161,11,0.0,166,9,7,28.57
1969,Seychelles,3,0.0,165,7,0.0,166,10,0.0,167,4,3,33.33
1969,Tonga,4,0.0,160,6,0.0,167,10,0.0,167,2,2,0.0
1969,Cook Islands,3,0.0,165,4,0.0,168,7,0.0,169,1,2,-50.0
1969,Maldives,3,0.0,165,3,0.0,170,6,0.0,170,0,0,
1969,Guam,1,0.0,169,0,0.0,171,1,0.0,171,-1,-9,-88.89
1968,United States of America,34063,14.06,1,35350,14.01,1,69413,14.03,1,1287,-2181,-159.01
1968,Germany,24888,10.27,2,20295,8.04,2,45183,9.14,2,-4593,-4215,8.97
1968,United Kingdom,15461,6.38,3,18960,7.52,3,34421,6.96,3,3499,3307,5.81
1968,France,12903,5.33,6,14019,5.56,4,26922,5.44,4,1116,896,24.55
1968,Japan,12971,5.35,5,12988,5.15,5,25959,5.25,5,17,1221,-98.61
1968,Canada,13171,5.44,4,12280,4.87,6,25451,5.15,6,-891,-181,392.27
1968,Netherlands,9535,3.94,9,10963,4.35,7,20498,4.14,7,1428,1514,-5.68
1968,Italy,10186,4.2,8,10285,4.08,8,20471,4.14,8,99,1123,-91.18
1968,U.S.S.R.,10634,4.39,7,9410,3.73,9,20044,4.05,9,-1224,-1115,9.78
1968,Belgium-Luxembourg,8172,3.37,10,8396,3.33,10,16568,3.35,10,224,204,9.8
1968,Sweden,4910,2.03,11,5126,2.03,11,10036,2.03,11,216,173,24.86
1968,Switzerland,3967,1.64,12,4442,1.76,12,8409,1.7,12,475,599,-20.7
1968,Australia,3526,1.46,14,4366,1.73,13,7892,1.6,13,840,446,88.34
1968,German Democratic Republic,3791,1.56,13,3393,1.34,15,7184,1.45,14,-398,-177,124.86
1968,Czech and Slovak Federal Republic,3005,1.24,16,3077,1.22,17,6082,1.23,15,72,-184,-139.13
1968,South Africa,3204,1.32,15,2789,1.11,19,5993,1.21,16,-415,-231,79.65
1968,Denmark,2640,1.09,19,3236,1.28,16,5876,1.19,17,596,615,-3.09
1968,Poland,2858,1.18,17,2853,1.13,18,5711,1.15,18,-5,118,-104.24
1968,Spain,1589,0.66,32,3505,1.39,14,5094,1.03,19,1916,2079,-7.84
1968,Norway,1938,0.8,23,2706,1.07,20,4644,0.94,20,768,1010,-23.96
1968,Austria,1989,0.82,21,2496,0.99,22,4485,0.91,21,507,500,1.4
1968,"Venezuela, Bolivarian Republic of",2779,1.15,18,1665,0.66,31,4444,0.9,22,-1114,-1632,-31.74
1968,China,2340,0.97,20,2068,0.82,24,4408,0.89,23,-272,-219,24.2
1968,India,1761,0.73,28,2570,1.02,21,4331,0.88,24,809,1160,-30.26
1968,Brazil,1881,0.78,24,2132,0.85,23,4013,0.81,25,251,13,1830.77
1968,"Hong Kong, China",1744,0.72,29,2058,0.82,25,3802,0.77,26,314,291,7.9
1968,Hungary,1790,0.74,27,1803,0.71,27,3593,0.73,27,13,74,-82.43
1968,Bulgaria,1615,0.67,31,1782,0.71,29,3397,0.69,28,167,114,46.49
1968,Iran,1881,0.78,24,1384,0.55,36,3265,0.66,29,-497,-810,-38.64
1968,Finland,1635,0.67,30,1592,0.63,33,3227,0.65,30,-43,163,-126.38
1968,Mexico,1254,0.52,39,1960,0.78,26,3214,0.65,31,706,603,17.08
1968,Romania,1469,0.61,33,1738,0.69,30,3207,0.65,32,269,275,-2.18
1968,"Yugoslavia, Socialist Federal Republic of",1264,0.52,38,1797,0.71,28,3061,0.62,33,533,455,17.14
1968,Singapore,1271,0.52,37,1660,0.66,32,2931,0.59,34,389,299,30.1
1968,Argentina,1368,0.56,35,1169,0.46,40,2537,0.51,35,-199,-369,-46.07
1968,Libya,1871,0.77,26,645,0.26,54,2516,0.51,36,-1226,-691,77.42
1968,Malaysia,1347,0.56,36,1160,0.46,41,2507,0.51,37,-187,-131,42.75
1968,"Saudi Arabia, Kingdom of",1944,0.8,22,553,0.22,58,2497,0.5,38,-1391,-1210,14.96
1968,Philippines,858,0.35,43,1290,0.51,38,2148,0.43,39,432,360,20.0
1968,"Kuwait, the State of",1439,0.59,34,611,0.24,56,2050,0.41,40,-828,-762,8.66
1968,Ireland,798,0.33,47,1175,0.47,39,1973,0.4,41,377,296,27.36
1968,Israel,639,0.26,53,1307,0.52,37,1946,0.39,42,668,219,205.02
1968,"Korea, Republic of",457,0.19,62,1463,0.58,34,1920,0.39,43,1006,675,49.04
1968,New Zealand,1010,0.42,41,895,0.35,46,1905,0.39,44,-115,-38,202.63
1968,Greece,468,0.19,61,1393,0.55,35,1861,0.38,45,925,691,33.86
1968,Thailand,658,0.27,51,1159,0.46,42,1817,0.37,46,501,386,29.79
1968,Portugal,734,0.3,49,1043,0.41,44,1777,0.36,47,309,319,-3.13
1968,Cuba,651,0.27,52,1102,0.44,43,1753,0.35,48,451,294,53.4
1968,Chile,858,0.35,43,852,0.34,47,1710,0.35,49,-6,-28,-78.57
1968,Chinese Taipei,802,0.33,46,906,0.36,45,1708,0.35,50,104,167,-37.72
1968,Algeria,830,0.34,45,815,0.32,48,1645,0.33,51,-15,-84,-82.14
1968,Peru,866,0.36,42,646,0.26,53,1512,0.31,52,-220,71,-409.86
1968,Indonesia,731,0.3,50,716,0.28,51,1447,0.29,53,-15,-16,-6.25
1968,Iraq,1039,0.43,40,404,0.16,64,1443,0.29,54,-635,-398,59.55
1968,Netherlands Antilles,599,0.25,55,786,0.31,49,1385,0.28,55,187,174,7.47
1968,Egypt,622,0.26,54,666,0.26,52,1288,0.26,56,44,226,-80.53
1968,Türkiye,496,0.2,59,764,0.3,50,1260,0.25,57,268,163,64.42
1968,Zambia,759,0.31,48,457,0.18,62,1216,0.25,58,-302,-214,41.12
1968,Colombia,559,0.23,58,643,0.25,55,1202,0.24,59,84,-13,-746.15
1968,Nigeria,591,0.24,56,540,0.21,60,1131,0.23,60,-51,-51,0.0
1968,Morocco,450,0.19,63,552,0.22,59,1002,0.2,61,102,94,8.51
1968,Trinidad and Tobago,472,0.19,60,420,0.17,63,892,0.18,62,-52,-22,136.36
1968,Pakistan,292,0.12,68,533,0.21,61,825,0.17,63,241,432,-44.21
1968,Lebanese Republic,147,0.06,93,596,0.24,57,743,0.15,64,449,434,3.46
1968,Côte d'Ivoire,425,0.18,64,307,0.12,72,732,0.15,65,-118,-61,93.44
1968,Sri Lanka,342,0.14,65,359,0.14,66,701,0.14,66,17,17,0.0
1968,Democratic Republic of the Congo,570,0.24,57,103,0.04,110,673,0.14,67,-467,-368,26.9
1968,Ghana,332,0.14,67,308,0.12,71,640,0.13,68,-24,4,-700.0
1968,United Arab Emirates,335,0.14,66,280,0.11,74,615,0.12,69,-55,-22,150.0
1968,Kenya,252,0.1,71,356,0.14,67,608,0.12,70,104,95,9.47
1968,Jamaica,220,0.09,76,384,0.15,65,604,0.12,71,164,123,33.33
1968,Zimbabwe,263,0.11,70,333,0.13,68,596,0.12,72,70,29,141.38
1968,Angola,271,0.11,69,303,0.12,73,574,0.12,73,32,37,-13.51
1968,Tanzania,241,0.1,72,257,0.1,77,498,0.1,74,16,-23,-169.57
1968,Sudan,233,0.1,73,258,0.1,76,491,0.1,75,25,1,2400.0
1968,Ecuador,226,0.09,75,255,0.1,78,481,0.1,76,29,24,20.83
1968,Syrian Arab Republic,168,0.07,87,313,0.12,70,481,0.1,76,145,110,31.82
1968,Guatemala,227,0.09,74,249,0.1,79,476,0.1,78,22,49,-55.1
1968,El Salvador,213,0.09,78,214,0.08,83,427,0.09,79,1,17,-94.12
1968,Dominican Republic,183,0.08,82,222,0.09,81,405,0.08,80,39,41,-4.88
1968,"Bahrain, Kingdom of",211,0.09,79,193,0.08,86,404,0.08,81,-18,-5,260.0
1968,Mozambique,154,0.06,90,234,0.09,80,388,0.08,82,80,77,3.9
1968,Costa Rica,171,0.07,85,214,0.08,83,385,0.08,83,43,47,-8.51
1968,Uganda,216,0.09,77,165,0.07,97,381,0.08,84,-51,-60,-15.0
1968,Cameroon,189,0.08,81,188,0.07,87,377,0.08,85,-1,56,-101.79
1968,Tunisia,158,0.07,89,218,0.09,82,376,0.08,86,60,112,-46.43
1968,Honduras,181,0.07,83,186,0.07,88,367,0.07,87,5,10,-50.0
1968,Panama,92,0.04,104,266,0.11,75,358,0.07,88,174,172,1.16
1968,Nicaragua,162,0.07,88,185,0.07,90,347,0.07,89,23,52,-55.77
1968,Senegal,153,0.06,91,186,0.07,88,339,0.07,90,33,26,26.92
1968,Uruguay,179,0.07,84,157,0.06,99,336,0.07,91,-22,12,-283.33
1968,Viet Nam,8,0.0,149,316,0.13,69,324,0.07,92,308,354,-12.99
1968,"Yemen, People's Democratic Republic",113,0.05,98,203,0.08,85,316,0.06,93,90,72,25.0
1968,"Bolivia, Plurinational State of",152,0.06,92,153,0.06,100,305,0.06,94,1,1,0.0
1968,Madagascar,116,0.05,95,170,0.07,95,286,0.06,95,54,41,31.71
1968,Ethiopia,106,0.04,101,173,0.07,94,279,0.06,96,67,42,59.52
1968,Liberia,169,0.07,86,108,0.04,109,277,0.06,97,-61,-34,79.41
1968,Papua New Guinea,83,0.03,108,177,0.07,91,260,0.05,98,94,113,-16.81
1968,Cyprus,89,0.04,106,170,0.07,95,259,0.05,99,81,83,-2.41
1968,Qatar,211,0.09,79,43,0.02,135,254,0.05,100,-168,-112,50.0
1968,Bahamas,51,0.02,116,176,0.07,92,227,0.05,101,125,132,-5.3
1968,Guyana,115,0.05,97,110,0.04,107,225,0.05,102,-5,17,-129.41
1968,Myanmar,111,0.05,100,114,0.05,105,225,0.05,102,3,0,
1968,Suriname,116,0.05,95,100,0.04,112,216,0.04,104,-16,-4,300.0
1968,Iceland,80,0.03,109,134,0.05,101,214,0.04,105,54,65,-16.92
1968,New Caledonia,113,0.05,98,93,0.04,113,206,0.04,106,-20,4,-600.0
1968,Cambodia,89,0.04,106,116,0.05,104,205,0.04,107,27,13,107.69
1968,Jordan,40,0.02,122,159,0.06,98,199,0.04,108,119,122,-2.46
1968,Gabon,125,0.05,94,65,0.03,122,190,0.04,109,-60,-53,13.21
1968,Sierra Leone,96,0.04,103,90,0.04,114,186,0.04,110,-6,20,-130.0
1968,Afghanistan,72,0.03,110,114,0.05,105,186,0.04,110,42,60,-30.0
1968,French Polynesia,12,0.0,141,174,0.07,93,186,0.04,110,162,101,60.4
1968,Reunion,46,0.02,120,123,0.05,102,169,0.03,113,77,80,-3.75
1968,Brunei Darussalam,92,0.04,104,69,0.03,121,161,0.03,114,-23,-36,-36.11
1968,Malta,34,0.01,130,123,0.05,102,157,0.03,115,89,85,4.71
1968,Martinique,40,0.02,122,109,0.04,108,149,0.03,116,69,63,9.52
1968,Fiji,68,0.03,112,79,0.03,117,147,0.03,117,11,8,37.5
1968,Guadeloupe,38,0.02,126,102,0.04,111,140,0.03,118,64,68,-5.88
1968,Mauritius,64,0.03,113,76,0.03,118,140,0.03,118,12,14,-14.29
1968,Congo,49,0.02,117,86,0.03,115,135,0.03,120,37,36,2.78
1968,Barbados,40,0.02,122,84,0.03,116,124,0.03,121,44,36,22.22
1968,Malawi,48,0.02,119,74,0.03,119,122,0.02,122,26,13,100.0
1968,Paraguay,46,0.02,120,73,0.03,120,119,0.02,123,27,24,12.5
1968,Oman,105,0.04,102,10,0.0,156,115,0.02,124,-95,-16,493.75
1968,Mauritania,72,0.03,110,35,0.01,139,107,0.02,125,-37,-33,12.12
1968,Nepal,49,0.02,117,56,0.02,123,105,0.02,126,7,11,-36.36
1968,Guinea,53,0.02,115,50,0.02,127,103,0.02,127,-3,2,-250.0
1968,Eswatini,55,0.02,114,48,0.02,131,103,0.02,127,-7,-7,0.0
1968,Togo,39,0.02,125,47,0.02,133,86,0.02,129,8,13,-38.46
1968,Chad,31,0.01,131,54,0.02,124,85,0.02,130,23,28,-17.86
1968,"Macao, China",28,0.01,134,50,0.02,127,78,0.02,131,22,18,22.22
1968,Central African Republic,36,0.01,127,40,0.02,137,76,0.02,132,4,15,-73.33
1968,Haiti,36,0.01,127,38,0.02,138,74,0.01,133,2,2,0.0
1968,Benin,22,0.01,135,50,0.02,127,72,0.01,134,28,33,-15.15
1968,Niger,29,0.01,133,41,0.02,136,70,0.01,135,12,11,9.09
1968,Equatorial Guinea,36,0.01,127,32,0.01,143,68,0.01,136,-4,-4,0.0
1968,Burkina Faso,21,0.01,136,44,0.02,134,65,0.01,137,23,18,27.78
1968,Djibouti,12,0.0,141,50,0.02,127,62,0.01,138,38,34,11.76
1968,Greenland,12,0.0,141,48,0.02,131,60,0.01,139,36,33,9.09
1968,Lao People's Democratic Republic,6,0.0,153,54,0.02,124,60,0.01,139,48,45,6.67
1968,French Guiana,3,0.0,165,52,0.02,126,55,0.01,141,49,38,28.95
1968,Mali,11,0.0,145,34,0.01,140,45,0.01,142,23,23,0.0
1968,Botswana,10,0.0,146,33,0.01,141,43,0.01,143,23,18,27.78
1968,American Samoa,30,0.01,132,12,0.0,154,42,0.01,144,-18,-23,-21.74
1968,Belize,15,0.01,137,27,0.01,144,42,0.01,144,12,12,0.0
1968,Lesotho,5,0.0,157,33,0.01,141,38,0.01,146,28,27,3.7
1968,Burundi,15,0.01,137,23,0.01,146,38,0.01,146,8,6,33.33
1968,Rwanda,15,0.01,137,22,0.01,147,37,0.01,148,7,6,16.67
1968,The Gambia,13,0.01,140,21,0.01,148,34,0.01,149,8,1,700.0
1968,Antigua and Barbuda,7,0.0,151,25,0.01,145,32,0.01,150,18,22,-18.18
1968,Yemen,4,0.0,160,20,0.01,149,24,0.0,151,16,31,-48.39
1968,Vanuatu,12,0.0,141,10,0.0,156,22,0.0,152,-2,-2,0.0
1968,Guinea-Bissau,4,0.0,160,18,0.01,150,22,0.0,152,14,12,16.67
1968,Saint Lucia,6,0.0,153,15,0.01,151,21,0.0,154,9,10,-10.0
1968,Solomon Islands,6,0.0,153,12,0.0,154,18,0.0,155,6,5,20.0
1968,Grenada,5,0.0,157,13,0.01,153,18,0.0,155,8,9,-11.11
1968,Saint Kitts and Nevis,7,0.0,151,9,0.0,160,16,0.0,157,2,0,
1968,Dominica,6,0.0,153,10,0.0,156,16,0.0,157,4,4,0.0
1968,Sao Tomé and Principe,9,0.0,147,6,0.0,165,15,0.0,159,-3,-3,0.0
1968,Montserrat,0,0.0,171,15,0.01,151,15,0.0,159,15,12,25.0
1968,Saint Vincent and the Grenadines,4,0.0,160,10,0.0,156,14,0.0,161,6,5,20.0
1968,Samoa,5,0.0,157,8,0.0,161,13,0.0,162,3,4,-25.0
1968,Kiribati,8,0.0,149,5,0.0,168,13,0.0,162,-3,-3,0.0
1968,Comoros,4,0.0,160,7,0.0,163,11,0.0,164,3,3,0.0
1968,Tonga,4,0.0,160,6,0.0,165,10,0.0,165,2,2,0.0
1968,Guam,9,0.0,147,0,0.0,171,9,0.0,166,-9,-8,12.5
1968,Seychelles,3,0.0,165,6,0.0,165,9,0.0,166,3,3,0.0
1968,Saint Pierre and Miquelon,1,0.0,169,8,0.0,161,9,0.0,166,7,7,0.0
1968,Cabo Verde,1,0.0,169,7,0.0,163,8,0.0,169,6,6,0.0
1968,Cook Islands,2,0.0,167,4,0.0,169,6,0.0,170,2,2,0.0
1968,Maldives,2,0.0,167,2,0.0,170,4,0.0,171,0,0,
1967,United States of America,30934,14.18,1,28753,12.62,1,59687,13.38,1,-2181,-1634,33.48
1967,Germany,21761,9.97,2,17546,7.7,3,39307,8.81,2,-4215,-1990,111.81
1967,United Kingdom,14493,6.64,3,17800,7.81,2,32293,7.24,3,3307,1893,74.7
1967,France,11547,5.29,4,12443,5.46,4,23990,5.38,4,896,877,2.17
1967,Japan,10442,4.79,6,11663,5.12,5,22105,4.96,5,1221,-253,-582.61
1967,Canada,11000,5.04,5,10819,4.75,6,21819,4.89,6,-181,57,-417.54
1967,Italy,8706,3.99,8,9829,4.31,8,18535,4.16,7,1123,552,103.44
1967,Netherlands,8361,3.83,9,9875,4.33,7,18236,4.09,8,1514,1769,-14.41
1967,U.S.S.R.,9652,4.42,7,8537,3.75,9,18189,4.08,9,-1115,-928,20.15
1967,Belgium-Luxembourg,7082,3.25,10,7286,3.2,10,14368,3.22,10,204,350,-41.71
1967,Sweden,4528,2.08,11,4701,2.06,11,9229,2.07,11,173,316,-45.25
1967,Switzerland,3468,1.59,13,4067,1.78,12,7535,1.69,12,599,640,-6.41
1967,Australia,3478,1.59,12,3924,1.72,13,7402,1.66,13,446,441,1.13
1967,German Democratic Republic,3456,1.58,14,3279,1.44,15,6735,1.51,14,-177,10,-1870.0
1967,South Africa,3011,1.38,16,2780,1.22,17,5791,1.3,15,-231,-346,-33.24
1967,Denmark,2538,1.16,18,3153,1.38,16,5691,1.28,16,615,550,11.82
1967,Czech and Slovak Federal Republic,2864,1.31,17,2680,1.18,20,5544,1.24,17,-184,-9,1944.44
1967,Poland,2527,1.16,19,2645,1.16,21,5172,1.16,18,118,222,-46.85
1967,Spain,1362,0.62,33,3441,1.51,14,4803,1.08,19,2079,2337,-11.04
1967,China,2388,1.09,20,2169,0.95,23,4557,1.02,20,-219,-199,10.05
1967,"Venezuela, Bolivarian Republic of",3077,1.41,15,1445,0.63,32,4522,1.01,21,-1632,-1066,53.1
1967,Norway,1738,0.8,24,2748,1.21,19,4486,1.01,22,1010,840,20.24
1967,India,1613,0.74,27,2773,1.22,18,4386,0.98,23,1160,1486,-21.94
1967,Austria,1809,0.83,22,2309,1.01,22,4118,0.92,24,500,644,-22.36
1967,Hungary,1702,0.78,25,1776,0.78,25,3478,0.78,25,74,-28,-364.29
1967,"Hong Kong, China",1527,0.7,28,1818,0.8,24,3345,0.75,26,291,443,-34.31
1967,Brazil,1654,0.76,26,1667,0.73,30,3321,0.74,27,13,-245,-105.31
1967,Finland,1513,0.69,29,1676,0.74,28,3189,0.71,28,163,221,-26.24
1967,Romania,1395,0.64,32,1670,0.73,29,3065,0.69,29,275,124,121.77
1967,Iran,1929,0.88,21,1119,0.49,36,3048,0.68,30,-810,-379,113.72
1967,Bulgaria,1458,0.67,31,1572,0.69,31,3030,0.68,31,114,174,-34.48
1967,"Yugoslavia, Socialist Federal Republic of",1252,0.57,35,1707,0.75,27,2959,0.66,32,455,355,28.17
1967,Mexico,1145,0.52,38,1748,0.77,26,2893,0.65,33,603,406,48.52
1967,Singapore,1140,0.52,39,1439,0.63,33,2579,0.58,34,299,226,32.3
1967,Argentina,1465,0.67,30,1096,0.48,38,2561,0.57,35,-369,-469,-21.32
1967,"Saudi Arabia, Kingdom of",1784,0.82,23,574,0.25,57,2358,0.53,36,-1210,-1059,14.26
1967,Malaysia,1217,0.56,36,1086,0.48,39,2303,0.52,37,-131,-152,-13.82
1967,Philippines,820,0.38,43,1180,0.52,35,2000,0.45,38,360,133,170.68
1967,"Kuwait, the State of",1355,0.62,34,593,0.26,56,1948,0.44,39,-762,-879,-13.31
1967,New Zealand,993,0.46,40,955,0.42,45,1948,0.44,39,-38,19,-300.0
1967,Ireland,790,0.36,44,1086,0.48,39,1876,0.42,41,296,359,-17.55
1967,Pakistan,680,0.31,50,1112,0.49,37,1792,0.4,42,432,282,53.19
1967,Thailand,681,0.31,49,1067,0.47,41,1748,0.39,43,386,212,82.08
1967,Portugal,696,0.32,48,1015,0.45,42,1711,0.38,44,319,386,-17.36
1967,Cuba,705,0.32,47,999,0.44,43,1704,0.38,45,294,333,-11.71
1967,Greece,495,0.23,60,1186,0.52,34,1681,0.38,46,691,817,-15.42
1967,Chile,847,0.39,41,819,0.36,47,1666,0.37,47,-28,75,-137.33
1967,Libya,1168,0.54,37,477,0.21,61,1645,0.37,48,-691,-590,17.12
1967,Peru,754,0.35,45,825,0.36,46,1579,0.35,49,71,65,9.23
1967,Chinese Taipei,641,0.29,54,808,0.35,48,1449,0.32,50,167,85,96.47
1967,Netherlands Antilles,608,0.28,55,782,0.34,50,1390,0.31,51,174,130,33.85
1967,Algeria,723,0.33,46,639,0.28,54,1362,0.31,52,-84,22,-481.82
1967,Egypt,566,0.26,56,792,0.35,49,1358,0.3,53,226,466,-51.5
1967,Israel,555,0.25,57,774,0.34,51,1329,0.3,54,219,330,-33.64
1967,"Korea, Republic of",321,0.15,66,996,0.44,44,1317,0.3,55,675,465,45.16
1967,Indonesia,665,0.3,52,649,0.28,53,1314,0.29,56,-16,-152,-89.47
1967,Nigeria,677,0.31,51,626,0.27,55,1303,0.29,57,-51,-78,-34.62
1967,Iraq,822,0.38,42,424,0.19,63,1246,0.28,58,-398,-441,-9.75
1967,Türkiye,522,0.24,58,685,0.3,52,1207,0.27,59,163,227,-28.19
1967,Zambia,654,0.3,53,440,0.19,62,1094,0.25,60,-214,-346,-38.15
1967,Colombia,510,0.23,59,497,0.22,60,1007,0.23,61,-13,168,-107.74
1967,Morocco,424,0.19,63,518,0.23,59,942,0.21,62,94,50,88.0
1967,Trinidad and Tobago,439,0.2,62,417,0.18,64,856,0.19,63,-22,25,-188.0
1967,Sri Lanka,348,0.16,64,365,0.16,65,713,0.16,64,17,43,-60.47
1967,Lebanese Republic,118,0.05,96,552,0.24,58,670,0.15,65,434,508,-14.57
1967,Ghana,303,0.14,67,307,0.13,69,610,0.14,66,4,84,-95.24
1967,Côte d'Ivoire,325,0.15,65,264,0.12,73,589,0.13,67,-61,-57,7.02
1967,Kenya,242,0.11,71,337,0.15,68,579,0.13,68,95,86,10.47
1967,Jamaica,226,0.1,73,349,0.15,67,575,0.13,69,123,99,24.24
1967,Zimbabwe,272,0.12,68,301,0.13,70,573,0.13,70,29,-7,-514.29
1967,Democratic Republic of the Congo,446,0.2,61,78,0.03,116,524,0.12,71,-368,-320,15.0
1967,Angola,238,0.11,72,275,0.12,71,513,0.12,72,37,-14,-364.29
1967,United Arab Emirates,262,0.12,69,240,0.11,77,502,0.11,73,-22,-4,450.0
1967,Tanzania,252,0.12,70,229,0.1,78,481,0.11,74,-23,-28,-17.86
1967,Guatemala,198,0.09,79,247,0.11,76,445,0.1,75,49,-19,-357.89
1967,El Salvador,207,0.09,77,224,0.1,79,431,0.1,76,17,32,-46.88
1967,Sudan,213,0.1,75,214,0.09,80,427,0.1,77,1,19,-94.74
1967,Syrian Arab Republic,155,0.07,84,265,0.12,72,420,0.09,78,110,116,-5.17
1967,"Bahrain, Kingdom of",211,0.1,76,206,0.09,83,417,0.09,79,-5,-11,-54.55
1967,Tunisia,149,0.07,88,261,0.11,74,410,0.09,80,112,110,1.82
1967,Ecuador,190,0.09,80,214,0.09,80,404,0.09,81,24,19,26.32
1967,Uganda,219,0.1,74,159,0.07,96,378,0.08,82,-60,-51,17.65
1967,Viet Nam,11,0.01,146,365,0.16,65,376,0.08,83,354,271,30.63
1967,Nicaragua,152,0.07,86,204,0.09,84,356,0.08,84,52,40,30.0
1967,Dominican Republic,156,0.07,83,197,0.09,86,353,0.08,85,41,44,-6.82
1967,"Yemen, People's Democratic Republic",138,0.06,91,210,0.09,82,348,0.08,86,72,93,-22.58
1967,Costa Rica,144,0.07,89,191,0.08,87,335,0.08,87,47,43,9.3
1967,Uruguay,159,0.07,81,171,0.08,90,330,0.07,88,12,-22,-154.55
1967,Panama,79,0.04,105,251,0.11,75,330,0.07,88,172,164,4.88
1967,Mozambique,122,0.06,93,199,0.09,85,321,0.07,90,77,96,-19.79
1967,Honduras,155,0.07,84,165,0.07,91,320,0.07,91,10,6,66.67
1967,Senegal,139,0.06,90,165,0.07,91,304,0.07,92,26,10,160.0
1967,"Bolivia, Plurinational State of",150,0.07,87,151,0.07,98,301,0.07,93,1,11,-90.91
1967,Cameroon,121,0.06,94,177,0.08,89,298,0.07,94,56,0,
1967,Qatar,202,0.09,78,90,0.04,112,292,0.07,95,-112,-110,1.82
1967,Liberia,159,0.07,81,125,0.05,103,284,0.06,96,-34,-36,-5.56
1967,Iceland,97,0.04,101,162,0.07,95,259,0.06,97,65,19,242.11
1967,Madagascar,104,0.05,99,145,0.06,99,249,0.06,98,41,48,-14.58
1967,Myanmar,124,0.06,92,124,0.05,104,248,0.06,99,0,-36,-100.0
1967,Cyprus,82,0.04,103,165,0.07,91,247,0.06,100,83,73,13.7
1967,Papua New Guinea,66,0.03,109,179,0.08,88,245,0.05,101,113,92,22.83
1967,Ethiopia,101,0.05,100,143,0.06,100,244,0.05,102,42,51,-17.65
1967,Guyana,113,0.05,97,130,0.06,101,243,0.05,103,17,9,88.89
1967,Suriname,107,0.05,98,103,0.05,109,210,0.05,104,-4,3,-233.33
1967,Bahamas,31,0.01,128,163,0.07,94,194,0.04,105,132,116,13.79
1967,Afghanistan,66,0.03,109,126,0.06,102,192,0.04,106,60,61,-1.64
1967,Gabon,120,0.06,95,67,0.03,122,187,0.04,107,-53,-35,51.43
1967,Jordan,32,0.01,125,154,0.07,97,186,0.04,108,122,162,-24.69
1967,Cambodia,83,0.04,102,96,0.04,111,179,0.04,109,13,44,-70.45
1967,Sierra Leone,70,0.03,107,90,0.04,112,160,0.04,110,20,17,17.65
1967,New Caledonia,75,0.03,106,79,0.03,115,154,0.03,111,4,-11,-136.36
1967,Reunion,36,0.02,121,116,0.05,105,152,0.03,112,80,66,21.21
1967,Martinique,43,0.02,119,106,0.05,108,149,0.03,113,63,48,31.25
1967,Mauritius,63,0.03,111,77,0.03,117,140,0.03,114,14,-1,-1500.0
1967,Malta,27,0.01,131,112,0.05,107,139,0.03,115,85,79,7.59
1967,Fiji,63,0.03,111,71,0.03,119,134,0.03,116,8,7,14.29
1967,Guadeloupe,32,0.01,125,100,0.04,110,132,0.03,117,68,58,17.24
1967,Congo,48,0.02,117,84,0.04,114,132,0.03,117,36,29,24.14
1967,Malawi,57,0.03,113,70,0.03,121,127,0.03,119,13,21,-38.1
1967,French Polynesia,13,0.01,142,114,0.05,106,127,0.03,119,101,150,-32.67
1967,Brunei Darussalam,81,0.04,104,45,0.02,132,126,0.03,121,-36,-23,56.52
1967,Paraguay,47,0.02,118,71,0.03,119,118,0.03,122,24,10,140.0
1967,Barbados,41,0.02,120,77,0.03,117,118,0.03,122,36,35,2.86
1967,Nepal,50,0.02,116,61,0.03,123,111,0.02,124,11,24,-54.17
1967,Mauritania,70,0.03,107,37,0.02,137,107,0.02,125,-33,-46,-28.26
1967,Eswatini,56,0.03,114,49,0.02,127,105,0.02,126,-7,-20,-65.0
1967,Guinea,51,0.02,115,53,0.02,126,104,0.02,127,2,12,-83.33
1967,Chad,31,0.01,128,59,0.03,124,90,0.02,128,28,8,250.0
1967,Niger,35,0.02,123,46,0.02,130,81,0.02,129,11,10,10.0
1967,Djibouti,23,0.01,135,57,0.03,125,80,0.02,130,34,32,6.25
1967,Togo,32,0.01,125,45,0.02,132,77,0.02,131,13,11,18.18
1967,Central African Republic,29,0.01,130,44,0.02,134,73,0.02,132,15,4,275.0
1967,Haiti,34,0.02,124,36,0.02,138,70,0.02,133,2,2,0.0
1967,Equatorial Guinea,36,0.02,121,32,0.01,143,68,0.02,134,-4,-2,100.0
1967,"Macao, China",25,0.01,134,43,0.02,135,68,0.02,134,18,27,-33.33
1967,Benin,15,0.01,138,48,0.02,129,63,0.01,136,33,23,43.48
1967,Greenland,13,0.01,142,46,0.02,130,59,0.01,137,33,23,43.48
1967,Burkina Faso,18,0.01,136,36,0.02,138,54,0.01,138,18,22,-18.18
1967,Lao People's Democratic Republic,4,0.0,157,49,0.02,127,53,0.01,139,45,41,9.76
1967,French Guiana,4,0.0,157,42,0.02,136,46,0.01,140,38,25,52.0
1967,Mali,11,0.01,146,34,0.01,141,45,0.01,141,23,23,0.0
1967,Botswana,13,0.01,142,31,0.01,144,44,0.01,142,18,11,63.64
1967,Belize,14,0.01,139,26,0.01,145,40,0.01,143,12,14,-14.29
1967,Lesotho,6,0.0,153,33,0.01,142,39,0.01,144,27,26,3.85
1967,Yemen,4,0.0,157,35,0.02,140,39,0.01,144,31,24,29.17
1967,The Gambia,18,0.01,136,19,0.01,149,37,0.01,146,1,2,-50.0
1967,Oman,26,0.01,133,10,0.0,155,36,0.01,147,-16,8,-300.0
1967,Burundi,14,0.01,139,20,0.01,147,34,0.01,148,6,10,-40.0
1967,Rwanda,14,0.01,139,20,0.01,147,34,0.01,148,6,9,-33.33
1967,American Samoa,27,0.01,131,4,0.0,167,31,0.01,150,-23,-14,64.29
1967,Antigua and Barbuda,1,0.0,168,23,0.01,146,24,0.01,151,22,26,-15.38
1967,Saint Lucia,7,0.0,151,17,0.01,150,24,0.01,151,10,10,0.0
1967,Vanuatu,12,0.01,145,10,0.0,155,22,0.0,153,-2,-2,0.0
1967,Guinea-Bissau,4,0.0,157,16,0.01,151,20,0.0,154,12,12,0.0
1967,Grenada,5,0.0,156,14,0.01,152,19,0.0,155,9,7,28.57
1967,Saint Kitts and Nevis,9,0.0,148,9,0.0,158,18,0.0,156,0,0,
1967,Solomon Islands,6,0.0,153,11,0.0,154,17,0.0,157,5,7,-28.57
1967,Dominica,6,0.0,153,10,0.0,155,16,0.0,158,4,4,0.0
1967,Sao Tomé and Principe,8,0.0,149,5,0.0,165,13,0.0,159,-3,0,
1967,Saint Vincent and the Grenadines,4,0.0,157,9,0.0,158,13,0.0,159,5,5,0.0
1967,Samoa,4,0.0,157,8,0.0,160,12,0.0,161,4,3,33.33
1967,Montserrat,0,0.0,171,12,0.01,153,12,0.0,161,12,9,33.33
1967,Comoros,4,0.0,157,7,0.0,162,11,0.0,163,3,3,0.0
1967,Kiribati,7,0.0,151,4,0.0,167,11,0.0,163,-3,-2,50.0
1967,Tonga,4,0.0,157,6,0.0,164,10,0.0,165,2,1,100.0
1967,Saint Pierre and Miquelon,1,0.0,168,8,0.0,160,9,0.0,166,7,5,40.0
1967,Cabo Verde,1,0.0,168,7,0.0,162,8,0.0,167,6,5,20.0
1967,Guam,8,0.0,149,0,0.0,171,8,0.0,167,-8,-7,14.29
1967,Seychelles,2,0.0,166,5,0.0,165,7,0.0,169,3,2,50.0
1967,Maldives,3,0.0,165,3,0.0,170,6,0.0,170,0,0,
1967,Cook Islands,2,0.0,166,4,0.0,167,6,0.0,170,2,2,0.0
1966,United States of America,29379,14.22,1,27745,12.75,1,57124,13.47,1,-1634,-3511,-53.46
1966,Germany,20157,9.76,2,18167,8.35,2,38324,9.03,2,-1990,-301,561.13
1966,United Kingdom,14770,7.15,3,16663,7.66,3,31433,7.41,3,1893,2318,-18.33
1966,France,10982,5.32,4,11859,5.45,4,22841,5.38,4,877,208,321.63
1966,Canada,10005,4.84,5,10062,4.62,5,20067,4.73,5,57,149,-61.74
1966,Japan,9776,4.73,6,9523,4.38,7,19299,4.55,6,-253,-282,-10.28
1966,Netherlands,7771,3.76,9,9540,4.38,6,17311,4.08,7,1769,1582,11.82
1966,U.S.S.R.,8841,4.28,7,7913,3.64,9,16754,3.95,8,-928,-117,693.16
1966,Italy,8038,3.89,8,8590,3.95,8,16628,3.92,9,552,180,206.67
1966,Belgium-Luxembourg,6832,3.31,10,7182,3.3,10,14014,3.3,10,350,108,224.07
1966,Sweden,4266,2.07,11,4582,2.11,11,8848,2.09,11,316,406,-22.17
1966,Switzerland,3248,1.57,12,3888,1.79,12,7136,1.68,12,640,702,-8.83
1966,Australia,3171,1.54,14,3612,1.66,13,6783,1.6,13,441,757,-41.74
1966,German Democratic Republic,3205,1.55,13,3215,1.48,16,6420,1.51,14,10,-260,-103.85
1966,Czech and Slovak Federal Republic,2745,1.33,15,2736,1.26,18,5481,1.29,15,-9,-16,-43.75
1966,Denmark,2453,1.19,18,3003,1.38,17,5456,1.29,16,550,503,9.34
1966,India,1954,0.95,21,3440,1.58,15,5394,1.27,17,1486,1151,29.11
1966,China,2681,1.3,17,2482,1.14,20,5163,1.22,18,-199,-317,-37.22
1966,South Africa,2741,1.33,16,2395,1.1,22,5136,1.21,19,-346,16,-2262.5
1966,Spain,1254,0.61,34,3591,1.65,14,4845,1.14,20,2337,2105,11.02
1966,Poland,2272,1.1,20,2494,1.15,19,4766,1.12,21,222,112,98.21
1966,Austria,1684,0.82,23,2328,1.07,23,4012,0.95,22,644,501,28.54
1966,Norway,1564,0.76,27,2404,1.1,21,3968,0.94,23,840,767,9.52
1966,"Venezuela, Bolivarian Republic of",2373,1.15,19,1307,0.6,33,3680,0.87,24,-1066,-1034,3.09
1966,Brazil,1741,0.84,22,1496,0.69,29,3237,0.76,25,-245,-500,-51.0
1966,Finland,1505,0.73,28,1726,0.79,25,3231,0.76,26,221,219,0.91
1966,Hungary,1594,0.77,25,1566,0.72,28,3160,0.74,27,-28,11,-354.55
1966,"Hong Kong, China",1324,0.64,30,1767,0.81,24,3091,0.73,28,443,426,3.99
1966,Mexico,1199,0.58,36,1605,0.74,26,2804,0.66,29,406,415,-2.17
1966,"Yugoslavia, Socialist Federal Republic of",1220,0.59,35,1575,0.72,27,2795,0.66,30,355,196,81.12
1966,Bulgaria,1305,0.63,32,1479,0.68,30,2784,0.66,31,174,2,8600.0
1966,Argentina,1593,0.77,26,1124,0.52,35,2717,0.64,32,-469,-294,59.52
1966,Romania,1186,0.57,37,1310,0.6,32,2496,0.59,33,124,61,103.28
1966,Singapore,1102,0.53,38,1328,0.61,31,2430,0.57,34,226,262,-13.74
1966,Malaysia,1256,0.61,33,1104,0.51,36,2360,0.56,35,-152,-140,8.57
1966,"Saudi Arabia, Kingdom of",1651,0.8,24,592,0.27,57,2243,0.53,36,-1059,-890,18.99
1966,Iran,1310,0.63,31,931,0.43,42,2241,0.53,37,-379,-446,-15.02
1966,New Zealand,1076,0.52,39,1095,0.5,37,2171,0.51,38,19,45,-57.78
1966,"Kuwait, the State of",1342,0.65,29,463,0.21,61,1805,0.43,39,-879,-907,-3.09
1966,Philippines,826,0.4,42,959,0.44,41,1785,0.42,40,133,196,-32.14
1966,Ireland,684,0.33,47,1043,0.48,39,1727,0.41,41,359,423,-15.13
1966,Chile,817,0.4,43,892,0.41,45,1709,0.4,42,75,81,-7.41
1966,Egypt,605,0.29,53,1071,0.49,38,1676,0.4,43,466,329,41.64
1966,Portugal,627,0.3,51,1013,0.47,40,1640,0.39,44,386,313,23.32
1966,Greece,406,0.2,63,1223,0.56,34,1629,0.38,45,817,806,1.36
1966,Peru,764,0.37,45,829,0.38,48,1593,0.38,46,65,63,3.17
1966,Thailand,678,0.33,49,890,0.41,46,1568,0.37,47,212,120,76.67
1966,Pakistan,634,0.31,50,916,0.42,44,1550,0.37,48,282,418,-32.54
1966,Cuba,593,0.29,54,926,0.43,43,1519,0.36,49,333,180,85.0
1966,Nigeria,796,0.39,44,718,0.33,50,1514,0.36,50,-78,21,-471.43
1966,Iraq,934,0.45,41,493,0.23,59,1427,0.34,51,-441,-427,3.28
1966,Libya,995,0.48,40,405,0.19,63,1400,0.33,52,-590,-470,25.53
1966,Israel,503,0.24,58,833,0.38,47,1336,0.31,53,330,408,-19.12
1966,Netherlands Antilles,592,0.29,55,722,0.33,49,1314,0.31,54,130,118,10.17
1966,Algeria,621,0.3,52,643,0.3,54,1264,0.3,55,22,34,-35.29
1966,Türkiye,491,0.24,59,718,0.33,50,1209,0.29,56,227,108,110.19
1966,Indonesia,679,0.33,48,527,0.24,58,1206,0.28,57,-152,-13,1069.23
1966,Colombia,507,0.25,57,675,0.31,53,1182,0.28,58,168,-84,-300.0
1966,Chinese Taipei,537,0.26,56,622,0.29,55,1159,0.27,59,85,107,-20.56
1966,Zambia,691,0.33,46,345,0.16,67,1036,0.24,60,-346,-228,51.75
1966,"Korea, Republic of",251,0.12,70,716,0.33,52,967,0.23,61,465,290,60.34
1966,Morocco,428,0.21,61,478,0.22,60,906,0.21,62,50,23,117.39
1966,Trinidad and Tobago,429,0.21,60,454,0.21,62,883,0.21,63,25,68,-63.24
1966,Sri Lanka,357,0.17,64,400,0.18,64,757,0.18,64,43,-99,-143.43
1966,Lebanese Republic,103,0.05,98,611,0.28,56,714,0.17,65,508,461,10.2
1966,Ghana,268,0.13,67,352,0.16,65,620,0.15,66,84,130,-35.38
1966,Kenya,260,0.13,69,346,0.16,66,606,0.14,67,86,54,59.26
1966,Côte d'Ivoire,311,0.15,65,254,0.12,73,565,0.13,68,-57,-41,39.02
1966,Jamaica,228,0.11,72,327,0.15,68,555,0.13,69,99,75,32.0
1966,Zimbabwe,280,0.14,66,273,0.13,72,553,0.13,70,-7,-66,-89.39
1966,Democratic Republic of the Congo,424,0.21,62,104,0.05,109,528,0.12,71,-320,-209,53.11
1966,Tanzania,265,0.13,68,237,0.11,75,502,0.12,72,-28,-10,180.0
1966,United Arab Emirates,241,0.12,71,237,0.11,75,478,0.11,73,-4,35,-111.43
1966,"Yemen, People's Democratic Republic",192,0.09,78,285,0.13,71,477,0.11,74,93,116,-19.83
1966,Syrian Arab Republic,173,0.08,83,289,0.13,69,462,0.11,75,116,44,163.64
1966,Guatemala,226,0.11,73,207,0.1,81,433,0.1,76,-19,43,-144.19
1966,Angola,221,0.11,74,207,0.1,81,428,0.1,77,-14,-5,180.0
1966,Sudan,203,0.1,76,222,0.1,78,425,0.1,78,19,13,46.15
1966,El Salvador,189,0.09,79,221,0.1,79,410,0.1,79,32,12,166.67
1966,Tunisia,140,0.07,89,250,0.11,74,390,0.09,80,110,126,-12.7
1966,Uganda,217,0.11,75,166,0.08,90,383,0.09,81,-51,-45,13.33
1966,"Bahrain, Kingdom of",187,0.09,80,176,0.08,87,363,0.09,82,-11,3,-466.67
1966,Myanmar,194,0.09,77,158,0.07,95,352,0.08,83,-36,22,-263.64
1966,Uruguay,186,0.09,81,164,0.08,91,350,0.08,84,-22,-40,-45.0
1966,Ecuador,155,0.08,84,174,0.08,88,329,0.08,85,19,1,1800.0
1966,Nicaragua,142,0.07,88,182,0.08,84,324,0.08,86,40,11,263.64
1966,Mozambique,112,0.05,95,208,0.1,80,320,0.08,87,96,65,47.69
1966,Dominican Republic,137,0.07,91,181,0.08,85,318,0.07,88,44,-29,-251.72
1966,Costa Rica,136,0.07,92,179,0.08,86,315,0.07,89,43,66,-34.85
1966,Senegal,150,0.07,85,160,0.07,93,310,0.07,90,10,33,-69.7
1966,Panama,71,0.03,106,235,0.11,77,306,0.07,91,164,146,12.33
1966,Viet Nam,15,0.01,138,286,0.13,70,301,0.07,92,271,187,44.92
1966,Iceland,140,0.07,89,159,0.07,94,299,0.07,93,19,8,137.5
1966,Honduras,143,0.07,87,149,0.07,97,292,0.07,94,6,-5,-220.0
1966,Ethiopia,111,0.05,96,162,0.07,92,273,0.06,95,51,34,50.0
1966,"Bolivia, Plurinational State of",127,0.06,94,138,0.06,101,265,0.06,96,11,5,120.0
1966,Liberia,150,0.07,85,114,0.05,105,264,0.06,97,-36,-30,20.0
1966,Cameroon,131,0.06,93,131,0.06,102,262,0.06,98,0,-10,-100.0
1966,Qatar,180,0.09,82,70,0.03,117,250,0.06,99,-110,-93,18.28
1966,Madagascar,98,0.05,100,146,0.07,99,244,0.06,100,48,46,4.35
1966,Cyprus,82,0.04,103,155,0.07,96,237,0.06,101,73,73,0.0
1966,Guyana,109,0.05,97,118,0.05,104,227,0.05,102,9,7,28.57
1966,Jordan,29,0.01,129,191,0.09,83,220,0.05,103,162,129,25.58
1966,Papua New Guinea,57,0.03,112,149,0.07,97,206,0.05,104,92,64,43.75
1966,Afghanistan,67,0.03,109,128,0.06,103,195,0.05,105,61,47,29.79
1966,French Polynesia,17,0.01,135,167,0.08,89,184,0.04,106,150,97,54.64
1966,Sierra Leone,83,0.04,102,100,0.05,110,183,0.04,107,17,20,-15.0
1966,Cambodia,67,0.03,109,111,0.05,106,178,0.04,108,44,-2,-2300.0
1966,Suriname,87,0.04,101,90,0.04,113,177,0.04,109,3,35,-91.43
1966,Gabon,101,0.05,99,66,0.03,122,167,0.04,110,-35,-43,-18.6
1966,Bahamas,23,0.01,133,139,0.06,100,162,0.04,111,116,86,34.88
1966,New Caledonia,78,0.04,104,67,0.03,121,145,0.03,112,-11,12,-191.67
1966,Reunion,39,0.02,121,105,0.05,108,144,0.03,113,66,64,3.13
1966,Mauritius,71,0.03,106,70,0.03,117,141,0.03,114,-1,11,-109.09
1966,Malta,30,0.01,127,109,0.05,107,139,0.03,115,79,74,6.76
1966,Martinique,45,0.02,118,93,0.04,111,138,0.03,116,48,53,-9.43
1966,Guadeloupe,35,0.02,124,93,0.04,111,128,0.03,117,58,47,23.4
1966,Guinea,58,0.03,111,70,0.03,117,128,0.03,117,12,-1,-1300.0
1966,Nepal,51,0.02,115,75,0.03,115,126,0.03,119,24,51,-52.94
1966,Brunei Darussalam,74,0.04,105,51,0.02,126,125,0.03,120,-23,-29,-20.69
1966,Fiji,57,0.03,112,64,0.03,123,121,0.03,121,7,11,-36.36
1966,Malawi,49,0.02,116,70,0.03,117,119,0.03,122,21,36,-41.67
1966,Barbados,41,0.02,120,76,0.03,114,117,0.03,123,35,31,12.9
1966,Congo,43,0.02,119,72,0.03,116,115,0.03,124,29,20,45.0
1966,Paraguay,49,0.02,116,59,0.03,124,108,0.03,125,10,-1,-1100.0
1966,Mauritania,69,0.03,108,23,0.01,146,92,0.02,126,-46,-34,35.29
1966,Eswatini,54,0.03,114,34,0.02,136,88,0.02,127,-20,-6,233.33
1966,Djibouti,27,0.01,130,59,0.03,124,86,0.02,128,32,33,-3.03
1966,Togo,36,0.02,122,47,0.02,128,83,0.02,129,11,18,-38.89
1966,Niger,35,0.02,124,45,0.02,129,80,0.02,130,10,13,-23.08
1966,"Macao, China",24,0.01,131,51,0.02,126,75,0.02,131,27,26,3.85
1966,Haiti,36,0.02,122,38,0.02,131,74,0.02,132,2,-3,-166.67
1966,Central African Republic,31,0.02,126,35,0.02,135,66,0.02,133,4,1,300.0
1966,Equatorial Guinea,30,0.01,127,28,0.01,140,58,0.01,134,-2,-1,100.0
1966,Chad,24,0.01,131,32,0.01,138,56,0.01,135,8,4,100.0
1966,Burkina Faso,16,0.01,136,38,0.02,131,54,0.01,136,22,22,0.0
1966,Greenland,15,0.01,138,38,0.02,131,53,0.01,137,23,21,9.52
1966,Mali,13,0.01,141,36,0.02,134,49,0.01,138,23,27,-14.81
1966,Benin,10,0.0,144,33,0.02,137,43,0.01,139,23,20,15.0
1966,Lao People's Democratic Republic,1,0.0,168,42,0.02,130,43,0.01,139,41,32,28.13
1966,Botswana,15,0.01,138,26,0.01,144,41,0.01,141,11,9,22.22
1966,Belize,13,0.01,141,27,0.01,142,40,0.01,142,14,12,16.67
1966,Lesotho,6,0.0,150,32,0.01,138,38,0.01,143,26,18,44.44
1966,The Gambia,16,0.01,136,18,0.01,149,34,0.01,144,2,2,0.0
1966,Rwanda,12,0.01,143,21,0.01,147,33,0.01,145,9,4,125.0
1966,French Guiana,3,0.0,160,28,0.01,140,31,0.01,146,25,17,47.06
1966,Yemen,3,0.0,160,27,0.01,142,30,0.01,147,24,14,71.43
1966,Burundi,10,0.0,144,20,0.01,148,30,0.01,147,10,9,11.11
1966,Antigua and Barbuda,0,0.0,171,26,0.01,144,26,0.01,149,26,18,44.44
1966,American Samoa,20,0.01,134,6,0.0,163,26,0.01,149,-14,-5,180.0
1966,Saint Lucia,7,0.0,148,17,0.01,150,24,0.01,151,10,6,66.67
1966,Grenada,6,0.0,150,13,0.01,152,19,0.0,152,7,5,40.0
1966,Vanuatu,10,0.0,144,8,0.0,159,18,0.0,153,-2,-2,0.0
1966,Guinea-Bissau,3,0.0,160,15,0.01,151,18,0.0,153,12,11,9.09
1966,Saint Kitts and Nevis,9,0.0,147,9,0.0,157,18,0.0,153,0,0,
1966,Dominica,6,0.0,150,10,0.0,154,16,0.0,156,4,4,0.0
1966,Solomon Islands,4,0.0,156,11,0.01,153,15,0.0,157,7,3,133.33
1966,Saint Vincent and the Grenadines,4,0.0,156,9,0.0,157,13,0.0,158,5,5,0.0
1966,Samoa,5,0.0,154,8,0.0,159,13,0.0,158,3,3,0.0
1966,Sao Tomé and Principe,6,0.0,150,6,0.0,163,12,0.0,160,0,0,
1966,Oman,2,0.0,163,10,0.0,154,12,0.0,160,8,7,14.29
1966,Comoros,4,0.0,156,7,0.0,161,11,0.0,162,3,3,0.0
1966,Montserrat,1,0.0,168,10,0.0,154,11,0.0,162,9,8,12.5
1966,Tonga,4,0.0,156,5,0.0,166,9,0.0,164,1,1,0.0
1966,Saint Pierre and Miquelon,2,0.0,163,7,0.0,161,9,0.0,164,5,5,0.0
1966,Kiribati,5,0.0,154,3,0.0,169,8,0.0,166,-2,0,
1966,Cabo Verde,1,0.0,168,6,0.0,163,7,0.0,167,5,5,0.0
1966,Guam,7,0.0,148,0,0.0,171,7,0.0,167,-7,-8,-12.5
1966,Seychelles,2,0.0,163,4,0.0,167,6,0.0,169,2,0,
1966,Cook Islands,2,0.0,163,4,0.0,167,6,0.0,169,2,1,100.0
1966,Maldives,2,0.0,163,2,0.0,170,4,0.0,171,0,0,
1965,United States of America,26699,14.1,1,23188,11.67,1,49887,12.86,1,-3511,-5384,-34.79
1965,Germany,17913,9.46,2,17612,8.86,2,35525,9.16,2,-301,-1520,-80.2
1965,United Kingdom,13810,7.29,3,16128,8.12,3,29938,7.72,3,2318,3086,-24.89
1965,France,10176,5.37,4,10384,5.23,4,20560,5.3,4,208,995,-79.1
1965,Canada,8473,4.47,5,8622,4.34,6,17095,4.41,5,149,-635,-123.46
1965,Japan,8451,4.46,6,8169,4.11,7,16620,4.28,6,-282,1265,-122.29
1965,Netherlands,7343,3.88,8,8925,4.49,5,16268,4.19,7,1582,1720,-8.02
1965,U.S.S.R.,8175,4.32,7,8058,4.06,8,16233,4.18,8,-117,53,-320.75
1965,Italy,7198,3.8,9,7378,3.71,9,14576,3.76,9,180,1292,-86.07
1965,Belgium-Luxembourg,6394,3.38,10,6502,3.27,10,12896,3.32,10,108,330,-67.27
1965,Sweden,3971,2.1,11,4377,2.2,11,8348,2.15,11,406,181,124.31
1965,Australia,3005,1.59,13,3762,1.89,12,6767,1.74,12,757,265,185.66
1965,Switzerland,2941,1.55,14,3643,1.83,13,6584,1.7,13,702,933,-24.76
1965,German Democratic Republic,3070,1.62,12,2810,1.41,17,5880,1.52,14,-260,-298,-12.75
1965,Czech and Slovak Federal Republic,2689,1.42,15,2673,1.35,18,5362,1.38,15,-16,-147,-89.12
1965,Denmark,2320,1.23,19,2823,1.42,16,5143,1.33,16,503,510,-1.37
1965,South Africa,2547,1.35,17,2563,1.29,19,5110,1.32,17,16,-198,-108.08
1965,China,2563,1.35,16,2246,1.13,21,4809,1.24,18,-317,-540,-41.3
1965,Poland,2228,1.18,20,2340,1.18,20,4568,1.18,19,112,-25,-548.0
1965,India,1687,0.89,21,2838,1.43,15,4525,1.17,20,1151,1171,-1.71
1965,Spain,935,0.49,39,3040,1.53,14,3975,1.02,21,2105,1335,57.68
1965,"Venezuela, Bolivarian Republic of",2455,1.3,18,1421,0.72,28,3876,1.0,22,-1034,-1223,-15.45
1965,Austria,1600,0.85,22,2101,1.06,23,3701,0.95,23,501,417,20.14
1965,Norway,1443,0.76,26,2210,1.11,22,3653,0.94,24,767,693,10.68
1965,Finland,1427,0.75,27,1646,0.83,24,3073,0.79,25,219,214,2.34
1965,Hungary,1510,0.8,24,1521,0.77,27,3031,0.78,26,11,143,-92.31
1965,"Hong Kong, China",1143,0.6,34,1569,0.79,25,2712,0.7,27,426,484,-11.98
1965,Mexico,1145,0.6,33,1560,0.79,26,2705,0.7,28,415,439,-5.47
1965,Argentina,1493,0.79,25,1199,0.6,31,2692,0.69,29,-294,-333,-11.71
1965,Brazil,1596,0.84,23,1096,0.55,35,2692,0.69,29,-500,-167,199.4
1965,"Yugoslavia, Socialist Federal Republic of",1092,0.58,36,1288,0.65,29,2380,0.61,31,196,430,-54.42
1965,Bulgaria,1176,0.62,32,1178,0.59,32,2354,0.61,32,2,82,-97.56
1965,Malaysia,1236,0.65,31,1096,0.55,35,2332,0.6,33,-140,-58,141.38
1965,Romania,1102,0.58,35,1163,0.59,33,2265,0.58,34,61,262,-76.72
1965,Singapore,981,0.52,38,1243,0.63,30,2224,0.57,35,262,231,13.42
1965,Iran,1305,0.69,29,859,0.43,44,2164,0.56,36,-446,-579,-22.97
1965,New Zealand,1007,0.53,37,1052,0.53,37,2059,0.53,37,45,-113,-139.82
1965,"Saudi Arabia, Kingdom of",1396,0.74,28,506,0.25,56,1902,0.49,38,-890,-793,12.23
1965,"Kuwait, the State of",1284,0.68,30,377,0.19,64,1661,0.43,39,-907,-929,-2.37
1965,Ireland,618,0.33,50,1041,0.52,38,1659,0.43,40,423,425,-0.47
1965,Philippines,698,0.37,44,894,0.45,42,1592,0.41,41,196,203,-3.45
1965,Cuba,686,0.36,45,866,0.44,43,1552,0.4,42,180,305,-40.98
1965,Egypt,605,0.32,51,934,0.47,40,1539,0.4,43,329,414,-20.53
1965,Nigeria,749,0.4,42,770,0.39,46,1519,0.39,44,21,110,-80.91
1965,Pakistan,550,0.29,54,968,0.49,39,1518,0.39,45,418,601,-30.45
1965,Portugal,584,0.31,53,897,0.45,41,1481,0.38,46,313,260,20.38
1965,Greece,328,0.17,64,1134,0.57,34,1462,0.38,47,806,576,39.93
1965,Indonesia,708,0.37,43,695,0.35,51,1403,0.36,48,-13,-44,-70.45
1965,Peru,667,0.35,46,730,0.37,48,1397,0.36,49,63,-88,-171.59
1965,Thailand,622,0.33,49,742,0.37,47,1364,0.35,50,120,92,30.43
1965,Chile,637,0.34,47,718,0.36,50,1355,0.35,51,81,131,-38.17
1965,Iraq,882,0.47,40,455,0.23,59,1337,0.34,52,-427,-427,0.0
1965,Netherlands Antilles,603,0.32,52,721,0.36,49,1324,0.34,53,118,128,-7.81
1965,Algeria,637,0.34,47,671,0.34,52,1308,0.34,54,34,-24,-241.67
1965,Israel,430,0.23,60,838,0.42,45,1268,0.33,55,408,467,-12.63
1965,Libya,790,0.42,41,320,0.16,65,1110,0.29,56,-470,-408,15.2
1965,Türkiye,464,0.25,57,572,0.29,53,1036,0.27,57,108,126,-14.29
1965,Chinese Taipei,450,0.24,59,557,0.28,54,1007,0.26,58,107,-4,-2775.0
1965,Colombia,538,0.28,55,454,0.23,60,992,0.26,59,-84,38,-321.05
1965,Morocco,430,0.23,60,453,0.23,61,883,0.23,60,23,30,-23.33
1965,Trinidad and Tobago,403,0.21,63,471,0.24,57,874,0.23,61,68,18,277.78
1965,Zimbabwe,452,0.24,58,386,0.19,63,838,0.22,62,-66,-36,83.33
1965,Zambia,527,0.28,56,299,0.15,68,826,0.21,63,-228,-251,-9.16
1965,Ghana,318,0.17,65,448,0.23,62,766,0.2,64,130,19,584.21
1965,Sri Lanka,409,0.22,62,310,0.16,66,719,0.19,65,-99,21,-571.43
1965,"Korea, Republic of",173,0.09,80,463,0.23,58,636,0.16,66,290,286,1.4
1965,Lebanese Republic,87,0.05,102,548,0.28,55,635,0.16,67,461,447,3.13
1965,Côte d'Ivoire,277,0.15,67,236,0.12,73,513,0.13,68,-41,-61,-32.79
1965,Kenya,228,0.12,68,282,0.14,70,510,0.13,69,54,24,125.0
1965,Jamaica,214,0.11,70,289,0.15,69,503,0.13,70,75,73,2.74
1965,"Yemen, People's Democratic Republic",185,0.1,79,301,0.15,67,486,0.13,71,116,91,27.47
1965,Myanmar,225,0.12,69,247,0.12,71,472,0.12,72,22,38,-42.11
1965,Guatemala,186,0.1,78,229,0.12,74,415,0.11,73,43,37,16.22
1965,United Arab Emirates,190,0.1,76,225,0.11,75,415,0.11,73,35,80,-56.25
1965,Tanzania,207,0.11,71,197,0.1,81,404,0.1,75,-10,-48,-79.17
1965,Democratic Republic of the Congo,306,0.16,66,97,0.05,110,403,0.1,76,-209,-231,-9.52
1965,Sudan,195,0.1,74,208,0.1,77,403,0.1,76,13,77,-83.12
1965,Angola,200,0.11,73,195,0.1,82,395,0.1,78,-5,-40,-87.5
1965,El Salvador,189,0.1,77,201,0.1,80,390,0.1,79,12,13,-7.69
1965,Syrian Arab Republic,169,0.09,81,213,0.11,76,382,0.1,80,44,60,-26.67
1965,Uganda,206,0.11,72,161,0.08,88,367,0.09,81,-45,-83,-45.78
1965,Tunisia,120,0.06,93,246,0.12,72,366,0.09,82,126,118,6.78
1965,Uruguay,191,0.1,75,151,0.08,91,342,0.09,83,-40,19,-310.53
1965,"Bahrain, Kingdom of",165,0.09,82,168,0.08,85,333,0.09,84,3,4,-25.0
1965,Ecuador,164,0.09,83,165,0.08,86,329,0.08,85,1,7,-85.71
1965,Nicaragua,149,0.08,85,160,0.08,89,309,0.08,86,11,12,-8.33
1965,Senegal,130,0.07,88,163,0.08,87,293,0.08,87,33,44,-25.0
1965,Costa Rica,112,0.06,95,178,0.09,83,290,0.07,88,66,25,164.0
1965,Mozambique,108,0.06,96,173,0.09,84,281,0.07,89,65,50,30.0
1965,Cameroon,144,0.08,86,134,0.07,96,278,0.07,90,-10,-9,11.11
1965,Panama,62,0.03,108,208,0.1,77,270,0.07,91,146,128,14.06
1965,Iceland,129,0.07,89,137,0.07,95,266,0.07,92,8,20,-60.0
1965,Ethiopia,116,0.06,94,150,0.08,92,266,0.07,92,34,18,88.89
1965,"Bolivia, Plurinational State of",129,0.07,89,134,0.07,96,263,0.07,94,5,7,-28.57
1965,Honduras,127,0.07,91,122,0.06,99,249,0.06,95,-5,7,-171.43
1965,Liberia,135,0.07,87,105,0.05,104,240,0.06,96,-30,-15,100.0
1965,Qatar,163,0.09,84,70,0.04,119,233,0.06,97,-93,-101,-7.92
1965,Madagascar,92,0.05,100,138,0.07,94,230,0.06,98,46,44,4.55
1965,Viet Nam,21,0.01,132,208,0.1,77,229,0.06,99,187,146,28.08
1965,Dominican Republic,126,0.07,92,97,0.05,110,223,0.06,100,-29,42,-169.05
1965,Cyprus,71,0.04,104,144,0.07,93,215,0.06,101,73,47,55.32
1965,Cambodia,105,0.06,97,103,0.05,107,208,0.05,102,-2,-6,-66.67
1965,Guyana,97,0.05,99,104,0.05,106,201,0.05,103,7,-8,-187.5
1965,Sierra Leone,88,0.05,101,108,0.05,101,196,0.05,104,20,4,400.0
1965,Afghanistan,74,0.04,103,121,0.06,100,195,0.05,105,47,60,-21.67
1965,Jordan,28,0.01,124,157,0.08,90,185,0.05,106,129,126,2.38
1965,Papua New Guinea,59,0.03,110,123,0.06,98,182,0.05,107,64,46,39.13
1965,Gabon,105,0.06,97,62,0.03,122,167,0.04,108,-43,-39,10.26
1965,Nepal,57,0.03,113,108,0.05,101,165,0.04,109,51,55,-7.27
1965,Suriname,58,0.03,111,93,0.05,112,151,0.04,110,35,33,6.06
1965,Mauritius,66,0.03,105,77,0.04,115,143,0.04,111,11,5,120.0
1965,New Caledonia,65,0.03,106,77,0.04,115,142,0.04,112,12,-8,-250.0
1965,Fiji,62,0.03,108,73,0.04,118,135,0.03,113,11,-3,-466.67
1965,Reunion,34,0.02,123,98,0.05,108,132,0.03,114,64,54,18.52
1965,Martinique,38,0.02,119,91,0.05,113,129,0.03,115,53,50,6.0
1965,Bahamas,19,0.01,134,105,0.05,104,124,0.03,116,86,84,2.38
1965,Guadeloupe,38,0.02,119,85,0.04,114,123,0.03,117,47,44,6.82
1965,Malta,24,0.01,131,98,0.05,108,122,0.03,118,74,78,-5.13
1965,French Polynesia,10,0.01,144,107,0.05,103,117,0.03,119,97,60,61.67
1965,Malawi,40,0.02,118,76,0.04,117,116,0.03,120,36,22,63.64
1965,Congo,47,0.02,116,67,0.03,121,114,0.03,121,20,20,0.0
1965,Paraguay,56,0.03,114,55,0.03,124,111,0.03,122,-1,-9,-88.89
1965,Guinea,54,0.03,115,53,0.03,125,107,0.03,123,-1,6,-116.67
1965,Barbados,37,0.02,121,68,0.03,120,105,0.03,124,31,29,6.9
1965,Brunei Darussalam,65,0.03,106,36,0.02,132,101,0.03,125,-29,-30,-3.33
1965,Djibouti,28,0.01,124,61,0.03,123,89,0.02,126,33,17,94.12
1965,Mauritania,58,0.03,111,24,0.01,141,82,0.02,127,-34,-30,13.33
1965,Eswatini,43,0.02,117,37,0.02,130,80,0.02,128,-6,-5,20.0
1965,Togo,27,0.01,126,45,0.02,127,72,0.02,129,18,12,50.0
1965,Haiti,37,0.02,121,34,0.02,133,71,0.02,130,-3,1,-400.0
1965,"Macao, China",21,0.01,132,47,0.02,126,68,0.02,131,26,26,0.0
1965,Niger,25,0.01,130,38,0.02,129,63,0.02,132,13,15,-13.33
1965,Mali,16,0.01,135,43,0.02,128,59,0.02,133,27,20,35.0
1965,Chad,27,0.01,126,31,0.02,137,58,0.01,134,4,8,-50.0
1965,Central African Republic,26,0.01,129,27,0.01,138,53,0.01,135,1,1,0.0
1965,Equatorial Guinea,27,0.01,126,26,0.01,139,53,0.01,135,-1,-10,-90.0
1965,Burkina Faso,15,0.01,136,37,0.02,130,52,0.01,137,22,28,-21.43
1965,Benin,14,0.01,138,34,0.02,133,48,0.01,138,20,18,11.11
1965,Greenland,13,0.01,142,34,0.02,133,47,0.01,139,21,19,10.53
1965,Botswana,14,0.01,138,23,0.01,143,37,0.01,140,9,1,800.0
1965,Belize,12,0.01,143,24,0.01,141,36,0.01,141,12,9,33.33
1965,Lao People's Democratic Republic,1,0.0,167,33,0.02,136,34,0.01,142,32,25,28.0
1965,Lesotho,7,0.0,149,25,0.01,140,32,0.01,143,18,18,0.0
1965,Rwanda,14,0.01,138,18,0.01,147,32,0.01,143,4,0,
1965,The Gambia,14,0.01,138,16,0.01,149,30,0.01,145,2,3,-33.33
1965,Burundi,9,0.0,145,18,0.01,147,27,0.01,146,9,8,12.5
1965,American Samoa,15,0.01,136,10,0.01,153,25,0.01,147,-5,-3,66.67
1965,Yemen,5,0.0,154,19,0.01,145,24,0.01,148,14,17,-17.65
1965,French Guiana,3,0.0,161,20,0.01,144,23,0.01,149,17,15,13.33
1965,Antigua and Barbuda,1,0.0,167,19,0.01,145,20,0.01,150,18,11,63.64
1965,Saint Lucia,7,0.0,149,13,0.01,151,20,0.01,150,6,6,0.0
1965,Guinea-Bissau,4,0.0,157,15,0.01,150,19,0.0,152,11,9,22.22
1965,Saint Kitts and Nevis,9,0.0,145,9,0.0,155,18,0.0,153,0,-2,-100.0
1965,Grenada,6,0.0,151,11,0.01,152,17,0.0,154,5,6,-16.67
1965,Vanuatu,9,0.0,145,7,0.0,161,16,0.0,155,-2,-2,0.0
1965,Dominica,6,0.0,151,10,0.01,153,16,0.0,155,4,4,0.0
1965,Samoa,6,0.0,151,9,0.0,155,15,0.0,157,3,3,0.0
1965,Saint Vincent and the Grenadines,4,0.0,157,9,0.0,155,13,0.0,158,5,5,0.0
1965,Solomon Islands,5,0.0,154,8,0.0,159,13,0.0,158,3,2,50.0
1965,Comoros,4,0.0,157,7,0.0,161,11,0.0,160,3,2,50.0
1965,Oman,2,0.0,164,9,0.0,155,11,0.0,160,7,4,75.0
1965,Sao Tomé and Principe,5,0.0,154,5,0.0,165,10,0.0,162,0,-1,-100.0
1965,Guam,8,0.0,148,0,0.0,171,8,0.0,163,-8,-7,14.29
1965,Kiribati,4,0.0,157,4,0.0,166,8,0.0,163,0,1,-100.0
1965,Montserrat,0,0.0,171,8,0.0,159,8,0.0,163,8,6,33.33
1965,Cabo Verde,1,0.0,167,6,0.0,163,7,0.0,166,5,6,-16.67
1965,Tonga,3,0.0,161,4,0.0,166,7,0.0,166,1,1,0.0
1965,Cook Islands,3,0.0,161,4,0.0,166,7,0.0,166,1,1,0.0
1965,Saint Pierre and Miquelon,1,0.0,167,6,0.0,163,7,0.0,166,5,4,25.0
1965,Maldives,2,0.0,164,2,0.0,169,4,0.0,170,0,0,
1965,Seychelles,2,0.0,164,2,0.0,169,4,0.0,170,0,1,-100.0
1964,United States of America,25690,14.71,1,20306,11.08,1,45996,12.85,1,-5384,-3806,41.46
1964,Germany,16230,9.29,2,14710,8.02,3,30940,8.64,2,-1520,-1508,0.8
1964,United Kingdom,12880,7.37,3,15966,8.71,2,28846,8.06,3,3086,1711,80.36
1964,France,9106,5.21,4,10101,5.51,4,19207,5.36,4,995,540,84.26
1964,Canada,8037,4.6,5,7402,4.04,8,15439,4.31,5,-635,-332,91.27
1964,U.S.S.R.,7683,4.4,6,7736,4.22,7,15419,4.31,6,53,-213,-124.88
1964,Netherlands,6694,3.83,7,8414,4.59,5,15108,4.22,7,1720,1411,21.9
1964,Japan,6673,3.82,8,7938,4.33,6,14611,4.08,8,1265,1284,-1.48
1964,Italy,5962,3.41,9,7254,3.96,9,13216,3.69,9,1292,2533,-48.99
1964,Belgium-Luxembourg,5600,3.21,10,5930,3.23,10,11530,3.22,10,330,288,14.58
1964,Sweden,3675,2.1,11,3856,2.1,11,7531,2.1,11,181,190,-4.74
1964,Australia,3053,1.75,12,3318,1.81,13,6371,1.78,12,265,-29,-1013.79
1964,Switzerland,2621,1.5,14,3554,1.94,12,6175,1.72,13,933,811,15.04
1964,German Democratic Republic,2932,1.68,13,2634,1.44,15,5566,1.55,14,-298,-382,-21.99
1964,Czech and Slovak Federal Republic,2576,1.47,15,2429,1.32,17,5005,1.4,15,-147,-302,-51.32
1964,South Africa,2479,1.42,16,2281,1.24,18,4760,1.33,16,-198,-588,-66.33
1964,Denmark,2107,1.21,19,2617,1.43,16,4724,1.32,17,510,221,130.77
1964,India,1705,0.98,21,2876,1.57,14,4581,1.28,18,1171,851,37.6
1964,Poland,2097,1.2,20,2072,1.13,20,4169,1.16,19,-25,209,-111.96
1964,China,2250,1.29,18,1710,0.93,23,3960,1.11,20,-540,-581,-7.06
1964,"Venezuela, Bolivarian Republic of",2472,1.42,17,1249,0.68,31,3721,1.04,21,-1223,-1105,10.68
1964,Austria,1446,0.83,22,1863,1.02,22,3309,0.92,22,417,349,19.48
1964,Norway,1291,0.74,26,1984,1.08,21,3275,0.91,23,693,749,-7.48
1964,Spain,920,0.53,37,2255,1.23,19,3175,0.89,24,1335,1220,9.43
1964,Hungary,1352,0.77,25,1495,0.82,26,2847,0.8,25,143,100,43.0
1964,Finland,1291,0.74,26,1505,0.82,24,2796,0.78,26,214,59,262.71
1964,Brazil,1430,0.82,23,1263,0.69,29,2693,0.75,27,-167,81,-306.17
1964,Mexico,1054,0.6,33,1493,0.81,27,2547,0.71,28,439,255,72.16
1964,"Hong Kong, China",1012,0.58,34,1496,0.82,25,2508,0.7,29,484,424,14.15
1964,Argentina,1410,0.81,24,1077,0.59,33,2487,0.69,30,-333,-384,-13.28
1964,Romania,1000,0.57,35,1262,0.69,30,2262,0.63,31,262,189,38.62
1964,"Yugoslavia, Socialist Federal Republic of",893,0.51,39,1323,0.72,28,2216,0.62,32,430,267,61.05
1964,Malaysia,1105,0.63,31,1047,0.57,36,2152,0.6,33,-58,-45,28.89
1964,Singapore,906,0.52,38,1137,0.62,32,2043,0.57,34,231,263,-12.17
1964,Bulgaria,980,0.56,36,1062,0.58,35,2042,0.57,35,82,99,-17.17
1964,New Zealand,1074,0.61,32,961,0.52,39,2035,0.57,36,-113,-7,1514.29
1964,Iran,1252,0.72,28,673,0.37,51,1925,0.54,37,-579,-395,46.58
1964,Cuba,714,0.41,43,1019,0.56,37,1733,0.48,38,305,323,-5.57
1964,"Saudi Arabia, Kingdom of",1187,0.68,30,394,0.21,62,1581,0.44,39,-793,-800,-0.88
1964,"Kuwait, the State of",1251,0.72,29,322,0.18,65,1573,0.44,40,-929,-812,14.41
1964,Pakistan,469,0.27,56,1070,0.58,34,1539,0.43,41,601,578,3.98
1964,Philippines,666,0.38,46,869,0.47,42,1535,0.43,42,203,34,497.06
1964,Ireland,549,0.31,51,974,0.53,38,1523,0.43,43,425,309,37.54
1964,Egypt,539,0.31,53,953,0.52,40,1492,0.42,44,414,394,5.08
1964,Algeria,727,0.42,41,703,0.38,48,1430,0.4,45,-24,-76,-68.42
1964,Indonesia,724,0.41,42,680,0.37,50,1404,0.39,46,-44,-175,-74.86
1964,Netherlands Antilles,630,0.36,47,758,0.41,45,1388,0.39,47,128,182,-29.67
1964,Chile,592,0.34,50,723,0.39,46,1315,0.37,48,131,141,-7.09
1964,Nigeria,601,0.34,48,711,0.39,47,1312,0.37,49,110,59,86.44
1964,Portugal,518,0.3,54,778,0.42,44,1296,0.36,50,260,243,7.0
1964,Thailand,593,0.34,49,685,0.37,49,1278,0.36,51,92,148,-37.84
1964,Iraq,840,0.48,40,413,0.23,60,1253,0.35,52,-427,-462,-7.58
1964,Peru,667,0.38,45,579,0.32,53,1246,0.35,53,-88,16,-650.0
1964,Israel,372,0.21,63,839,0.46,43,1211,0.34,54,467,322,45.03
1964,Greece,309,0.18,66,885,0.48,41,1194,0.33,55,576,514,12.06
1964,Colombia,548,0.31,52,586,0.32,52,1134,0.32,56,38,62,-38.71
1964,Libya,700,0.4,44,292,0.16,67,992,0.28,57,-408,-135,202.22
1964,Türkiye,411,0.24,59,537,0.29,54,948,0.26,58,126,320,-60.62
1964,Morocco,432,0.25,58,462,0.25,56,894,0.25,59,30,65,-53.85
1964,Chinese Taipei,434,0.25,57,430,0.23,57,864,0.24,60,-4,31,-112.9
1964,Trinidad and Tobago,408,0.23,60,426,0.23,58,834,0.23,61,18,3,500.0
1964,Sri Lanka,394,0.23,61,415,0.23,59,809,0.23,62,21,-51,-141.18
1964,Zimbabwe,385,0.22,62,349,0.19,63,734,0.21,63,-36,20,-280.0
1964,Zambia,470,0.27,55,219,0.12,76,689,0.19,64,-251,-197,27.41
1964,Ghana,321,0.18,64,340,0.19,64,661,0.18,65,19,60,-68.33
1964,Lebanese Republic,65,0.04,104,512,0.28,55,577,0.16,66,447,367,21.8
1964,Côte d'Ivoire,296,0.17,67,235,0.13,74,531,0.15,67,-61,-60,1.67
1964,"Korea, Republic of",118,0.07,90,404,0.22,61,522,0.15,68,286,473,-39.53
1964,Jamaica,216,0.12,71,289,0.16,68,505,0.14,69,73,24,204.17
1964,Myanmar,233,0.13,68,271,0.15,70,504,0.14,70,38,-36,-205.56
1964,"Yemen, People's Democratic Republic",206,0.12,73,297,0.16,66,503,0.14,71,91,76,19.74
1964,Sudan,197,0.11,75,274,0.15,69,471,0.13,72,77,59,30.51
1964,Kenya,222,0.13,70,246,0.13,72,468,0.13,73,24,34,-29.41
1964,Syrian Arab Republic,176,0.1,79,236,0.13,73,412,0.12,74,60,46,30.43
1964,Democratic Republic of the Congo,318,0.18,65,87,0.05,109,405,0.11,75,-231,-328,-29.57
1964,Tanzania,225,0.13,69,177,0.1,83,402,0.11,76,-48,-66,-27.27
1964,Dominican Republic,179,0.1,76,221,0.12,75,400,0.11,77,42,10,320.0
1964,Tunisia,130,0.07,85,248,0.14,71,378,0.11,78,118,97,21.65
1964,Uruguay,179,0.1,76,198,0.11,79,377,0.11,79,19,12,58.33
1964,El Salvador,178,0.1,78,191,0.1,80,369,0.1,80,13,-2,-750.0
1964,Angola,204,0.12,74,164,0.09,86,368,0.1,81,-40,-16,150.0
1964,Guatemala,165,0.09,81,202,0.11,78,367,0.1,82,37,19,94.74
1964,"Bahrain, Kingdom of",176,0.1,79,180,0.1,82,356,0.1,83,4,-20,-120.0
1964,Uganda,213,0.12,72,130,0.07,94,343,0.1,84,-83,-62,33.87
1964,United Arab Emirates,125,0.07,87,205,0.11,77,330,0.09,85,80,145,-44.83
1964,Senegal,133,0.08,84,177,0.1,83,310,0.09,86,44,49,-10.2
1964,Ecuador,144,0.08,83,151,0.08,88,295,0.08,87,7,8,-12.5
1964,Mozambique,106,0.06,93,156,0.09,87,262,0.07,88,50,41,21.95
1964,Nicaragua,125,0.07,87,137,0.07,91,262,0.07,88,12,4,200.0
1964,Costa Rica,114,0.07,91,139,0.08,90,253,0.07,90,25,29,-13.79
1964,Iceland,111,0.06,92,131,0.07,93,242,0.07,91,20,16,25.0
1964,Cameroon,125,0.07,87,116,0.06,97,241,0.07,92,-9,-7,28.57
1964,Liberia,126,0.07,86,111,0.06,98,237,0.07,93,-15,27,-155.56
1964,Panama,53,0.03,110,181,0.1,81,234,0.07,94,128,142,-9.86
1964,Ethiopia,105,0.06,94,123,0.07,96,228,0.06,95,18,21,-14.29
1964,Madagascar,92,0.05,100,136,0.07,92,228,0.06,95,44,46,-4.35
1964,Viet Nam,28,0.02,128,174,0.09,85,202,0.06,97,146,122,19.67
1964,Qatar,151,0.09,82,50,0.03,123,201,0.06,98,-101,-96,5.21
1964,"Bolivia, Plurinational State of",96,0.05,95,103,0.06,100,199,0.06,99,7,36,-80.56
1964,Honduras,95,0.05,96,102,0.06,101,197,0.06,100,7,12,-41.67
1964,Sierra Leone,95,0.05,96,99,0.05,103,194,0.05,101,4,3,33.33
1964,Afghanistan,64,0.04,105,124,0.07,95,188,0.05,102,60,55,9.09
1964,Guyana,95,0.05,96,87,0.05,109,182,0.05,103,-8,-33,-75.76
1964,Jordan,24,0.01,130,150,0.08,89,174,0.05,104,126,125,0.8
1964,Cambodia,88,0.05,101,82,0.04,111,170,0.05,105,-6,18,-133.33
1964,Cyprus,58,0.03,109,105,0.06,99,163,0.05,106,47,71,-33.8
1964,Mauritius,77,0.04,102,82,0.04,111,159,0.04,107,5,-20,-125.0
1964,Albania,60,0.03,108,98,0.05,104,158,0.04,108,38,23,65.22
1964,Gabon,95,0.05,96,56,0.03,121,151,0.04,109,-39,-25,56.0
1964,Papua New Guinea,50,0.03,111,96,0.05,107,146,0.04,110,46,37,24.32
1964,Fiji,73,0.04,103,70,0.04,117,143,0.04,111,-3,-12,-75.0
1964,Nepal,43,0.02,116,98,0.05,104,141,0.04,112,55,41,34.15
1964,Suriname,48,0.03,113,81,0.04,113,129,0.04,113,33,11,200.0
1964,Reunion,37,0.02,119,91,0.05,108,128,0.04,114,54,32,68.75
1964,New Caledonia,62,0.04,106,54,0.03,122,116,0.03,115,-8,-8,0.0
1964,Malta,19,0.01,133,97,0.05,106,116,0.03,115,78,70,11.43
1964,Bahamas,16,0.01,136,100,0.05,102,116,0.03,115,84,69,21.74
1964,Guadeloupe,35,0.02,120,79,0.04,114,114,0.03,118,44,31,41.94
1964,Congo,47,0.03,114,67,0.04,118,114,0.03,118,20,22,-9.09
1964,Martinique,29,0.02,126,79,0.04,114,108,0.03,120,50,38,31.58
1964,Barbados,35,0.02,120,64,0.03,119,99,0.03,121,29,17,70.59
1964,Brunei Darussalam,61,0.03,107,31,0.02,134,92,0.03,122,-30,-39,-23.08
1964,Malawi,35,0.02,120,57,0.03,120,92,0.03,122,22,10,120.0
1964,Guinea,43,0.02,116,49,0.03,124,92,0.03,122,6,-9,-166.67
1964,Paraguay,49,0.03,112,40,0.02,129,89,0.02,125,-9,0,
1964,French Polynesia,11,0.01,143,71,0.04,116,82,0.02,126,60,22,172.73
1964,Haiti,40,0.02,118,41,0.02,127,81,0.02,127,1,-2,-150.0
1964,Togo,30,0.02,125,42,0.02,126,72,0.02,128,12,11,9.09
1964,"Macao, China",22,0.01,132,48,0.03,125,70,0.02,129,26,21,23.81
1964,Djibouti,24,0.01,130,41,0.02,127,65,0.02,130,17,26,-34.62
1964,Chad,27,0.02,129,35,0.02,132,62,0.02,131,8,6,33.33
1964,Mauritania,46,0.03,115,16,0.01,145,62,0.02,131,-30,14,-314.29
1964,Central African Republic,29,0.02,126,30,0.02,136,59,0.02,133,1,4,-75.0
1964,Eswatini,32,0.02,124,27,0.01,138,59,0.02,133,-5,-5,0.0
1964,Equatorial Guinea,33,0.02,123,23,0.01,141,56,0.02,135,-10,-10,0.0
1964,Mali,17,0.01,135,37,0.02,131,54,0.02,136,20,23,-13.04
1964,Niger,19,0.01,133,34,0.02,133,53,0.01,137,15,3,400.0
1964,Burkina Faso,12,0.01,140,40,0.02,129,52,0.01,138,28,28,0.0
1964,Benin,13,0.01,137,31,0.02,134,44,0.01,139,18,20,-10.0
1964,Greenland,10,0.01,144,29,0.02,137,39,0.01,140,19,14,35.71
1964,Belize,13,0.01,137,22,0.01,142,35,0.01,141,9,6,50.0
1964,Lesotho,6,0.0,151,24,0.01,140,30,0.01,142,18,17,5.88
1964,Lao People's Democratic Republic,1,0.0,167,26,0.01,139,27,0.01,143,25,25,0.0
1964,Burundi,9,0.01,146,17,0.01,144,26,0.01,144,8,9,-11.11
1964,Botswana,12,0.01,140,13,0.01,148,25,0.01,145,1,1,0.0
1964,Yemen,4,0.0,157,21,0.01,143,25,0.01,145,17,15,13.33
1964,Rwanda,12,0.01,140,12,0.01,150,24,0.01,147,0,8,-100.0
1964,American Samoa,13,0.01,137,10,0.01,153,23,0.01,148,-3,-3,0.0
1964,Guinea-Bissau,6,0.0,151,15,0.01,147,21,0.01,149,9,7,28.57
1964,The Gambia,9,0.01,146,12,0.01,150,21,0.01,149,3,3,0.0
1964,Saint Kitts and Nevis,10,0.01,144,8,0.0,158,18,0.01,151,-2,-1,100.0
1964,Saint Lucia,6,0.0,151,12,0.01,150,18,0.01,151,6,5,20.0
1964,Samoa,7,0.0,149,10,0.01,153,17,0.0,153,3,1,200.0
1964,French Guiana,1,0.0,167,16,0.01,145,17,0.0,153,15,10,50.0
1964,Vanuatu,9,0.01,146,7,0.0,159,16,0.0,155,-2,0,
1964,Antigua and Barbuda,2,0.0,165,13,0.01,148,15,0.0,156,11,9,22.22
1964,Grenada,4,0.0,157,10,0.01,153,14,0.0,157,6,4,50.0
1964,Dominica,5,0.0,155,9,0.0,156,14,0.0,157,4,2,100.0
1964,Saint Vincent and the Grenadines,4,0.0,157,9,0.0,156,13,0.0,159,5,3,66.67
1964,Solomon Islands,5,0.0,155,7,0.0,159,12,0.0,160,2,2,0.0
1964,Sao Tomé and Principe,6,0.0,151,5,0.0,165,11,0.0,161,-1,-1,0.0
1964,Comoros,4,0.0,157,6,0.0,164,10,0.0,162,2,0,
1964,Oman,3,0.0,161,7,0.0,159,10,0.0,162,4,10,-60.0
1964,Cabo Verde,1,0.0,167,7,0.0,159,8,0.0,164,6,3,100.0
1964,Montserrat,1,0.0,167,7,0.0,159,8,0.0,164,6,4,50.0
1964,Guam,7,0.0,149,0,0.0,172,7,0.0,166,-7,-7,0.0
1964,Kiribati,3,0.0,161,4,0.0,167,7,0.0,166,1,3,-66.67
1964,Tonga,3,0.0,161,4,0.0,167,7,0.0,166,1,1,0.0
1964,Cook Islands,3,0.0,161,4,0.0,167,7,0.0,166,1,1,0.0
1964,Saint Pierre and Miquelon,1,0.0,167,5,0.0,165,6,0.0,170,4,4,0.0
1964,Maldives,2,0.0,165,2,0.0,170,4,0.0,171,0,0,
1964,Seychelles,1,0.0,167,2,0.0,170,3,0.0,172,1,1,0.0
1963,United States of America,22427,14.37,1,18621,11.37,1,41048,12.83,1,-3806,-3192,19.24
1963,Germany,14578,9.34,2,13070,7.98,3,27648,8.64,2,-1508,-869,73.53
1963,United Kingdom,12258,7.85,3,13969,8.53,2,26227,8.2,3,1711,1584,8.02
1963,France,8204,5.26,4,8744,5.34,4,16948,5.3,4,540,-33,-1736.36
1963,U.S.S.R.,7272,4.66,5,7059,4.31,7,14331,4.48,5,-213,-575,-62.96
1963,Canada,6777,4.34,6,6445,3.94,9,13222,4.13,6,-332,7,-4842.86
1963,Netherlands,5706,3.66,7,7117,4.35,6,12823,4.01,7,1411,1138,23.99
1963,Italy,5056,3.24,9,7589,4.64,5,12645,3.95,8,2533,1402,80.67
1963,Japan,5452,3.49,8,6736,4.11,8,12188,3.81,9,1284,720,78.33
1963,Belgium-Luxembourg,4840,3.1,10,5128,3.13,10,9968,3.12,10,288,236,22.03
1963,Sweden,3203,2.05,11,3393,2.07,11,6596,2.06,11,190,198,-4.04
1963,Switzerland,2388,1.53,15,3199,1.95,12,5587,1.75,12,811,779,4.11
1963,Australia,2805,1.8,12,2776,1.7,13,5581,1.74,13,-29,184,-115.76
1963,German Democratic Republic,2713,1.74,13,2331,1.42,15,5044,1.58,14,-382,29,-1417.24
1963,Czech and Slovak Federal Republic,2462,1.58,14,2160,1.32,16,4622,1.45,15,-302,-124,143.55
1963,South Africa,2359,1.51,16,1771,1.08,21,4130,1.29,16,-588,-743,-20.86
1963,India,1626,1.04,21,2477,1.51,14,4103,1.28,17,851,959,-11.26
1963,Denmark,1908,1.22,19,2129,1.3,17,4037,1.26,18,221,461,-52.06
1963,Poland,1770,1.13,20,1979,1.21,18,3749,1.17,19,209,239,-12.55
1963,"Venezuela, Bolivarian Republic of",2343,1.5,17,1238,0.76,29,3581,1.12,20,-1105,-1038,6.45
1963,China,2031,1.3,18,1450,0.89,24,3481,1.09,21,-581,-540,7.59
1963,Austria,1326,0.85,24,1675,1.02,22,3001,0.94,22,349,288,21.18
1963,Norway,1073,0.69,31,1822,1.11,20,2895,0.91,23,749,692,8.24
1963,Brazil,1406,0.9,22,1487,0.91,23,2893,0.9,24,81,261,-68.97
1963,Spain,735,0.47,41,1955,1.19,19,2690,0.84,25,1220,833,46.46
1963,Singapore,1135,0.73,28,1398,0.85,25,2533,0.79,26,263,203,29.56
1963,Hungary,1206,0.77,25,1306,0.8,26,2512,0.79,27,100,49,104.08
1963,Finland,1149,0.74,26,1208,0.74,30,2357,0.74,28,59,124,-52.42
1963,Argentina,1365,0.87,23,981,0.6,35,2346,0.73,29,-384,141,-372.34
1963,Mexico,985,0.63,32,1240,0.76,28,2225,0.7,30,255,213,19.72
1963,"Hong Kong, China",873,0.56,36,1297,0.79,27,2170,0.68,31,424,397,6.8
1963,Malaysia,1088,0.7,30,1043,0.64,33,2131,0.67,32,-45,-67,-32.84
1963,Romania,915,0.59,34,1104,0.67,31,2019,0.63,33,189,198,-4.55
1963,"Yugoslavia, Socialist Federal Republic of",790,0.51,38,1057,0.65,32,1847,0.58,34,267,198,34.85
1963,New Zealand,910,0.58,35,903,0.55,38,1813,0.57,35,-7,-45,-84.44
1963,Bulgaria,834,0.53,37,933,0.57,36,1767,0.55,36,99,12,725.0
1963,Netherlands Antilles,659,0.42,43,841,0.51,41,1500,0.47,37,182,184,-1.09
1963,"Kuwait, the State of",1136,0.73,27,324,0.2,61,1460,0.46,38,-812,-792,2.53
1963,Iran,919,0.59,33,524,0.32,53,1443,0.45,39,-395,-291,35.74
1963,Algeria,759,0.49,40,683,0.42,45,1442,0.45,40,-76,201,-137.81
1963,"Saudi Arabia, Kingdom of",1120,0.72,29,320,0.2,62,1440,0.45,41,-800,-739,8.25
1963,Egypt,522,0.33,48,916,0.56,37,1438,0.45,42,394,342,15.2
1963,Cuba,544,0.35,46,867,0.53,39,1411,0.44,43,323,238,35.71
1963,Ireland,549,0.35,45,858,0.52,40,1407,0.44,44,309,278,11.15
1963,Pakistan,407,0.26,55,985,0.6,34,1392,0.44,45,578,427,35.36
1963,Philippines,653,0.42,44,687,0.42,44,1340,0.42,46,34,154,-77.92
1963,Indonesia,696,0.45,42,521,0.32,54,1217,0.38,47,-175,-35,400.0
1963,Chile,522,0.33,48,663,0.4,47,1185,0.37,48,141,150,-6.0
1963,Iraq,781,0.5,39,319,0.19,63,1100,0.34,49,-462,-331,39.58
1963,Nigeria,520,0.33,50,579,0.35,50,1099,0.34,50,59,101,-41.58
1963,Peru,541,0.35,47,557,0.34,52,1098,0.34,51,16,-3,-633.33
1963,Greece,290,0.19,65,804,0.49,42,1094,0.34,52,514,451,13.97
1963,Thailand,466,0.3,51,614,0.38,49,1080,0.34,53,148,95,55.79
1963,Portugal,417,0.27,54,660,0.4,48,1077,0.34,54,243,231,5.19
1963,Türkiye,368,0.24,59,688,0.42,43,1056,0.33,55,320,238,34.45
1963,Israel,352,0.23,62,674,0.41,46,1026,0.32,56,322,356,-9.55
1963,Colombia,446,0.29,53,508,0.31,55,954,0.3,57,62,78,-20.51
1963,Morocco,384,0.25,56,449,0.27,56,833,0.26,58,65,85,-23.53
1963,Trinidad and Tobago,374,0.24,57,377,0.23,58,751,0.23,59,3,8,-62.5
1963,Chinese Taipei,332,0.21,63,363,0.22,60,695,0.22,60,31,83,-62.65
1963,Sri Lanka,364,0.23,60,313,0.19,64,677,0.21,61,-51,-31,64.52
1963,Ghana,305,0.2,64,365,0.22,59,670,0.21,62,60,11,445.45
1963,"Korea, Republic of",87,0.06,95,560,0.34,51,647,0.2,63,473,366,29.23
1963,Libya,374,0.24,57,239,0.15,67,613,0.19,64,-135,69,-295.65
1963,Democratic Republic of the Congo,459,0.29,52,131,0.08,89,590,0.18,65,-328,-255,28.63
1963,Zambia,361,0.23,61,164,0.1,83,525,0.16,66,-197,-160,23.13
1963,Sudan,226,0.14,68,285,0.17,65,511,0.16,67,59,44,34.09
1963,Myanmar,270,0.17,66,234,0.14,69,504,0.16,68,-36,-46,-21.74
1963,Lebanese Republic,57,0.04,106,424,0.26,57,481,0.15,69,367,290,26.55
1963,"Yemen, People's Democratic Republic",196,0.13,73,272,0.17,66,468,0.15,70,76,54,40.74
1963,Zimbabwe,210,0.13,69,230,0.14,71,440,0.14,71,20,40,-50.0
1963,Kenya,198,0.13,72,232,0.14,70,430,0.13,72,34,69,-50.72
1963,Jamaica,202,0.13,71,226,0.14,72,428,0.13,73,24,41,-41.46
1963,Syrian Arab Republic,189,0.12,74,235,0.14,68,424,0.13,74,46,64,-28.13
1963,Côte d'Ivoire,230,0.15,67,170,0.1,81,400,0.13,75,-60,-37,62.16
1963,"Bahrain, Kingdom of",206,0.13,70,186,0.11,74,392,0.12,76,-20,-11,81.82
1963,Dominican Republic,174,0.11,77,184,0.11,75,358,0.11,77,10,-24,-141.67
1963,Tunisia,126,0.08,84,223,0.14,73,349,0.11,78,97,100,-3.0
1963,Uruguay,165,0.11,78,177,0.11,78,342,0.11,79,12,77,-84.42
1963,Guatemala,152,0.1,81,171,0.1,79,323,0.1,80,19,10,90.0
1963,Angola,163,0.1,79,147,0.09,85,310,0.1,81,-16,-12,33.33
1963,El Salvador,154,0.1,80,152,0.09,84,306,0.1,82,-2,-11,-81.82
1963,Senegal,122,0.08,85,171,0.1,79,293,0.09,83,49,38,28.95
1963,Tanzania,179,0.11,75,113,0.07,96,292,0.09,84,-66,-33,100.0
1963,Uganda,176,0.11,76,114,0.07,95,290,0.09,85,-62,-39,58.97
1963,Cameroon,135,0.09,83,128,0.08,90,263,0.08,86,-7,-1,600.0
1963,Ecuador,120,0.08,86,128,0.08,90,248,0.08,87,8,-47,-117.02
1963,Mozambique,101,0.06,89,142,0.09,87,243,0.08,88,41,45,-8.89
1963,Panama,39,0.02,116,181,0.11,76,220,0.07,89,142,120,18.33
1963,Costa Rica,95,0.06,90,124,0.08,94,219,0.07,90,29,20,45.0
1963,Nicaragua,107,0.07,87,111,0.07,97,218,0.07,91,4,3,33.33
1963,United Arab Emirates,35,0.02,122,180,0.11,77,215,0.07,92,145,160,-9.38
1963,Viet Nam,45,0.03,111,167,0.1,82,212,0.07,93,122,121,0.83
1963,Madagascar,82,0.05,97,128,0.08,90,210,0.07,94,46,28,64.29
1963,Iceland,94,0.06,91,110,0.07,99,204,0.06,95,16,5,220.0
1963,Ethiopia,90,0.06,92,111,0.07,97,201,0.06,96,21,24,-12.5
1963,Cambodia,89,0.06,94,107,0.07,101,196,0.06,97,18,48,-62.5
1963,Afghanistan,70,0.04,101,125,0.08,93,195,0.06,98,55,58,-5.17
1963,Cyprus,61,0.04,104,132,0.08,88,193,0.06,99,71,68,4.41
1963,Liberia,81,0.05,98,108,0.07,100,189,0.06,100,27,64,-57.81
1963,Honduras,83,0.05,96,95,0.06,103,178,0.06,101,12,-1,-1300.0
1963,Qatar,136,0.09,82,40,0.02,123,176,0.06,102,-96,-94,2.13
1963,Guyana,102,0.07,88,69,0.04,113,171,0.05,103,-33,-21,57.14
1963,"Bolivia, Plurinational State of",67,0.04,102,103,0.06,102,170,0.05,104,36,37,-2.7
1963,Sierra Leone,81,0.05,98,84,0.05,105,165,0.05,105,3,28,-89.29
1963,Jordan,18,0.01,131,143,0.09,86,161,0.05,106,125,111,12.61
1963,Mauritius,90,0.06,92,70,0.04,111,160,0.05,107,-20,4,-600.0
1963,Papua New Guinea,43,0.03,112,80,0.05,106,123,0.04,108,37,28,32.14
1963,Gabon,73,0.05,100,48,0.03,119,121,0.04,109,-25,-18,38.89
1963,Albania,48,0.03,108,71,0.04,110,119,0.04,110,23,24,-4.17
1963,Nepal,38,0.02,118,79,0.05,107,117,0.04,111,41,18,127.78
1963,Fiji,63,0.04,103,51,0.03,118,114,0.04,112,-12,-4,200.0
1963,Martinique,36,0.02,121,74,0.05,109,110,0.03,113,38,23,65.22
1963,Reunion,38,0.02,118,70,0.04,111,108,0.03,114,32,30,6.67
1963,Guadeloupe,38,0.02,118,69,0.04,113,107,0.03,115,31,22,40.91
1963,Congo,42,0.03,113,64,0.04,115,106,0.03,116,22,41,-46.34
1963,Suriname,47,0.03,109,58,0.04,116,105,0.03,117,11,13,-15.38
1963,Guinea,55,0.04,107,46,0.03,121,101,0.03,118,-9,18,-150.0
1963,Malta,15,0.01,135,85,0.05,104,100,0.03,119,70,68,2.94
1963,Barbados,41,0.03,114,58,0.04,116,99,0.03,120,17,23,-26.09
1963,Bahamas,10,0.01,141,79,0.05,107,89,0.03,121,69,60,15.0
1963,New Caledonia,46,0.03,110,38,0.02,127,84,0.03,122,-8,7,-214.29
1963,Brunei Darussalam,60,0.04,105,21,0.01,141,81,0.03,123,-39,-49,-20.41
1963,Haiti,41,0.03,114,39,0.02,125,80,0.03,124,-2,-6,-66.67
1963,Paraguay,39,0.02,116,39,0.02,125,78,0.02,125,0,7,-100.0
1963,Malawi,30,0.02,124,40,0.02,123,70,0.02,126,10,11,-9.09
1963,Djibouti,22,0.01,127,48,0.03,119,70,0.02,126,26,12,116.67
1963,"Macao, China",21,0.01,129,42,0.03,122,63,0.02,128,21,21,0.0
1963,Eswatini,31,0.02,123,26,0.02,135,57,0.02,129,-5,1,-600.0
1963,Chad,23,0.01,126,29,0.02,133,52,0.02,130,6,12,-50.0
1963,Central African Republic,22,0.01,127,26,0.02,135,48,0.02,131,4,11,-63.64
1963,Togo,18,0.01,131,29,0.02,133,47,0.01,132,11,10,10.0
1963,Equatorial Guinea,28,0.02,125,18,0.01,144,46,0.01,133,-10,-1,900.0
1963,Benin,13,0.01,136,33,0.02,130,46,0.01,133,20,16,25.0
1963,Burkina Faso,9,0.01,143,37,0.02,128,46,0.01,133,28,27,3.7
1963,Mauritania,16,0.01,134,30,0.02,132,46,0.01,133,14,33,-57.58
1963,Mali,11,0.01,138,34,0.02,129,45,0.01,137,23,36,-36.11
1963,Niger,20,0.01,130,23,0.01,139,43,0.01,138,3,8,-62.5
1963,French Polynesia,10,0.01,141,32,0.02,131,42,0.01,139,22,14,57.14
1963,Greenland,11,0.01,138,25,0.02,138,36,0.01,140,14,13,7.69
1963,Belize,13,0.01,136,19,0.01,143,32,0.01,141,6,13,-53.85
1963,American Samoa,17,0.01,133,14,0.01,146,31,0.01,142,-3,-3,0.0
1963,Lesotho,5,0.0,153,22,0.01,140,27,0.01,143,17,15,13.33
1963,Yemen,6,0.0,150,21,0.01,141,27,0.01,143,15,10,50.0
1963,Burundi,9,0.01,143,18,0.01,144,27,0.01,143,9,10,-10.0
1963,Lao People's Democratic Republic,1,0.0,166,26,0.02,135,27,0.01,143,25,22,13.64
1963,Botswana,11,0.01,138,12,0.01,149,23,0.01,147,1,2,-50.0
1963,Guinea-Bissau,7,0.0,147,14,0.01,146,21,0.01,148,7,4,75.0
1963,The Gambia,9,0.01,143,12,0.01,149,21,0.01,148,3,3,0.0
1963,Antigua and Barbuda,4,0.0,158,13,0.01,148,17,0.01,150,9,10,-10.0
1963,Rwanda,4,0.0,158,12,0.01,149,16,0.01,151,8,5,60.0
1963,Saint Kitts and Nevis,8,0.01,146,7,0.0,157,15,0.0,152,-1,2,-150.0
1963,Samoa,7,0.0,147,8,0.0,156,15,0.0,152,1,0,
1963,Saint Lucia,5,0.0,153,10,0.01,154,15,0.0,152,5,6,-16.67
1963,Oman,2,0.0,162,12,0.01,149,14,0.0,155,10,10,0.0
1963,Grenada,5,0.0,153,9,0.01,155,14,0.0,155,4,5,-20.0
1963,Vanuatu,6,0.0,150,6,0.0,160,12,0.0,157,0,0,
1963,Dominica,5,0.0,153,7,0.0,157,12,0.0,157,2,3,-33.33
1963,French Guiana,1,0.0,166,11,0.01,153,12,0.0,157,10,11,-9.09
1963,Sao Tomé and Principe,6,0.0,150,5,0.0,162,11,0.0,160,-1,-1,0.0
1963,Saint Vincent and the Grenadines,4,0.0,158,7,0.0,157,11,0.0,160,3,3,0.0
1963,Comoros,5,0.0,153,5,0.0,162,10,0.0,162,0,1,-100.0
1963,Solomon Islands,4,0.0,158,6,0.0,160,10,0.0,162,2,2,0.0
1963,Guam,7,0.0,147,0,0.0,172,7,0.0,164,-7,-6,16.67
1963,Montserrat,1,0.0,166,5,0.0,162,6,0.0,165,4,3,33.33
1963,Saint Pierre and Miquelon,1,0.0,166,5,0.0,162,6,0.0,165,4,2,100.0
1963,Cabo Verde,1,0.0,166,4,0.0,166,5,0.0,167,3,6,-50.0
1963,Kiribati,1,0.0,166,4,0.0,166,5,0.0,167,3,3,0.0
1963,Tonga,2,0.0,162,3,0.0,168,5,0.0,167,1,1,0.0
1963,Cook Islands,2,0.0,162,3,0.0,168,5,0.0,167,1,1,0.0
1963,Maldives,2,0.0,162,2,0.0,170,4,0.0,171,0,1,-100.0
1963,Seychelles,1,0.0,166,2,0.0,170,3,0.0,172,1,1,0.0
1962,United States of America,20973,14.7,1,17781,11.81,1,38754,13.22,1,-3192,-4252,-24.93
1962,Germany,13244,9.28,2,12375,8.22,3,25619,8.74,2,-869,-1640,-47.01
1962,United Kingdom,11374,7.97,3,12958,8.61,2,24332,8.3,3,1584,1655,-4.29
1962,France,7411,5.2,4,7378,4.9,4,14789,5.04,4,-33,-541,-93.9
1962,U.S.S.R.,7030,4.93,5,6455,4.29,5,13485,4.6,5,-575,-170,238.24
1962,Canada,6213,4.36,6,6220,4.13,7,12433,4.24,6,7,-23,-130.43
1962,Netherlands,5260,3.69,7,6398,4.25,6,11658,3.98,7,1138,1128,0.89
1962,Italy,4667,3.27,9,6069,4.03,8,10736,3.66,8,1402,1037,35.2
1962,Japan,4916,3.45,8,5636,3.74,9,10552,3.6,9,720,1574,-54.26
1962,Belgium-Luxembourg,4332,3.04,10,4568,3.03,10,8900,3.04,10,236,294,-19.73
1962,Sweden,2925,2.05,11,3123,2.07,11,6048,2.06,11,198,184,7.61
1962,Switzerland,2191,1.54,17,2970,1.97,12,5161,1.76,12,779,646,20.59
1962,Australia,2356,1.65,13,2540,1.69,13,4896,1.67,13,184,6,2966.67
1962,German Democratic Republic,2378,1.67,12,2407,1.6,14,4785,1.63,14,29,-30,-196.67
1962,Czech and Slovak Federal Republic,2194,1.54,16,2070,1.38,17,4264,1.45,15,-124,-22,463.64
1962,Denmark,1669,1.17,19,2130,1.41,16,3799,1.3,16,461,336,37.2
1962,India,1403,0.98,21,2362,1.57,15,3765,1.28,17,959,900,6.56
1962,South Africa,2219,1.56,15,1476,0.98,22,3695,1.26,18,-743,-679,9.43
1962,"Venezuela, Bolivarian Republic of",2342,1.64,14,1304,0.87,27,3646,1.24,19,-1038,-1028,0.97
1962,Poland,1646,1.15,20,1885,1.25,18,3531,1.2,20,239,183,30.6
1962,China,1913,1.34,18,1373,0.91,24,3286,1.12,21,-540,-195,176.92
1962,Austria,1264,0.89,22,1552,1.03,21,2816,0.96,22,288,283,1.77
1962,Brazil,1214,0.85,24,1475,0.98,23,2689,0.92,23,261,57,357.89
1962,Norway,972,0.68,31,1664,1.11,19,2636,0.9,24,692,685,1.02
1962,Argentina,1216,0.85,23,1357,0.9,25,2573,0.88,25,141,496,-71.57
1962,Singapore,1116,0.78,25,1319,0.88,26,2435,0.83,26,203,214,-5.14
1962,Finland,1104,0.77,26,1228,0.82,28,2332,0.8,27,124,100,24.0
1962,Spain,737,0.52,38,1570,1.04,20,2307,0.79,28,833,382,118.06
1962,Hungary,1100,0.77,27,1149,0.76,30,2249,0.77,29,49,-3,-1733.33
1962,Mexico,930,0.65,32,1143,0.76,31,2073,0.71,30,213,313,-31.95
1962,Malaysia,1065,0.75,29,998,0.66,33,2063,0.7,31,-67,-138,-51.45
1962,"Hong Kong, China",768,0.54,37,1165,0.77,29,1933,0.66,32,397,357,11.2
1962,Romania,818,0.57,34,1016,0.67,32,1834,0.63,33,198,87,127.59
1962,"Yugoslavia, Socialist Federal Republic of",690,0.48,40,888,0.59,34,1578,0.54,34,198,341,-41.94
1962,Netherlands Antilles,688,0.48,41,872,0.58,35,1560,0.53,35,184,162,13.58
1962,Bulgaria,773,0.54,36,785,0.52,37,1558,0.53,36,12,3,300.0
1962,New Zealand,798,0.56,35,753,0.5,40,1551,0.53,37,-45,108,-141.67
1962,"Kuwait, the State of",1077,0.76,28,285,0.19,64,1362,0.46,38,-792,-713,11.08
1962,"Saudi Arabia, Kingdom of",1047,0.73,30,308,0.2,62,1355,0.46,39,-739,-695,6.33
1962,Iran,822,0.58,33,531,0.35,53,1353,0.46,40,-291,-151,92.72
1962,Indonesia,682,0.48,42,647,0.43,45,1329,0.45,41,-35,10,-450.0
1962,Cuba,521,0.37,45,759,0.5,39,1280,0.44,42,238,78,205.13
1962,Ireland,488,0.34,47,766,0.51,38,1254,0.43,43,278,227,22.47
1962,Pakistan,407,0.29,51,834,0.55,36,1241,0.42,44,427,170,151.18
1962,Chile,530,0.37,44,680,0.45,43,1210,0.41,45,150,205,-26.83
1962,Philippines,507,0.36,46,661,0.44,44,1168,0.4,46,154,336,-54.17
1962,Egypt,401,0.28,52,743,0.49,41,1144,0.39,47,342,215,59.07
1962,Peru,540,0.38,43,537,0.36,52,1077,0.37,48,-3,-27,-88.89
1962,Iraq,692,0.49,39,361,0.24,57,1053,0.36,49,-331,-254,30.31
1962,Nigeria,468,0.33,48,569,0.38,49,1037,0.35,50,101,137,-26.28
1962,Thailand,456,0.32,50,551,0.37,50,1007,0.34,51,95,14,578.57
1962,Colombia,463,0.32,49,541,0.36,51,1004,0.34,52,78,124,-37.1
1962,Türkiye,381,0.27,53,619,0.41,47,1000,0.34,53,238,160,48.75
1962,Portugal,370,0.26,55,601,0.4,48,971,0.33,54,231,324,-28.7
1962,Greece,250,0.18,63,701,0.47,42,951,0.32,55,451,491,-8.15
1962,Israel,279,0.2,61,635,0.42,46,914,0.31,56,356,335,6.27
1962,Morocco,349,0.24,56,434,0.29,54,783,0.27,57,85,110,-22.73
1962,Sri Lanka,380,0.27,54,349,0.23,59,729,0.25,58,-31,-22,40.91
1962,Trinidad and Tobago,345,0.24,57,353,0.23,58,698,0.24,59,8,-5,-260.0
1962,Ghana,322,0.23,60,333,0.22,61,655,0.22,60,11,78,-85.9
1962,Algeria,192,0.13,69,393,0.26,56,585,0.2,61,201,657,-69.41
1962,Chinese Taipei,221,0.15,64,304,0.2,63,525,0.18,62,83,121,-31.4
1962,Zambia,335,0.23,59,175,0.12,76,510,0.17,63,-160,-107,49.53
1962,Myanmar,265,0.19,62,219,0.15,71,484,0.17,64,-46,-5,820.0
1962,"Korea, Republic of",56,0.04,104,422,0.28,55,478,0.16,65,366,275,33.09
1962,Sudan,213,0.15,65,257,0.17,65,470,0.16,66,44,68,-35.29
1962,Zimbabwe,204,0.14,67,244,0.16,66,448,0.15,67,40,57,-29.82
1962,Democratic Republic of the Congo,341,0.24,58,86,0.06,102,427,0.15,68,-255,-100,155.0
1962,"Yemen, People's Democratic Republic",186,0.13,70,240,0.16,67,426,0.15,69,54,53,1.89
1962,"Bahrain, Kingdom of",212,0.15,66,201,0.13,74,413,0.14,70,-11,-12,-8.33
1962,Lebanese Republic,59,0.04,99,349,0.23,59,408,0.14,71,290,275,5.45
1962,Jamaica,182,0.13,71,223,0.15,70,405,0.14,72,41,39,5.13
1962,Syrian Arab Republic,167,0.12,73,231,0.15,68,398,0.14,73,64,89,-28.09
1962,Uruguay,153,0.11,74,230,0.15,69,383,0.13,74,77,36,113.89
1962,Côte d'Ivoire,193,0.14,68,156,0.1,80,349,0.12,75,-37,-24,54.17
1962,Libya,137,0.1,78,206,0.14,73,343,0.12,76,69,133,-48.12
1962,Tunisia,116,0.08,84,216,0.14,72,332,0.11,77,100,101,-0.99
1962,Kenya,126,0.09,82,195,0.13,75,321,0.11,78,69,76,-9.21
1962,Dominican Republic,172,0.12,72,148,0.1,82,320,0.11,79,-24,-63,-61.9
1962,Senegal,124,0.09,83,162,0.11,78,286,0.1,80,38,39,-2.56
1962,Angola,148,0.1,75,136,0.09,83,284,0.1,81,-12,-21,-42.86
1962,El Salvador,136,0.1,79,125,0.08,88,261,0.09,82,-11,-10,10.0
1962,Tanzania,146,0.1,76,113,0.08,92,259,0.09,83,-33,-26,26.92
1962,Ecuador,144,0.1,77,97,0.06,97,241,0.08,84,-47,-19,147.37
1962,Uganda,134,0.09,80,95,0.06,99,229,0.08,85,-39,-40,-2.5
1962,Guatemala,109,0.08,85,119,0.08,90,228,0.08,86,10,11,-9.09
1962,Mozambique,91,0.06,90,136,0.09,83,227,0.08,87,45,40,12.5
1962,Madagascar,94,0.07,88,122,0.08,89,216,0.07,88,28,25,12.0
1962,Costa Rica,93,0.07,89,113,0.08,92,206,0.07,89,20,23,-13.04
1962,Cameroon,103,0.07,86,102,0.07,95,205,0.07,90,-1,-2,-50.0
1962,Liberia,68,0.05,95,132,0.09,85,200,0.07,91,64,29,120.69
1962,Panama,40,0.03,111,160,0.11,79,200,0.07,91,120,112,7.14
1962,Viet Nam,33,0.02,117,154,0.1,81,187,0.06,93,121,184,-34.24
1962,Cyprus,58,0.04,101,126,0.08,87,184,0.06,94,68,57,19.3
1962,Ethiopia,80,0.06,94,104,0.07,94,184,0.06,94,24,19,26.32
1962,Nicaragua,90,0.06,91,93,0.06,100,183,0.06,96,3,3,0.0
1962,United Arab Emirates,10,0.01,135,170,0.11,77,180,0.06,97,160,168,-4.76
1962,Afghanistan,58,0.04,101,116,0.08,91,174,0.06,98,58,46,26.09
1962,Iceland,84,0.06,92,89,0.06,101,173,0.06,99,5,5,0.0
1962,Guyana,95,0.07,87,74,0.05,107,169,0.06,100,-21,0,
1962,Qatar,131,0.09,81,37,0.02,125,168,0.06,101,-94,-82,14.63
1962,Honduras,81,0.06,93,80,0.05,104,161,0.05,102,-1,-1,0.0
1962,"Bolivia, Plurinational State of",60,0.04,98,97,0.06,97,157,0.05,103,37,20,85.0
1962,Cambodia,54,0.04,105,102,0.07,95,156,0.05,104,48,34,41.18
1962,Jordan,17,0.01,126,128,0.09,86,145,0.05,105,111,102,8.82
1962,Sierra Leone,57,0.04,103,85,0.06,103,142,0.05,106,28,9,211.11
1962,Mauritius,64,0.04,97,68,0.05,109,132,0.05,107,4,6,-33.33
1962,Guinea,48,0.03,106,66,0.04,111,114,0.04,108,18,15,20.0
1962,Congo,35,0.02,113,76,0.05,106,111,0.04,109,41,59,-30.51
1962,Papua New Guinea,39,0.03,112,67,0.04,110,106,0.04,110,28,29,-3.45
1962,Albania,41,0.03,110,65,0.04,112,106,0.04,110,24,23,4.35
1962,Gabon,59,0.04,99,41,0.03,120,100,0.03,112,-18,-19,-5.26
1962,Suriname,42,0.03,109,55,0.04,116,97,0.03,113,13,13,0.0
1962,Reunion,33,0.02,117,63,0.04,113,96,0.03,114,30,21,42.86
1962,Fiji,48,0.03,106,44,0.03,119,92,0.03,115,-4,3,-233.33
1962,Malta,12,0.01,131,80,0.05,104,92,0.03,115,68,69,-1.45
1962,Guadeloupe,35,0.02,113,57,0.04,114,92,0.03,115,22,16,37.5
1962,Martinique,34,0.02,115,57,0.04,114,91,0.03,118,23,17,35.29
1962,Brunei Darussalam,65,0.05,96,16,0.01,144,81,0.03,119,-49,-61,-19.67
1962,Barbados,29,0.02,120,52,0.03,117,81,0.03,119,23,22,4.55
1962,Haiti,43,0.03,108,37,0.02,125,80,0.03,121,-6,1,-700.0
1962,Bahamas,9,0.01,138,69,0.05,108,78,0.03,122,60,77,-22.08
1962,New Caledonia,34,0.02,115,41,0.03,120,75,0.03,123,7,-8,-187.5
1962,Paraguay,33,0.02,117,40,0.03,122,73,0.02,124,7,11,-36.36
1962,Malawi,29,0.02,120,40,0.03,122,69,0.02,125,11,14,-21.43
1962,Djibouti,25,0.02,122,37,0.02,125,62,0.02,126,12,16,-25.0
1962,Mali,10,0.01,135,46,0.03,118,56,0.02,127,36,22,63.64
1962,"Macao, China",17,0.01,126,38,0.03,124,55,0.02,128,21,18,16.67
1962,Equatorial Guinea,25,0.02,122,24,0.02,136,49,0.02,129,-1,-4,-75.0
1962,Niger,19,0.01,125,27,0.02,131,46,0.02,130,8,4,100.0
1962,Chad,17,0.01,126,29,0.02,130,46,0.02,130,12,4,200.0
1962,Togo,17,0.01,126,27,0.02,131,44,0.02,132,10,7,42.86
1962,Burkina Faso,8,0.01,143,35,0.02,129,43,0.01,133,27,24,12.5
1962,Eswatini,21,0.01,124,22,0.01,139,43,0.01,133,1,2,-50.0
1962,Central African Republic,14,0.01,130,25,0.02,134,39,0.01,135,11,8,37.5
1962,Mauritania,3,0.0,159,36,0.02,128,39,0.01,135,33,29,13.79
1962,Benin,11,0.01,132,27,0.02,131,38,0.01,137,16,10,60.0
1962,French Polynesia,11,0.01,132,25,0.02,134,36,0.01,138,14,11,27.27
1962,Belize,9,0.01,138,22,0.01,139,31,0.01,139,13,7,85.71
1962,Greenland,9,0.01,138,22,0.01,139,31,0.01,139,13,9,44.44
1962,Nepal,6,0.0,146,24,0.02,136,30,0.01,141,18,16,12.5
1962,Burundi,9,0.01,138,19,0.01,143,28,0.01,142,10,9,11.11
1962,Lesotho,5,0.0,152,20,0.01,142,25,0.01,143,15,16,-6.25
1962,Lao People's Democratic Republic,1,0.0,167,23,0.02,138,24,0.01,144,22,16,37.5
1962,The Gambia,10,0.01,135,13,0.01,146,23,0.01,145,3,4,-25.0
1962,Yemen,6,0.0,146,16,0.01,144,22,0.01,146,10,5,100.0
1962,Botswana,9,0.01,138,11,0.01,150,20,0.01,147,2,-1,-300.0
1962,Guinea-Bissau,8,0.01,143,12,0.01,148,20,0.01,147,4,1,300.0
1962,American Samoa,11,0.01,132,8,0.01,155,19,0.01,149,-3,-5,-40.0
1962,Rwanda,6,0.0,146,11,0.01,150,17,0.01,150,5,7,-28.57
1962,Antigua and Barbuda,3,0.0,159,13,0.01,146,16,0.01,151,10,9,11.11
1962,Samoa,8,0.01,143,8,0.01,155,16,0.01,151,0,2,-100.0
1962,Oman,2,0.0,162,12,0.01,148,14,0.0,153,10,23,-56.52
1962,Saint Lucia,4,0.0,154,10,0.01,153,14,0.0,153,6,3,100.0
1962,Grenada,4,0.0,154,9,0.01,154,13,0.0,155,5,6,-16.67
1962,Vanuatu,6,0.0,146,6,0.0,161,12,0.0,156,0,2,-100.0
1962,Saint Kitts and Nevis,5,0.0,152,7,0.0,157,12,0.0,156,2,-2,-200.0
1962,Sao Tomé and Principe,6,0.0,146,5,0.0,163,11,0.0,158,-1,-1,0.0
1962,Saint Vincent and the Grenadines,4,0.0,154,7,0.0,157,11,0.0,158,3,4,-25.0
1962,Dominica,4,0.0,154,7,0.0,157,11,0.0,158,3,2,50.0
1962,French Guiana,0,0.0,172,11,0.01,150,11,0.0,158,11,8,37.5
1962,Solomon Islands,4,0.0,154,6,0.0,161,10,0.0,162,2,1,100.0
1962,Cabo Verde,1,0.0,167,7,0.0,157,8,0.0,163,6,5,20.0
1962,Comoros,3,0.0,159,4,0.0,164,7,0.0,164,1,1,0.0
1962,Guam,6,0.0,146,0,0.0,172,6,0.0,165,-6,-8,-25.0
1962,Saint Pierre and Miquelon,2,0.0,162,4,0.0,164,6,0.0,165,2,3,-33.33
1962,Maldives,2,0.0,162,3,0.0,168,5,0.0,167,1,1,0.0
1962,Kiribati,1,0.0,167,4,0.0,164,5,0.0,167,3,3,0.0
1962,Tonga,2,0.0,162,3,0.0,168,5,0.0,167,1,0,
1962,Cook Islands,2,0.0,162,3,0.0,168,5,0.0,167,1,,
1962,Montserrat,1,0.0,167,4,0.0,164,5,0.0,167,3,3,0.0
1962,Seychelles,1,0.0,167,2,0.0,171,3,0.0,172,1,1,0.0
1961,United States of America,20190,14.9,1,15938,11.18,1,36128,12.99,1,-4252,-3255,30.63
1961,United Kingdom,11074,8.17,3,12729,8.93,2,23803,8.56,2,1655,2425,-31.75
1961,Germany,12651,9.33,2,11011,7.73,3,23662,8.51,3,-1640,-1244,31.83
1961,France,7224,5.33,4,6683,4.69,4,13907,5.0,4,-541,-584,-7.36
1961,Canada,6085,4.49,5,6062,4.25,6,12147,4.37,5,-23,255,-109.02
1961,U.S.S.R.,5998,4.43,6,5828,4.09,7,11826,4.25,6,-170,66,-357.58
1961,Netherlands,4957,3.66,7,6085,4.27,5,11042,3.97,7,1128,759,48.62
1961,Japan,4236,3.13,8,5810,4.08,8,10046,3.61,8,1574,436,261.01
1961,Italy,4184,3.09,9,5221,3.66,9,9405,3.38,9,1037,1077,-3.71
1961,Belgium-Luxembourg,3930,2.9,10,4224,2.96,10,8154,2.93,10,294,178,65.17
1961,Sweden,2745,2.03,11,2929,2.06,11,5674,2.04,11,184,335,-45.07
1961,Australia,2363,1.74,12,2369,1.66,13,4732,1.7,12,6,612,-99.02
1961,Switzerland,2017,1.49,17,2663,1.87,12,4680,1.68,13,646,347,86.17
1961,German Democratic Republic,2281,1.68,13,2251,1.58,15,4532,1.63,14,-30,-12,150.0
1961,Czech and Slovak Federal Republic,2046,1.51,16,2024,1.42,16,4070,1.46,15,-22,-114,-80.7
1961,China,1942,1.43,18,1747,1.23,18,3689,1.33,16,-195,77,-353.25
1961,India,1386,1.02,22,2286,1.6,14,3672,1.32,17,900,971,-7.31
1961,South Africa,2139,1.58,15,1460,1.02,22,3599,1.29,18,-679,-356,90.73
1961,"Venezuela, Bolivarian Republic of",2225,1.64,14,1197,0.84,26,3422,1.23,19,-1028,-1117,-7.97
1961,Denmark,1537,1.13,19,1873,1.31,17,3410,1.23,20,336,313,7.35
1961,Poland,1504,1.11,20,1687,1.18,19,3191,1.15,21,183,169,8.28
1961,Brazil,1403,1.04,21,1460,1.02,22,2863,1.03,22,57,194,-70.62
1961,Austria,1202,0.89,23,1485,1.04,21,2687,0.97,23,283,296,-4.39
1961,Norway,931,0.69,31,1616,1.13,20,2547,0.92,24,685,581,17.9
1961,Argentina,964,0.71,28,1460,1.02,22,2424,0.87,25,496,170,191.76
1961,Singapore,1081,0.8,24,1295,0.91,25,2376,0.85,26,214,197,8.63
1961,Finland,1054,0.78,26,1154,0.81,27,2208,0.79,27,100,75,33.33
1961,Hungary,1029,0.76,27,1026,0.72,31,2055,0.74,28,-3,102,-102.94
1961,Malaysia,1058,0.78,25,920,0.65,34,1978,0.71,29,-138,-277,-50.18
1961,Mexico,826,0.61,32,1139,0.8,28,1965,0.71,30,313,422,-25.83
1961,Spain,710,0.52,37,1092,0.77,29,1802,0.65,31,382,-3,-12833.33
1961,"Hong Kong, China",688,0.51,39,1045,0.73,30,1733,0.62,32,357,337,5.93
1961,New Zealand,793,0.59,33,901,0.63,36,1694,0.61,33,108,-61,-277.05
1961,Philippines,670,0.49,40,1006,0.71,33,1676,0.6,34,336,91,269.23
1961,Romania,793,0.59,33,880,0.62,37,1673,0.6,35,87,-17,-611.76
1961,Netherlands Antilles,709,0.52,38,871,0.61,38,1580,0.57,36,162,166,-2.41
1961,Indonesia,784,0.58,35,794,0.56,39,1578,0.57,37,10,-267,-103.75
1961,"Yugoslavia, Socialist Federal Republic of",569,0.42,44,910,0.64,35,1479,0.53,38,341,260,31.15
1961,Algeria,367,0.27,54,1024,0.72,32,1391,0.5,39,657,870,-24.48
1961,Iran,756,0.56,36,605,0.42,48,1361,0.49,40,-151,-76,98.68
1961,Bulgaria,663,0.49,41,666,0.47,45,1329,0.48,41,3,61,-95.08
1961,Cuba,625,0.46,43,703,0.49,43,1328,0.48,42,78,20,290.0
1961,Ireland,505,0.37,46,732,0.51,40,1237,0.44,43,227,207,9.66
1961,Chile,506,0.37,45,711,0.5,42,1217,0.44,44,205,137,49.64
1961,"Saudi Arabia, Kingdom of",956,0.71,30,261,0.18,63,1217,0.44,44,-695,-657,5.78
1961,"Kuwait, the State of",962,0.71,29,249,0.17,66,1211,0.44,46,-713,-720,-0.97
1961,Egypt,485,0.36,49,700,0.49,44,1185,0.43,47,215,100,115.0
1961,Nigeria,486,0.36,48,623,0.44,47,1109,0.4,48,137,142,-3.52
1961,Iraq,662,0.49,42,408,0.29,56,1070,0.38,49,-254,-265,-4.15
1961,Pakistan,424,0.31,52,594,0.42,49,1018,0.37,50,170,427,-60.19
1961,Colombia,433,0.32,51,557,0.39,51,990,0.36,51,124,52,138.46
1961,Portugal,331,0.24,59,655,0.46,46,986,0.35,52,324,218,48.62
1961,Peru,496,0.37,47,469,0.33,54,965,0.35,53,-27,-54,-50.0
1961,Thailand,475,0.35,50,489,0.34,53,964,0.35,54,14,47,-70.21
1961,Greece,223,0.16,63,714,0.5,41,937,0.34,55,491,499,-1.6
1961,Türkiye,347,0.26,55,507,0.36,52,854,0.31,56,160,147,8.84
1961,Israel,245,0.18,62,580,0.41,50,825,0.3,57,335,279,20.07
1961,Morocco,342,0.25,57,452,0.32,55,794,0.29,58,110,59,86.44
1961,Sri Lanka,380,0.28,53,358,0.25,58,738,0.27,59,-22,28,-178.57
1961,Ghana,322,0.24,60,400,0.28,57,722,0.26,60,78,38,105.26
1961,Trinidad and Tobago,346,0.26,56,341,0.24,59,687,0.25,61,-5,7,-171.43
1961,Zambia,335,0.25,58,228,0.16,69,563,0.2,62,-107,-152,-29.61
1961,Chinese Taipei,201,0.15,65,322,0.23,60,523,0.19,63,121,108,12.04
1961,Democratic Republic of the Congo,300,0.22,61,200,0.14,74,500,0.18,64,-100,-245,-59.18
1961,Zimbabwe,200,0.15,66,257,0.18,64,457,0.16,65,57,79,-27.85
1961,Myanmar,221,0.16,64,216,0.15,70,437,0.16,66,-5,38,-113.16
1961,"Yemen, People's Democratic Republic",182,0.13,69,235,0.16,68,417,0.15,67,53,54,-1.85
1961,Sudan,170,0.13,72,238,0.17,67,408,0.15,68,68,1,6700.0
1961,Uruguay,175,0.13,70,211,0.15,71,386,0.14,69,36,89,-59.55
1961,"Bahrain, Kingdom of",198,0.15,67,186,0.13,77,384,0.14,70,-12,-10,20.0
1961,Jamaica,172,0.13,71,211,0.15,71,383,0.14,71,39,58,-32.76
1961,Côte d'Ivoire,193,0.14,68,169,0.12,79,362,0.13,72,-24,-26,-7.69
1961,Lebanese Republic,41,0.03,107,316,0.22,61,357,0.13,73,275,212,29.72
1961,"Korea, Republic of",41,0.03,107,316,0.22,61,357,0.13,73,275,312,-11.86
1961,Viet Nam,71,0.05,95,255,0.18,65,326,0.12,75,184,154,19.48
1961,Tunisia,110,0.08,82,211,0.15,71,321,0.12,76,101,71,42.25
1961,Kenya,117,0.09,81,193,0.14,76,310,0.11,77,76,84,-9.52
1961,Syrian Arab Republic,110,0.08,82,199,0.14,75,309,0.11,78,89,126,-29.37
1961,Senegal,124,0.09,78,163,0.11,80,287,0.1,79,39,59,-33.9
1961,Tanzania,138,0.1,74,112,0.08,87,250,0.09,80,-26,-44,-40.91
1961,Angola,135,0.1,75,114,0.08,86,249,0.09,81,-21,4,-625.0
1961,Ecuador,126,0.09,77,107,0.08,89,233,0.08,82,-19,-32,-40.63
1961,Guatemala,110,0.08,82,121,0.08,84,231,0.08,83,11,8,37.5
1961,Uganda,135,0.1,75,95,0.07,96,230,0.08,84,-40,-38,5.26
1961,El Salvador,119,0.09,80,109,0.08,88,228,0.08,85,-10,6,-266.67
1961,Dominican Republic,143,0.11,73,80,0.06,104,223,0.08,86,-63,-80,-21.25
1961,Mozambique,89,0.07,86,129,0.09,83,218,0.08,87,40,52,-23.08
1961,Cameroon,98,0.07,85,96,0.07,95,194,0.07,88,-2,-13,-84.62
1961,Costa Rica,84,0.06,88,107,0.08,89,191,0.07,89,23,26,-11.54
1961,Madagascar,78,0.06,90,103,0.07,92,181,0.07,90,25,37,-32.43
1961,Sierra Leone,82,0.06,89,91,0.06,98,173,0.06,91,9,-9,-200.0
1961,Guyana,86,0.06,87,86,0.06,100,172,0.06,92,0,12,-100.0
1961,United Arab Emirates,2,0.0,160,170,0.12,78,172,0.06,92,168,158,6.33
1961,Ethiopia,76,0.06,92,95,0.07,96,171,0.06,94,19,10,90.0
1961,Libya,16,0.01,126,149,0.1,81,165,0.06,95,133,160,-16.88
1961,Qatar,122,0.09,79,40,0.03,121,162,0.06,96,-82,-94,-12.77
1961,Panama,24,0.02,119,136,0.1,82,160,0.06,97,112,99,13.13
1961,Cambodia,63,0.05,97,97,0.07,94,160,0.06,97,34,25,36.0
1961,Iceland,76,0.06,92,81,0.06,103,157,0.06,99,5,24,-79.17
1961,Cyprus,50,0.04,105,107,0.08,89,157,0.06,99,57,50,14.0
1961,Liberia,62,0.05,98,91,0.06,98,153,0.06,101,29,-14,-307.14
1961,Afghanistan,53,0.04,104,99,0.07,93,152,0.05,102,46,37,24.32
1961,Honduras,73,0.05,94,72,0.05,108,145,0.05,103,-1,9,-111.11
1961,Nicaragua,68,0.05,96,71,0.05,110,139,0.05,104,3,9,-66.67
1961,"Bolivia, Plurinational State of",58,0.04,100,78,0.05,106,136,0.05,105,20,20,0.0
1961,Jordan,15,0.01,127,117,0.08,85,132,0.05,106,102,109,-6.42
1961,Guinea,58,0.04,100,73,0.05,107,131,0.05,107,15,-1,-1600.0
1961,Mauritius,62,0.05,98,68,0.05,111,130,0.05,108,6,31,-80.65
1961,Albania,49,0.04,106,72,0.05,108,121,0.04,109,23,32,-28.13
1961,New Caledonia,56,0.04,102,48,0.03,117,104,0.04,110,-8,-13,-38.46
1961,Papua New Guinea,37,0.03,111,66,0.05,112,103,0.04,111,29,22,31.82
1961,Congo,20,0.01,123,79,0.06,105,99,0.04,112,59,52,13.46
1961,Suriname,41,0.03,107,54,0.04,114,95,0.03,113,13,10,30.0
1961,Malta,13,0.01,133,82,0.06,102,95,0.03,113,69,72,-4.17
1961,Reunion,37,0.03,111,58,0.04,113,95,0.03,113,21,15,40.0
1961,Brunei Darussalam,77,0.06,91,16,0.01,144,93,0.03,116,-61,-66,-7.58
1961,Bahamas,8,0.01,142,85,0.06,101,93,0.03,116,77,60,28.33
1961,Gabon,55,0.04,103,36,0.03,124,91,0.03,118,-19,-15,26.67
1961,Guadeloupe,36,0.03,113,52,0.04,115,88,0.03,119,16,13,23.08
1961,Martinique,34,0.03,114,51,0.04,116,85,0.03,120,17,15,13.33
1961,Fiji,40,0.03,110,43,0.03,119,83,0.03,121,3,-5,-160.0
1961,Barbados,25,0.02,118,47,0.03,118,72,0.03,122,22,25,-12.0
1961,Paraguay,30,0.02,116,41,0.03,120,71,0.03,123,11,10,10.0
1961,Malawi,26,0.02,117,40,0.03,121,66,0.02,124,14,15,-6.67
1961,Haiti,32,0.02,115,33,0.02,126,65,0.02,125,1,7,-85.71
1961,Djibouti,22,0.02,121,38,0.03,123,60,0.02,126,16,12,33.33
1961,Mali,14,0.01,130,36,0.03,124,50,0.02,127,22,20,10.0
1961,Chad,21,0.02,122,25,0.02,131,46,0.02,128,4,12,-66.67
1961,"Macao, China",14,0.01,130,32,0.02,127,46,0.02,128,18,19,-5.26
1961,Togo,19,0.01,124,26,0.02,130,45,0.02,130,7,11,-36.36
1961,Equatorial Guinea,23,0.02,120,19,0.01,139,42,0.02,131,-4,-18,-77.78
1961,Benin,15,0.01,127,25,0.02,131,40,0.01,132,10,13,-23.08
1961,Eswatini,18,0.01,125,20,0.01,137,38,0.01,133,2,0,
1961,Central African Republic,14,0.01,130,22,0.02,135,36,0.01,134,8,6,33.33
1961,French Polynesia,12,0.01,134,23,0.02,134,35,0.01,135,11,5,120.0
1961,Niger,15,0.01,127,19,0.01,139,34,0.01,136,4,0,
1961,Mauritania,2,0.0,160,31,0.02,128,33,0.01,137,29,22,31.82
1961,Burkina Faso,4,0.0,152,28,0.02,129,32,0.01,138,24,7,242.86
1961,Yemen,11,0.01,135,16,0.01,144,27,0.01,139,5,5,0.0
1961,Oman,2,0.0,160,25,0.02,131,27,0.01,139,23,18,27.78
1961,Nepal,5,0.0,147,21,0.01,136,26,0.01,141,16,21,-23.81
1961,Burundi,8,0.01,142,17,0.01,141,25,0.01,142,9,14,-35.71
1961,Belize,9,0.01,137,16,0.01,144,25,0.01,142,7,5,40.0
1961,Greenland,8,0.01,142,17,0.01,141,25,0.01,142,9,8,12.5
1961,Lesotho,4,0.0,152,20,0.01,137,24,0.01,145,16,13,23.08
1961,The Gambia,9,0.01,137,13,0.01,147,22,0.01,146,4,1,300.0
1961,Guinea-Bissau,9,0.01,137,10,0.01,150,19,0.01,147,1,7,-85.71
1961,Saint Kitts and Nevis,10,0.01,136,8,0.01,152,18,0.01,148,-2,1,-300.0
1961,Lao People's Democratic Republic,1,0.0,166,17,0.01,141,18,0.01,148,16,18,-11.11
1961,Botswana,9,0.01,137,8,0.01,152,17,0.01,150,-1,1,-200.0
1961,Rwanda,5,0.0,147,12,0.01,148,17,0.01,150,7,10,-30.0
1961,Antigua and Barbuda,2,0.0,160,11,0.01,149,13,0.0,152,9,7,28.57
1961,American Samoa,9,0.01,137,4,0.0,164,13,0.0,152,-5,-3,66.67
1961,Saint Lucia,5,0.0,147,8,0.01,152,13,0.0,152,3,4,-25.0
1961,Vanuatu,5,0.0,147,7,0.0,156,12,0.0,155,2,2,0.0
1961,Samoa,5,0.0,147,7,0.0,156,12,0.0,155,2,0,
1961,Grenada,3,0.0,156,9,0.01,151,12,0.0,155,6,5,20.0
1961,Sao Tomé and Principe,6,0.0,146,5,0.0,161,11,0.0,158,-1,-2,-50.0
1961,Saint Vincent and the Grenadines,3,0.0,156,7,0.0,156,10,0.0,159,4,5,-20.0
1961,Dominica,4,0.0,152,6,0.0,159,10,0.0,159,2,2,0.0
1961,Solomon Islands,4,0.0,152,5,0.0,161,9,0.0,161,1,1,0.0
1961,Guam,8,0.01,142,0,0.0,171,8,0.0,162,-8,-8,0.0
1961,French Guiana,0,0.0,171,8,0.01,152,8,0.0,162,8,8,0.0
1961,Comoros,3,0.0,156,4,0.0,164,7,0.0,164,1,1,0.0
1961,Cabo Verde,1,0.0,166,6,0.0,159,7,0.0,164,5,1,400.0
1961,Saint Pierre and Miquelon,2,0.0,160,5,0.0,161,7,0.0,164,3,2,50.0
1961,Tonga,3,0.0,156,3,0.0,168,6,0.0,167,0,0,
1961,Maldives,2,0.0,160,3,0.0,168,5,0.0,168,1,2,-50.0
1961,Kiribati,1,0.0,166,4,0.0,164,5,0.0,168,3,1,200.0
1961,Montserrat,1,0.0,166,4,0.0,164,5,0.0,168,3,3,0.0
1961,Seychelles,1,0.0,166,2,0.0,170,3,0.0,171,1,0,
1960,United States of America,19626,15.14,1,16371,11.96,1,35997,13.5,1,-3255,601,-641.6
1960,United Kingdom,10609,8.18,3,13034,9.52,2,23643,8.87,2,2425,1493,62.42
1960,Germany,11416,8.81,2,10172,7.43,3,21588,8.1,3,-1244,-1276,-2.51
1960,France,6866,5.3,4,6282,4.59,4,13148,4.93,4,-584,-527,10.82
1960,Canada,5818,4.49,5,6073,4.44,5,11891,4.46,5,255,526,-51.52
1960,U.S.S.R.,5564,4.29,6,5630,4.11,6,11194,4.2,6,66,-377,-117.51
1960,Netherlands,4602,3.55,7,5361,3.92,7,9963,3.74,7,759,527,44.02
1960,Japan,4055,3.13,8,4491,3.28,9,8546,3.21,8,436,143,204.9
1960,Italy,3657,2.82,10,4734,3.46,8,8391,3.15,9,1077,460,134.13
1960,Belgium-Luxembourg,3792,2.92,9,3970,2.9,10,7762,2.91,10,178,146,21.92
1960,Sweden,2566,1.98,12,2901,2.12,11,5467,2.05,11,335,206,62.62
1960,China,2571,1.98,11,2648,1.93,13,5219,1.96,12,77,-280,-127.5
1960,Australia,2050,1.58,15,2662,1.94,12,4712,1.77,13,612,82,646.34
1960,German Democratic Republic,2207,1.7,14,2195,1.6,16,4402,1.65,14,-12,-132,-90.91
1960,Switzerland,1859,1.43,18,2206,1.61,15,4065,1.52,15,347,228,52.19
1960,Czech and Slovak Federal Republic,1930,1.49,17,1816,1.33,17,3746,1.41,16,-114,-125,-8.8
1960,India,1332,1.03,20,2303,1.68,14,3635,1.36,17,971,667,45.58
1960,South Africa,1985,1.53,16,1629,1.19,19,3614,1.36,18,-356,-484,-26.45
1960,"Venezuela, Bolivarian Republic of",2305,1.78,13,1188,0.87,27,3493,1.31,19,-1117,-636,75.63
1960,Denmark,1494,1.15,19,1807,1.32,18,3301,1.24,20,313,204,53.43
1960,Poland,1326,1.02,21,1495,1.09,20,2821,1.06,21,169,275,-38.55
1960,Brazil,1268,0.98,22,1462,1.07,21,2730,1.02,22,194,92,110.87
1960,Austria,1120,0.86,25,1416,1.03,23,2536,0.95,23,296,177,67.23
1960,Singapore,1136,0.88,24,1333,0.97,24,2469,0.93,24,197,153,28.76
1960,Norway,881,0.68,30,1462,1.07,21,2343,0.88,25,581,513,13.26
1960,Argentina,1079,0.83,26,1249,0.91,26,2328,0.87,26,170,-16,-1162.5
1960,Malaysia,1187,0.92,23,910,0.66,32,2097,0.79,27,-277,-273,1.47
1960,Finland,989,0.76,27,1064,0.78,29,2053,0.77,28,75,0,
1960,Mexico,764,0.59,34,1186,0.87,28,1950,0.73,29,422,254,66.14
1960,Hungary,874,0.67,31,976,0.71,31,1850,0.69,30,102,23,343.48
1960,"Hong Kong, China",689,0.53,37,1026,0.75,30,1715,0.64,31,337,292,15.41
1960,Algeria,394,0.3,54,1264,0.92,25,1658,0.62,32,870,774,12.4
1960,New Zealand,847,0.65,32,786,0.57,36,1633,0.61,33,-61,-175,-65.14
1960,Netherlands Antilles,658,0.51,38,824,0.6,35,1482,0.56,34,166,227,-26.87
1960,Spain,725,0.56,35,722,0.53,37,1447,0.54,35,-3,294,-101.02
1960,Romania,717,0.55,36,700,0.51,40,1417,0.53,36,-17,20,-185.0
1960,Indonesia,841,0.65,33,574,0.42,47,1415,0.53,37,-267,-448,-40.4
1960,"Yugoslavia, Socialist Federal Republic of",566,0.44,45,826,0.6,34,1392,0.52,38,260,210,23.81
1960,Philippines,624,0.48,41,715,0.52,38,1339,0.5,39,91,48,89.58
1960,Cuba,618,0.48,42,638,0.47,42,1256,0.47,40,20,104,-80.77
1960,Egypt,568,0.44,44,668,0.49,41,1236,0.46,41,100,177,-43.5
1960,Pakistan,400,0.31,53,827,0.6,33,1227,0.46,42,427,8,5237.5
1960,Bulgaria,572,0.44,43,633,0.46,44,1205,0.45,43,61,113,-46.02
1960,"Kuwait, the State of",962,0.74,28,242,0.18,65,1204,0.45,44,-720,-572,25.87
1960,Iran,636,0.49,40,560,0.41,48,1196,0.45,45,-76,-174,-56.32
1960,"Saudi Arabia, Kingdom of",891,0.69,29,234,0.17,69,1125,0.42,46,-657,-702,-6.41
1960,Chile,488,0.38,46,625,0.46,45,1113,0.42,47,137,-4,-3525.0
1960,Nigeria,462,0.36,49,604,0.44,46,1066,0.4,48,142,45,215.56
1960,Ireland,427,0.33,51,634,0.46,43,1061,0.4,49,207,229,-9.61
1960,Iraq,654,0.5,39,389,0.28,56,1043,0.39,50,-265,-279,-5.02
1960,Colombia,465,0.36,48,517,0.38,50,982,0.37,51,52,-58,-189.66
1960,Greece,203,0.16,64,702,0.51,39,905,0.34,52,499,363,37.47
1960,Portugal,326,0.25,58,544,0.4,49,870,0.33,53,218,186,17.2
1960,Thailand,407,0.31,52,454,0.33,53,861,0.32,54,47,68,-30.88
1960,Peru,433,0.33,50,379,0.28,57,812,0.3,55,-54,-22,145.45
1960,Sri Lanka,385,0.3,55,413,0.3,54,798,0.3,56,28,68,-58.82
1960,Türkiye,321,0.25,60,468,0.34,52,789,0.3,57,147,116,26.72
1960,Morocco,354,0.27,57,413,0.3,54,767,0.29,58,59,3,1866.67
1960,Democratic Republic of the Congo,480,0.37,47,235,0.17,68,715,0.27,59,-245,-181,35.36
1960,Israel,217,0.17,63,496,0.36,51,713,0.27,60,279,257,8.56
1960,Ghana,325,0.25,59,363,0.27,58,688,0.26,61,38,3,1166.67
1960,Trinidad and Tobago,287,0.22,61,294,0.21,60,581,0.22,62,7,-1,-800.0
1960,Zambia,362,0.28,56,210,0.15,73,572,0.21,63,-152,-136,11.76
1960,Myanmar,224,0.17,62,262,0.19,62,486,0.18,64,38,-1,-3900.0
1960,Chinese Taipei,164,0.13,69,272,0.2,61,436,0.16,65,108,57,89.47
1960,Zimbabwe,173,0.13,68,252,0.18,64,425,0.16,66,79,86,-8.14
1960,"Yemen, People's Democratic Republic",163,0.13,70,217,0.16,71,380,0.14,67,54,30,80.0
1960,Jamaica,159,0.12,71,217,0.16,71,376,0.14,68,58,63,-7.94
1960,"Korea, Republic of",32,0.02,115,344,0.25,59,376,0.14,68,312,284,9.86
1960,"Bahrain, Kingdom of",190,0.15,65,180,0.13,77,370,0.14,70,-10,-11,-9.09
1960,Sudan,182,0.14,66,183,0.13,76,365,0.14,71,1,-28,-103.57
1960,Syrian Arab Republic,113,0.09,81,239,0.17,67,352,0.13,72,126,75,68.0
1960,Uruguay,129,0.1,75,218,0.16,70,347,0.13,73,89,65,36.92
1960,Viet Nam,86,0.07,86,240,0.18,66,326,0.12,74,154,150,2.67
1960,Tunisia,120,0.09,79,191,0.14,75,311,0.12,75,71,11,545.45
1960,Kenya,112,0.09,84,196,0.14,74,308,0.12,76,84,65,29.23
1960,Lebanese Republic,43,0.03,108,255,0.19,63,298,0.11,77,212,182,16.48
1960,Côte d'Ivoire,157,0.12,72,131,0.1,81,288,0.11,78,-26,-13,100.0
1960,Senegal,113,0.09,81,172,0.13,78,285,0.11,79,59,62,-4.84
1960,Dominican Republic,180,0.14,67,100,0.07,93,280,0.11,80,-80,5,-1700.0
1960,Tanzania,155,0.12,73,111,0.08,90,266,0.1,81,-44,-23,91.3
1960,Ecuador,146,0.11,74,114,0.08,88,260,0.1,82,-32,-42,-23.81
1960,Angola,124,0.1,78,128,0.09,82,252,0.09,83,4,10,-60.0
1960,El Salvador,117,0.09,80,123,0.09,84,240,0.09,84,6,-13,-146.15
1960,Guatemala,113,0.09,81,121,0.09,85,234,0.09,85,8,16,-50.0
1960,Uganda,129,0.1,75,91,0.07,96,220,0.08,86,-38,-46,-17.39
1960,Mozambique,75,0.06,92,127,0.09,83,202,0.08,87,52,54,-3.7
1960,Costa Rica,84,0.06,87,110,0.08,91,194,0.07,88,26,26,0.0
1960,Madagascar,75,0.06,92,112,0.08,89,187,0.07,89,37,44,-15.91
1960,Cameroon,97,0.07,85,84,0.06,100,181,0.07,90,-13,-26,-50.0
1960,Libya,9,0.01,137,169,0.12,79,178,0.07,91,160,104,53.85
1960,Iceland,73,0.06,95,97,0.07,94,170,0.06,92,24,30,-20.0
1960,Ethiopia,78,0.06,91,88,0.06,97,166,0.06,93,10,12,-16.67
1960,Cambodia,70,0.05,96,95,0.07,95,165,0.06,94,25,10,150.0
1960,United Arab Emirates,2,0.0,161,160,0.12,80,162,0.06,95,158,143,10.49
1960,Guyana,74,0.06,94,86,0.06,99,160,0.06,96,12,4,200.0
1960,Cyprus,54,0.04,99,104,0.08,92,158,0.06,97,50,62,-19.35
1960,Qatar,126,0.1,77,32,0.02,126,158,0.06,97,-94,-96,-2.08
1960,Sierra Leone,83,0.06,88,74,0.05,103,157,0.06,99,-9,11,-181.82
1960,Liberia,83,0.06,88,69,0.05,109,152,0.06,100,-14,-24,-41.67
1960,Panama,21,0.02,120,120,0.09,86,141,0.05,101,99,82,20.73
1960,Afghanistan,50,0.04,103,87,0.06,98,137,0.05,102,37,31,19.35
1960,Nicaragua,63,0.05,97,72,0.05,104,135,0.05,103,9,-5,-280.0
1960,Honduras,63,0.05,97,72,0.05,104,135,0.05,103,9,2,350.0
1960,Jordan,11,0.01,132,120,0.09,86,131,0.05,105,109,103,5.83
1960,Albania,49,0.04,104,81,0.06,102,130,0.05,106,32,51,-37.25
1960,"Bolivia, Plurinational State of",51,0.04,100,71,0.05,106,122,0.05,107,20,4,400.0
1960,Mauritius,39,0.03,109,70,0.05,107,109,0.04,108,31,-1,-3200.0
1960,Guinea,51,0.04,100,50,0.04,114,101,0.04,109,-1,33,-103.03
1960,Brunei Darussalam,83,0.06,88,17,0.01,138,100,0.04,110,-66,-81,-18.52
1960,Suriname,44,0.03,107,54,0.04,112,98,0.04,111,10,4,150.0
1960,Papua New Guinea,38,0.03,110,60,0.04,111,98,0.04,111,22,11,100.0
1960,Malta,11,0.01,132,83,0.06,101,94,0.04,113,72,67,7.46
1960,New Caledonia,51,0.04,100,38,0.03,121,89,0.03,114,-13,-2,550.0
1960,Reunion,37,0.03,111,52,0.04,113,89,0.03,114,15,15,0.0
1960,Congo,18,0.01,122,70,0.05,107,88,0.03,116,52,42,23.81
1960,Fiji,46,0.04,106,41,0.03,118,87,0.03,117,-5,2,-350.0
1960,Guadeloupe,35,0.03,112,48,0.04,116,83,0.03,118,13,7,85.71
1960,Martinique,32,0.02,115,47,0.03,117,79,0.03,119,15,12,25.0
1960,Gabon,47,0.04,105,32,0.02,126,79,0.03,119,-15,-17,-11.76
1960,Barbados,24,0.02,119,49,0.04,115,73,0.03,121,25,17,47.06
1960,Haiti,33,0.03,114,40,0.03,119,73,0.03,121,7,6,16.67
1960,Bahamas,6,0.0,147,66,0.05,110,72,0.03,123,60,64,-6.25
1960,Paraguay,28,0.02,117,38,0.03,121,66,0.02,124,10,-2,-600.0
1960,Malawi,25,0.02,118,40,0.03,119,65,0.02,125,15,15,0.0
1960,Nepal,17,0.01,124,38,0.03,121,55,0.02,126,21,27,-22.22
1960,Djibouti,21,0.02,120,33,0.02,124,54,0.02,127,12,12,0.0
1960,Equatorial Guinea,34,0.03,113,16,0.01,141,50,0.02,128,-18,-14,28.57
1960,Benin,18,0.01,122,31,0.02,128,49,0.02,129,13,7,85.71
1960,Mali,13,0.01,128,33,0.02,124,46,0.02,130,20,20,0.0
1960,Togo,15,0.01,126,26,0.02,130,41,0.02,131,11,-3,-466.67
1960,"Macao, China",11,0.01,132,30,0.02,129,41,0.02,131,19,17,11.76
1960,Chad,13,0.01,128,25,0.02,131,38,0.01,133,12,8,50.0
1960,Central African Republic,14,0.01,127,20,0.01,134,34,0.01,134,6,2,200.0
1960,Eswatini,17,0.01,124,17,0.01,138,34,0.01,134,0,-3,-100.0
1960,French Polynesia,13,0.01,128,18,0.01,137,31,0.01,136,5,1,400.0
1960,Burundi,7,0.01,144,21,0.02,133,28,0.01,137,14,3,366.67
1960,Yemen,11,0.01,132,16,0.01,141,27,0.01,138,5,5,0.0
1960,Niger,13,0.01,128,13,0.01,145,26,0.01,139,0,-5,-100.0
1960,Mauritania,2,0.0,161,24,0.02,132,26,0.01,139,22,22,0.0
1960,Greenland,8,0.01,138,16,0.01,141,24,0.01,141,8,7,14.29
1960,Cabo Verde,11,0.01,132,12,0.01,147,23,0.01,142,1,2,-50.0
1960,Oman,2,0.0,161,20,0.01,134,22,0.01,143,18,15,20.0
1960,Lesotho,4,0.0,150,17,0.01,138,21,0.01,144,13,11,18.18
1960,Belize,8,0.01,138,13,0.01,145,21,0.01,144,5,7,-28.57
1960,Lao People's Democratic Republic,1,0.0,169,19,0.01,136,20,0.01,146,18,26,-30.77
1960,Rwanda,4,0.0,150,14,0.01,144,18,0.01,147,10,0,
1960,Botswana,8,0.01,138,9,0.01,150,17,0.01,148,1,1,0.0
1960,The Gambia,8,0.01,138,9,0.01,150,17,0.01,148,1,1,0.0
1960,Guinea-Bissau,4,0.0,150,11,0.01,148,15,0.01,150,7,1,600.0
1960,Burkina Faso,4,0.0,150,11,0.01,148,15,0.01,150,7,3,133.33
1960,Samoa,7,0.01,144,7,0.01,156,14,0.01,152,0,-2,-100.0
1960,American Samoa,8,0.01,138,5,0.0,161,13,0.0,153,-3,-3,0.0
1960,Saint Kitts and Nevis,6,0.0,147,7,0.01,156,13,0.0,153,1,1,0.0
1960,Grenada,4,0.0,150,9,0.01,150,13,0.0,153,5,3,66.67
1960,Sao Tomé and Principe,7,0.01,144,5,0.0,161,12,0.0,156,-2,0,
1960,Vanuatu,5,0.0,149,7,0.01,156,12,0.0,156,2,-1,-300.0
1960,Antigua and Barbuda,2,0.0,161,9,0.01,150,11,0.0,158,7,5,40.0
1960,Saint Vincent and the Grenadines,3,0.0,158,8,0.01,154,11,0.0,158,5,2,150.0
1960,Dominica,4,0.0,150,6,0.0,160,10,0.0,160,2,2,0.0
1960,Saint Lucia,3,0.0,158,7,0.01,156,10,0.0,160,4,2,100.0
1960,Solomon Islands,4,0.0,150,5,0.0,161,9,0.0,162,1,-2,-150.0
1960,Guam,8,0.01,138,0,0.0,171,8,0.0,163,-8,-7,14.29
1960,Tonga,4,0.0,150,4,0.0,164,8,0.0,163,0,0,
1960,French Guiana,0,0.0,170,8,0.01,154,8,0.0,163,8,6,33.33
1960,Comoros,3,0.0,158,4,0.0,164,7,0.0,166,1,0,
1960,Maldives,2,0.0,161,4,0.0,164,6,0.0,167,2,2,0.0
1960,Saint Pierre and Miquelon,2,0.0,161,4,0.0,164,6,0.0,167,2,2,0.0
1960,Kiribati,2,0.0,161,3,0.0,168,5,0.0,169,1,1,0.0
1960,Seychelles,2,0.0,161,2,0.0,170,4,0.0,170,0,0,
1960,Montserrat,0,0.0,170,3,0.0,168,3,0.0,171,3,2,50.0
1959,United States of America,16407,13.98,1,17008,13.85,1,33415,13.92,1,601,-1749,-134.36
1959,United Kingdom,9951,8.48,2,11444,9.32,2,21395,8.91,2,1493,1240,20.4
1959,Germany,9807,8.36,3,8531,6.95,3,18338,7.64,3,-1276,-1180,8.14
1959,Canada,5617,4.79,5,6143,5.0,4,11760,4.9,4,526,340,54.71
1959,France,5621,4.79,4,5094,4.15,5,10715,4.46,5,-527,487,-208.21
1959,U.S.S.R.,5450,4.65,6,5073,4.13,6,10523,4.38,6,-377,52,-825.0
1959,Netherlands,4135,3.52,7,4662,3.8,7,8797,3.66,7,527,574,-8.19
1959,Japan,3456,2.95,8,3599,2.93,8,7055,2.94,8,143,160,-10.63
1959,Belgium-Luxembourg,3306,2.82,9,3452,2.81,9,6758,2.81,9,146,80,82.5
1959,Italy,2929,2.5,11,3389,2.76,10,6318,2.63,10,460,642,-28.35
1959,China,3172,2.7,10,2892,2.35,11,6064,2.53,11,-280,-220,27.27
1959,Sweden,2208,1.88,13,2414,1.97,12,4622,1.92,12,206,281,-26.69
1959,German Democratic Republic,2143,1.83,14,2011,1.64,14,4154,1.73,13,-132,-214,-38.32
1959,Australia,2007,1.71,15,2089,1.7,13,4096,1.71,14,82,352,-76.7
1959,"Venezuela, Bolivarian Republic of",2214,1.89,12,1578,1.28,19,3792,1.58,15,-636,-727,-12.52
1959,Switzerland,1663,1.42,18,1891,1.54,16,3554,1.48,16,228,157,45.22
1959,South Africa,1921,1.64,16,1437,1.17,20,3358,1.4,17,-484,-89,443.82
1959,Czech and Slovak Federal Republic,1727,1.47,17,1602,1.3,17,3329,1.39,18,-125,-156,-19.87
1959,India,1323,1.13,20,1990,1.62,15,3313,1.38,19,667,427,56.21
1959,Denmark,1398,1.19,19,1602,1.3,17,3000,1.25,20,204,79,158.23
1959,Brazil,1282,1.09,21,1374,1.12,22,2656,1.11,21,92,110,-16.36
1959,Poland,1145,0.98,22,1420,1.16,21,2565,1.07,22,275,167,64.67
1959,Singapore,1124,0.96,23,1277,1.04,24,2401,1.0,23,153,163,-6.13
1959,Norway,810,0.69,32,1323,1.08,23,2133,0.89,24,513,566,-9.36
1959,Austria,968,0.83,26,1145,0.93,25,2113,0.88,25,177,156,13.46
1959,Argentina,1009,0.86,25,993,0.81,28,2002,0.83,26,-16,239,-106.69
1959,Malaysia,1039,0.89,24,766,0.62,34,1805,0.75,27,-273,-85,221.18
1959,Mexico,753,0.64,34,1007,0.82,27,1760,0.73,28,254,393,-35.37
1959,Finland,835,0.71,29,835,0.68,31,1670,0.7,29,0,-44,-100.0
1959,Netherlands Antilles,712,0.61,35,939,0.76,29,1651,0.69,30,227,279,-18.64
1959,Hungary,770,0.66,33,793,0.65,33,1563,0.65,31,23,-53,-143.4
1959,Algeria,366,0.31,52,1140,0.93,26,1506,0.63,32,774,642,20.56
1959,New Zealand,822,0.7,31,647,0.53,37,1469,0.61,33,-175,96,-282.29
1959,"Hong Kong, China",574,0.49,39,866,0.71,30,1440,0.6,34,292,281,3.91
1959,Indonesia,931,0.79,28,483,0.39,47,1414,0.59,35,-448,-247,81.38
1959,Cuba,638,0.54,37,742,0.6,35,1380,0.57,36,104,45,131.11
1959,Spain,501,0.43,42,795,0.65,32,1296,0.54,37,294,386,-23.83
1959,"Saudi Arabia, Kingdom of",957,0.82,27,255,0.21,63,1212,0.5,38,-702,-615,14.15
1959,Iran,676,0.58,36,502,0.41,45,1178,0.49,39,-174,-266,-34.59
1959,"Yugoslavia, Socialist Federal Republic of",477,0.41,45,687,0.56,36,1164,0.48,40,210,244,-13.93
1959,Philippines,530,0.45,40,578,0.47,41,1108,0.46,41,48,134,-64.18
1959,Egypt,461,0.39,48,638,0.52,38,1099,0.46,42,177,212,-16.51
1959,"Kuwait, the State of",830,0.71,30,258,0.21,62,1088,0.45,43,-572,-720,-20.56
1959,Romania,522,0.44,41,542,0.44,43,1064,0.44,44,20,52,-61.54
1959,Bulgaria,467,0.4,47,580,0.47,40,1047,0.44,45,113,-6,-1983.33
1959,Chile,495,0.42,43,491,0.4,46,986,0.41,46,-4,108,-103.7
1959,Ireland,366,0.31,52,595,0.48,39,961,0.4,47,229,189,21.16
1959,Nigeria,458,0.39,49,503,0.41,44,961,0.4,47,45,88,-48.86
1959,Iraq,605,0.52,38,326,0.27,55,931,0.39,49,-279,-258,8.14
1959,Colombia,473,0.4,46,415,0.34,53,888,0.37,50,-58,-61,-4.92
1959,Türkiye,354,0.3,55,470,0.38,49,824,0.34,51,116,68,70.59
1959,Sri Lanka,368,0.31,51,436,0.36,50,804,0.33,52,68,2,3300.0
1959,Democratic Republic of the Congo,489,0.42,44,308,0.25,57,797,0.33,53,-181,-44,311.36
1959,Thailand,357,0.3,54,425,0.35,52,782,0.33,54,68,85,-20.0
1959,Greece,204,0.17,63,567,0.46,42,771,0.32,55,363,333,9.01
1959,Portugal,290,0.25,60,476,0.39,48,766,0.32,56,186,191,-2.62
1959,Pakistan,369,0.31,50,377,0.31,54,746,0.31,57,8,68,-88.24
1959,Ghana,313,0.27,58,316,0.26,56,629,0.26,58,3,-56,-105.36
1959,Israel,179,0.15,65,436,0.36,50,615,0.26,59,257,282,-8.87
1959,Peru,314,0.27,57,292,0.24,60,606,0.25,60,-22,35,-162.86
1959,Morocco,297,0.25,59,300,0.24,59,597,0.25,61,3,55,-94.55
1959,Trinidad and Tobago,262,0.22,61,261,0.21,61,523,0.22,62,-1,-8,-87.5
1959,Zambia,329,0.28,56,193,0.16,71,522,0.22,63,-136,-31,338.71
1959,Myanmar,224,0.19,62,223,0.18,66,447,0.19,64,-1,10,-110.0
1959,Zimbabwe,161,0.14,68,247,0.2,64,408,0.17,65,86,105,-18.1
1959,"Yemen, People's Democratic Republic",175,0.15,67,205,0.17,69,380,0.16,66,30,25,20.0
1959,Chinese Taipei,156,0.13,69,213,0.17,68,369,0.15,67,57,70,-18.57
1959,Sudan,192,0.16,64,164,0.13,77,356,0.15,68,-28,46,-160.87
1959,"Bahrain, Kingdom of",179,0.15,65,168,0.14,76,347,0.14,69,-11,-45,-75.56
1959,"Korea, Republic of",20,0.02,120,304,0.25,58,324,0.13,70,284,364,-21.98
1959,Jamaica,129,0.11,75,192,0.16,72,321,0.13,71,63,48,31.25
1959,Syrian Arab Republic,119,0.1,79,194,0.16,70,313,0.13,72,75,89,-15.73
1959,Viet Nam,75,0.06,89,225,0.18,65,300,0.12,73,150,177,-15.25
1959,Tunisia,142,0.12,70,153,0.12,78,295,0.12,74,11,2,450.0
1959,Senegal,116,0.1,80,178,0.14,73,294,0.12,75,62,72,-13.89
1959,Uruguay,108,0.09,82,173,0.14,74,281,0.12,76,65,-12,-641.67
1959,Kenya,107,0.09,84,172,0.14,75,279,0.12,77,65,77,-15.58
1959,Côte d'Ivoire,141,0.12,71,128,0.1,82,269,0.11,78,-13,-41,-68.29
1959,Dominican Republic,130,0.11,74,135,0.11,80,265,0.11,79,5,12,-58.33
1959,Lebanese Republic,40,0.03,106,222,0.18,67,262,0.11,80,182,131,38.93
1959,Angola,121,0.1,78,131,0.11,81,252,0.1,81,10,2,400.0
1959,Ecuador,141,0.12,71,99,0.08,93,240,0.1,82,-42,-29,44.83
1959,Tanzania,129,0.11,75,106,0.09,90,235,0.1,83,-23,-27,-14.81
1959,Uganda,136,0.12,73,90,0.07,95,226,0.09,84,-46,-51,-9.8
1959,Guatemala,102,0.09,85,118,0.1,85,220,0.09,85,16,31,-48.39
1959,El Salvador,113,0.1,81,100,0.08,92,213,0.09,86,-13,-8,62.5
1959,Madagascar,76,0.06,88,120,0.1,83,196,0.08,87,44,31,41.94
1959,Cameroon,108,0.09,82,82,0.07,98,190,0.08,88,-26,-8,225.0
1959,Mozambique,66,0.06,94,120,0.1,83,186,0.08,89,54,44,22.73
1959,Costa Rica,77,0.07,87,103,0.08,91,180,0.07,90,26,7,271.43
1959,Cyprus,53,0.05,101,115,0.09,86,168,0.07,91,62,54,14.81
1959,Iceland,65,0.06,95,95,0.08,94,160,0.07,92,30,20,50.0
1959,Qatar,128,0.11,77,32,0.03,122,160,0.07,92,-96,-112,-14.29
1959,Ethiopia,72,0.06,90,84,0.07,97,156,0.06,94,12,15,-20.0
1959,United Arab Emirates,2,0.0,161,145,0.12,79,147,0.06,95,143,141,1.42
1959,Honduras,69,0.06,92,71,0.06,101,140,0.06,96,2,17,-88.24
1959,Nicaragua,72,0.06,90,67,0.05,104,139,0.06,97,-5,7,-171.43
1959,Panama,25,0.02,118,107,0.09,89,132,0.05,98,82,85,-3.53
1959,Afghanistan,50,0.04,102,81,0.07,99,131,0.05,99,31,13,138.46
1959,Cambodia,60,0.05,99,70,0.06,102,130,0.05,100,10,20,-50.0
1959,"Bolivia, Plurinational State of",61,0.05,96,65,0.05,106,126,0.05,101,4,27,-85.19
1959,Guyana,61,0.05,96,65,0.05,106,126,0.05,101,4,11,-63.64
1959,Libya,10,0.01,133,114,0.09,87,124,0.05,103,104,85,22.35
1959,Jordan,10,0.01,133,113,0.09,88,123,0.05,104,103,85,21.18
1959,Brunei Darussalam,101,0.09,86,20,0.02,132,121,0.05,105,-81,-81,0.0
1959,Sierra Leone,55,0.05,100,66,0.05,105,121,0.05,105,11,12,-8.33
1959,Mauritius,61,0.05,96,60,0.05,109,121,0.05,105,-1,2,-150.0
1959,Albania,34,0.03,109,85,0.07,96,119,0.05,108,51,50,2.0
1959,Liberia,67,0.06,93,43,0.04,115,110,0.05,109,-24,-16,50.0
1959,Papua New Guinea,40,0.03,106,51,0.04,111,91,0.04,110,11,14,-21.43
1959,Guinea,29,0.02,114,62,0.05,108,91,0.04,110,33,26,26.92
1959,Malta,11,0.01,130,78,0.06,100,89,0.04,112,67,71,-5.63
1959,Suriname,41,0.03,104,45,0.04,112,86,0.04,113,4,5,-20.0
1959,Fiji,41,0.03,104,43,0.04,115,84,0.03,114,2,1,100.0
1959,Guadeloupe,35,0.03,108,42,0.03,118,77,0.03,115,7,13,-46.15
1959,Bahamas,6,0.01,146,70,0.06,102,76,0.03,116,64,41,56.1
1959,Martinique,31,0.03,111,43,0.04,115,74,0.03,117,12,13,-7.69
1959,Gabon,45,0.04,103,28,0.02,126,73,0.03,118,-17,-5,240.0
1959,Reunion,29,0.02,114,44,0.04,113,73,0.03,118,15,16,-6.25
1959,Barbados,27,0.02,117,44,0.04,113,71,0.03,120,17,20,-15.0
1959,Congo,14,0.01,126,56,0.05,110,70,0.03,121,42,44,-4.55
1959,Paraguay,34,0.03,109,32,0.03,122,66,0.03,122,-2,1,-300.0
1959,Haiti,28,0.02,116,34,0.03,120,62,0.03,123,6,6,0.0
1959,Malawi,22,0.02,119,37,0.03,119,59,0.02,124,15,14,7.14
1959,New Caledonia,30,0.03,112,28,0.02,126,58,0.02,125,-2,28,-107.14
1959,Djibouti,19,0.02,121,31,0.03,124,50,0.02,126,12,8,50.0
1959,Equatorial Guinea,30,0.03,112,16,0.01,136,46,0.02,127,-14,-14,0.0
1959,Mali,13,0.01,127,33,0.03,121,46,0.02,127,20,23,-13.04
1959,Chad,17,0.01,124,25,0.02,130,42,0.02,129,8,4,100.0
1959,"Macao, China",10,0.01,133,27,0.02,128,37,0.02,130,17,13,30.77
1959,Togo,18,0.02,122,15,0.01,137,33,0.01,131,-3,3,-200.0
1959,Eswatini,18,0.02,122,15,0.01,137,33,0.01,131,-3,-1,200.0
1959,Central African Republic,15,0.01,125,17,0.01,134,32,0.01,133,2,3,-33.33
1959,Nepal,2,0.0,161,29,0.02,125,31,0.01,134,27,25,8.0
1959,Benin,11,0.01,130,18,0.01,133,29,0.01,135,7,2,250.0
1959,Lao People's Democratic Republic,1,0.0,169,27,0.02,128,28,0.01,136,26,26,0.0
1959,Mauritania,2,0.0,161,24,0.02,131,26,0.01,137,22,26,-15.38
1959,Yemen,10,0.01,133,15,0.01,137,25,0.01,138,5,4,25.0
1959,French Polynesia,12,0.01,128,13,0.01,143,25,0.01,138,1,4,-75.0
1959,Cabo Verde,11,0.01,130,13,0.01,143,24,0.01,140,2,3,-33.33
1959,Greenland,8,0.01,139,15,0.01,137,23,0.01,141,7,8,-12.5
1959,Belize,7,0.01,142,14,0.01,142,21,0.01,142,7,7,0.0
1959,Niger,12,0.01,128,7,0.01,151,19,0.01,143,-5,-8,-37.5
1959,Lesotho,4,0.0,152,15,0.01,137,19,0.01,143,11,10,10.0
1959,Botswana,9,0.01,137,10,0.01,145,19,0.01,143,1,3,-66.67
1959,Oman,2,0.0,161,17,0.01,134,19,0.01,143,15,7,114.29
1959,The Gambia,8,0.01,139,9,0.01,146,17,0.01,147,1,-1,-200.0
1959,Samoa,9,0.01,137,7,0.01,151,16,0.01,148,-2,-2,0.0
1959,Burundi,6,0.01,146,9,0.01,146,15,0.01,149,3,2,50.0
1959,Guinea-Bissau,7,0.01,142,8,0.01,148,15,0.01,149,1,1,0.0
1959,American Samoa,8,0.01,139,5,0.0,161,13,0.01,151,-3,-4,-25.0
1959,Vanuatu,7,0.01,142,6,0.0,156,13,0.01,151,-1,-2,-50.0
1959,Saint Kitts and Nevis,6,0.01,146,7,0.01,151,13,0.01,151,1,2,-50.0
1959,Burkina Faso,5,0.0,151,8,0.01,148,13,0.01,151,3,3,0.0
1959,Sao Tomé and Principe,6,0.01,146,6,0.0,156,12,0.0,155,0,-4,-100.0
1959,Antigua and Barbuda,3,0.0,159,8,0.01,148,11,0.0,156,5,5,0.0
1959,Grenada,4,0.0,152,7,0.01,151,11,0.0,156,3,2,50.0
1959,Saint Vincent and the Grenadines,4,0.0,152,6,0.0,156,10,0.0,158,2,3,-33.33
1959,Solomon Islands,6,0.01,146,4,0.0,162,10,0.0,158,-2,0,
1959,Dominica,4,0.0,152,6,0.0,156,10,0.0,158,2,1,100.0
1959,Saint Lucia,4,0.0,152,6,0.0,156,10,0.0,158,2,2,0.0
1959,Tonga,4,0.0,152,4,0.0,162,8,0.0,162,0,1,-100.0
1959,Rwanda,4,0.0,152,4,0.0,162,8,0.0,162,0,0,
1959,French Guiana,1,0.0,169,7,0.01,151,8,0.0,162,6,7,-14.29
1959,Guam,7,0.01,142,0,0.0,171,7,0.0,165,-7,-4,75.0
1959,Comoros,3,0.0,159,3,0.0,167,6,0.0,166,0,0,
1959,Maldives,2,0.0,161,4,0.0,162,6,0.0,166,2,2,0.0
1959,Saint Pierre and Miquelon,2,0.0,161,4,0.0,162,6,0.0,166,2,2,0.0
1959,Kiribati,2,0.0,161,3,0.0,167,5,0.0,169,1,1,0.0
1959,Seychelles,2,0.0,161,2,0.0,170,4,0.0,170,0,0,
1959,Montserrat,1,0.0,169,3,0.0,167,4,0.0,170,2,2,0.0
1958,United States of America,16367,15.05,1,14618,12.76,1,30985,13.88,1,-1749,-4875,-64.12
1958,United Kingdom,9495,8.73,2,10735,9.37,2,20230,9.06,2,1240,1778,-30.26
1958,Germany,8810,8.1,3,7630,6.66,3,16440,7.36,3,-1180,-973,21.27
1958,Canada,5273,4.85,4,5613,4.9,5,10886,4.87,4,340,851,-60.05
1958,France,5129,4.72,5,5616,4.9,4,10745,4.81,5,487,1071,-54.53
1958,U.S.S.R.,4298,3.95,6,4350,3.8,6,8648,3.87,6,52,-444,-111.71
1958,Netherlands,3699,3.4,7,4273,3.73,7,7972,3.57,7,574,1268,-54.73
1958,Belgium-Luxembourg,3054,2.81,8,3134,2.74,9,6188,2.77,8,80,258,-68.99
1958,Japan,2873,2.64,9,3033,2.65,10,5906,2.64,9,160,1428,-88.8
1958,Italy,2577,2.37,11,3219,2.81,8,5796,2.6,10,642,1127,-43.03
1958,China,2726,2.51,10,2506,2.19,11,5232,2.34,11,-220,-183,20.22
1958,Sweden,2087,1.92,13,2368,2.07,12,4455,1.99,12,281,291,-3.44
1958,"Venezuela, Bolivarian Republic of",2326,2.14,12,1599,1.4,18,3925,1.76,13,-727,-673,8.02
1958,Australia,1664,1.53,16,2016,1.76,13,3680,1.65,14,352,-311,-213.18
1958,German Democratic Republic,1915,1.76,14,1701,1.49,14,3616,1.62,15,-214,-195,9.74
1958,South Africa,1725,1.59,15,1636,1.43,17,3361,1.51,16,-89,-265,-66.42
1958,Switzerland,1520,1.4,17,1677,1.46,15,3197,1.43,17,157,397,-60.45
1958,Czech and Slovak Federal Republic,1513,1.39,18,1357,1.18,19,2870,1.29,18,-156,29,-637.93
1958,India,1216,1.12,21,1643,1.43,16,2859,1.28,19,427,625,-31.68
1958,Denmark,1268,1.17,19,1347,1.18,21,2615,1.17,20,79,185,-57.3
1958,Brazil,1243,1.14,20,1353,1.18,20,2596,1.16,21,110,97,13.4
1958,Poland,1060,0.97,22,1227,1.07,24,2287,1.02,22,167,276,-39.49
1958,Argentina,994,0.91,24,1233,1.08,23,2227,1.0,23,239,335,-28.66
1958,Singapore,1026,0.94,23,1189,1.04,25,2215,0.99,24,163,200,-18.5
1958,Norway,744,0.68,33,1310,1.14,22,2054,0.92,25,566,453,24.94
1958,Austria,918,0.84,26,1074,0.94,29,1992,0.89,26,156,149,4.7
1958,Netherlands Antilles,807,0.74,29,1086,0.95,28,1893,0.85,27,279,292,-4.45
1958,Mexico,736,0.68,34,1129,0.99,26,1865,0.84,28,393,420,-6.43
1958,Algeria,482,0.44,42,1124,0.98,27,1606,0.72,29,642,573,12.04
1958,Cuba,763,0.7,32,808,0.71,31,1571,0.7,30,45,-32,-240.63
1958,Malaysia,808,0.74,28,723,0.63,35,1531,0.69,31,-85,-131,-35.11
1958,Finland,774,0.71,31,730,0.64,34,1504,0.67,32,-44,64,-168.75
1958,New Zealand,700,0.64,35,796,0.7,33,1496,0.67,33,96,57,68.42
1958,Spain,486,0.45,41,872,0.76,30,1358,0.61,34,386,386,0.0
1958,Indonesia,791,0.73,30,544,0.47,42,1335,0.6,35,-247,-151,63.58
1958,"Hong Kong, China",523,0.48,39,804,0.7,32,1327,0.59,36,281,373,-24.66
1958,Hungary,684,0.63,36,631,0.55,38,1315,0.59,37,-53,195,-127.18
1958,Egypt,478,0.44,43,690,0.6,36,1168,0.52,38,212,31,583.87
1958,"Saudi Arabia, Kingdom of",885,0.81,27,270,0.24,60,1155,0.52,39,-615,-309,99.03
1958,"Kuwait, the State of",930,0.85,25,210,0.18,67,1140,0.51,40,-720,-567,26.98
1958,"Yugoslavia, Socialist Federal Republic of",441,0.41,46,685,0.6,37,1126,0.5,41,244,266,-8.27
1958,Philippines,494,0.45,40,628,0.55,39,1122,0.5,42,134,255,-47.45
1958,Iran,678,0.62,37,412,0.36,48,1090,0.49,43,-266,-194,37.11
1958,Romania,468,0.43,44,520,0.45,43,988,0.44,44,52,120,-56.67
1958,Ireland,368,0.34,51,557,0.49,41,925,0.41,45,189,148,27.7
1958,Chile,386,0.35,48,494,0.43,44,880,0.39,46,108,-14,-871.43
1958,Iraq,566,0.52,38,308,0.27,59,874,0.39,47,-258,-19,1257.89
1958,Colombia,461,0.42,45,400,0.35,50,861,0.39,48,-61,-28,117.86
1958,Nigeria,379,0.35,49,467,0.41,46,846,0.38,49,88,70,25.71
1958,Greece,232,0.21,61,565,0.49,40,797,0.36,50,333,304,9.54
1958,Portugal,289,0.27,58,480,0.42,45,769,0.34,51,191,214,-10.75
1958,Democratic Republic of the Congo,406,0.37,47,362,0.32,55,768,0.34,52,-44,-35,25.71
1958,Morocco,346,0.32,53,401,0.35,49,747,0.33,53,55,88,-37.5
1958,Bulgaria,373,0.34,50,367,0.32,53,740,0.33,54,-6,-38,-84.21
1958,Sri Lanka,359,0.33,52,361,0.32,56,720,0.32,55,2,26,-92.31
1958,Thailand,307,0.28,54,392,0.34,51,699,0.31,56,85,48,77.08
1958,Pakistan,297,0.27,55,365,0.32,54,662,0.3,57,68,103,-33.98
1958,Peru,290,0.27,57,325,0.28,57,615,0.28,58,35,70,-50.0
1958,Israel,141,0.13,71,423,0.37,47,564,0.25,59,282,295,-4.41
1958,Türkiye,247,0.23,60,315,0.28,58,562,0.25,60,68,52,30.77
1958,Ghana,293,0.27,56,237,0.21,63,530,0.24,61,-56,15,-473.33
1958,Trinidad and Tobago,248,0.23,59,240,0.21,62,488,0.22,62,-8,-21,-61.9
1958,Myanmar,194,0.18,64,204,0.18,69,398,0.18,63,10,68,-85.29
1958,"Korea, Republic of",14,0.01,128,378,0.33,52,392,0.18,64,364,419,-13.13
1958,Zambia,209,0.19,63,178,0.16,72,387,0.17,65,-31,-92,-66.3
1958,Chinese Taipei,156,0.14,66,226,0.2,65,382,0.17,66,70,69,1.45
1958,"Yemen, People's Democratic Republic",178,0.16,65,203,0.18,70,381,0.17,67,25,21,19.05
1958,Zimbabwe,138,0.13,73,243,0.21,61,381,0.17,67,105,76,38.16
1958,"Bahrain, Kingdom of",210,0.19,62,165,0.14,75,375,0.17,69,-45,-37,21.62
1958,Senegal,137,0.13,74,209,0.18,68,346,0.15,70,72,110,-34.55
1958,Syrian Arab Republic,122,0.11,80,211,0.18,66,333,0.15,71,89,19,368.42
1958,Jamaica,133,0.12,77,181,0.16,71,314,0.14,72,48,46,4.35
1958,Tunisia,153,0.14,68,155,0.14,77,308,0.14,73,2,26,-92.31
1958,Uruguay,155,0.14,67,143,0.12,79,298,0.13,74,-12,117,-110.26
1958,Sudan,125,0.11,79,171,0.15,73,296,0.13,75,46,34,35.29
1958,Viet Nam,55,0.05,98,232,0.2,64,287,0.13,76,177,208,-14.9
1958,Dominican Republic,137,0.13,74,149,0.13,78,286,0.13,77,12,-25,-148.0
1958,Kenya,93,0.09,87,170,0.15,74,263,0.12,78,77,115,-33.04
1958,Angola,128,0.12,78,130,0.11,82,258,0.12,79,2,6,-66.67
1958,Côte d'Ivoire,148,0.14,69,107,0.09,87,255,0.11,80,-41,-27,51.85
1958,Uganda,147,0.14,70,96,0.08,93,243,0.11,81,-51,-47,8.51
1958,Ecuador,134,0.12,76,105,0.09,89,239,0.11,82,-29,-26,11.54
1958,Guatemala,102,0.09,85,133,0.12,81,235,0.11,83,31,25,24.0
1958,El Salvador,116,0.11,82,108,0.09,85,224,0.1,84,-8,-23,-65.22
1958,Madagascar,96,0.09,86,127,0.11,83,223,0.1,85,31,55,-43.64
1958,Cameroon,115,0.11,83,107,0.09,87,222,0.1,86,-8,17,-147.06
1958,Tanzania,121,0.11,81,94,0.08,95,215,0.1,87,-27,-3,800.0
1958,Lebanese Republic,32,0.03,111,163,0.14,76,195,0.09,88,131,155,-15.48
1958,Costa Rica,92,0.08,88,99,0.09,91,191,0.09,89,7,20,-65.0
1958,Mozambique,71,0.07,89,115,0.1,84,186,0.08,90,44,39,12.82
1958,Qatar,140,0.13,72,28,0.02,125,168,0.08,91,-112,-84,33.33
1958,Honduras,70,0.06,91,87,0.08,96,157,0.07,92,17,26,-34.62
1958,Iceland,66,0.06,92,86,0.08,97,152,0.07,93,20,23,-13.04
1958,Cyprus,49,0.05,102,103,0.09,90,152,0.07,93,54,73,-26.03
1958,Nicaragua,71,0.07,89,78,0.07,101,149,0.07,95,7,10,-30.0
1958,United Arab Emirates,2,0.0,160,143,0.12,79,145,0.06,96,141,139,1.44
1958,Ethiopia,63,0.06,93,78,0.07,101,141,0.06,97,15,-5,-400.0
1958,"Bolivia, Plurinational State of",53,0.05,101,80,0.07,99,133,0.06,98,27,14,92.86
1958,Brunei Darussalam,107,0.1,84,26,0.02,130,133,0.06,98,-81,-79,2.53
1958,Afghanistan,60,0.06,95,73,0.06,104,133,0.06,98,13,11,18.18
1958,Cambodia,56,0.05,97,76,0.07,103,132,0.06,101,20,6,233.33
1958,Panama,23,0.02,117,108,0.09,85,131,0.06,102,85,85,0.0
1958,Guyana,57,0.05,96,68,0.06,106,125,0.06,103,11,6,83.33
1958,Mauritius,61,0.06,94,63,0.06,108,124,0.06,104,2,-14,-114.29
1958,Sierra Leone,55,0.05,98,67,0.06,107,122,0.05,105,12,28,-57.14
1958,New Caledonia,41,0.04,104,69,0.06,105,110,0.05,106,28,-3,-1033.33
1958,Libya,12,0.01,130,97,0.08,92,109,0.05,107,85,66,28.79
1958,Albania,29,0.03,114,79,0.07,100,108,0.05,108,50,24,108.33
1958,Jordan,10,0.01,132,95,0.08,94,105,0.05,109,85,69,23.19
1958,Liberia,54,0.05,100,38,0.03,119,92,0.04,110,-16,-2,700.0
1958,Malta,10,0.01,132,81,0.07,98,91,0.04,111,71,67,5.97
1958,Fiji,43,0.04,103,44,0.04,115,87,0.04,112,1,-2,-150.0
1958,Haiti,39,0.04,106,45,0.04,114,84,0.04,113,6,4,50.0
1958,Paraguay,41,0.04,104,42,0.04,117,83,0.04,114,1,-1,-200.0
1958,Guadeloupe,34,0.03,108,47,0.04,111,81,0.04,115,13,13,0.0
1958,Papua New Guinea,33,0.03,109,47,0.04,111,80,0.04,116,14,20,-30.0
1958,Reunion,32,0.03,111,48,0.04,110,80,0.04,116,16,12,33.33
1958,Gabon,39,0.04,106,34,0.03,123,73,0.03,118,-5,7,-171.43
1958,Congo,14,0.01,128,58,0.05,109,72,0.03,119,44,44,0.0
1958,Suriname,33,0.03,109,38,0.03,119,71,0.03,120,5,5,0.0
1958,Martinique,29,0.03,114,42,0.04,117,71,0.03,120,13,12,8.33
1958,Barbados,23,0.02,117,43,0.04,116,66,0.03,122,20,11,81.82
1958,Malawi,20,0.02,119,34,0.03,123,54,0.02,123,14,8,75.0
1958,Mali,15,0.01,126,38,0.03,119,53,0.02,124,23,26,-11.54
1958,Chad,24,0.02,116,28,0.02,125,52,0.02,125,4,9,-55.56
1958,Bahamas,5,0.0,147,46,0.04,113,51,0.02,126,41,39,5.13
1958,Equatorial Guinea,30,0.03,113,16,0.01,137,46,0.02,127,-14,-41,-65.85
1958,Guinea,9,0.01,135,35,0.03,122,44,0.02,128,26,23,13.04
1958,Djibouti,16,0.01,122,24,0.02,131,40,0.02,129,8,8,0.0
1958,Benin,18,0.02,120,20,0.02,132,38,0.02,130,2,9,-77.78
1958,French Polynesia,16,0.01,122,20,0.02,132,36,0.02,131,4,2,100.0
1958,Central African Republic,16,0.01,122,19,0.02,135,35,0.02,132,3,2,50.0
1958,Togo,15,0.01,126,18,0.02,136,33,0.01,133,3,4,-25.0
1958,Eswatini,16,0.01,122,15,0.01,138,31,0.01,134,-1,-2,-50.0
1958,Mauritania,2,0.0,160,28,0.02,125,30,0.01,135,26,29,-10.34
1958,Nepal,2,0.0,160,27,0.02,128,29,0.01,136,25,25,0.0
1958,Niger,18,0.02,120,10,0.01,145,28,0.01,137,-8,-4,100.0
1958,Lao People's Democratic Republic,1,0.0,168,27,0.02,128,28,0.01,137,26,41,-36.59
1958,"Macao, China",7,0.01,140,20,0.02,132,27,0.01,139,13,11,18.18
1958,Cabo Verde,10,0.01,132,13,0.01,141,23,0.01,140,3,1,200.0
1958,The Gambia,12,0.01,130,11,0.01,144,23,0.01,140,-1,1,-200.0
1958,Yemen,9,0.01,135,13,0.01,141,22,0.01,142,4,3,33.33
1958,Greenland,7,0.01,140,15,0.01,138,22,0.01,142,8,4,100.0
1958,Belize,6,0.01,144,13,0.01,141,19,0.01,144,7,5,40.0
1958,Lesotho,4,0.0,151,14,0.01,140,18,0.01,145,10,9,11.11
1958,Botswana,7,0.01,140,10,0.01,145,17,0.01,146,3,1,200.0
1958,Guinea-Bissau,7,0.01,140,8,0.01,148,15,0.01,147,1,1,0.0
1958,Burundi,6,0.01,144,8,0.01,148,14,0.01,148,2,3,-33.33
1958,Samoa,8,0.01,137,6,0.01,155,14,0.01,148,-2,0,
1958,Burkina Faso,5,0.0,147,8,0.01,148,13,0.01,150,3,4,-25.0
1958,Sao Tomé and Principe,8,0.01,137,4,0.0,159,12,0.01,151,-4,-3,33.33
1958,American Samoa,8,0.01,137,4,0.0,159,12,0.01,151,-4,-2,100.0
1958,Saint Kitts and Nevis,5,0.0,147,7,0.01,153,12,0.01,151,2,0,
1958,Grenada,5,0.0,147,7,0.01,153,12,0.01,151,2,3,-33.33
1958,Antigua and Barbuda,3,0.0,155,8,0.01,148,11,0.0,155,5,3,66.67
1958,Oman,2,0.0,160,9,0.01,147,11,0.0,155,7,7,0.0
1958,Vanuatu,6,0.01,144,4,0.0,159,10,0.0,157,-2,-1,100.0
1958,Saint Vincent and the Grenadines,3,0.0,155,6,0.01,155,9,0.0,158,3,1,200.0
1958,Dominica,4,0.0,151,5,0.0,157,9,0.0,158,1,1,0.0
1958,French Guiana,1,0.0,168,8,0.01,148,9,0.0,158,7,7,0.0
1958,Solomon Islands,4,0.0,151,4,0.0,159,8,0.0,161,0,0,
1958,Saint Lucia,3,0.0,155,5,0.0,157,8,0.0,161,2,2,0.0
1958,Comoros,3,0.0,155,3,0.0,165,6,0.0,163,0,0,
1958,Maldives,2,0.0,160,4,0.0,159,6,0.0,163,2,2,0.0
1958,Rwanda,3,0.0,155,3,0.0,165,6,0.0,163,0,0,
1958,Saint Pierre and Miquelon,2,0.0,160,4,0.0,159,6,0.0,163,2,2,0.0
1958,Kiribati,2,0.0,160,3,0.0,165,5,0.0,167,1,1,0.0
1958,Guam,4,0.0,151,0,0.0,171,4,0.0,168,-4,-4,0.0
1958,Seychelles,2,0.0,160,2,0.0,169,4,0.0,168,0,0,
1958,Montserrat,1,0.0,168,3,0.0,165,4,0.0,168,2,1,100.0
1958,Tonga,1,0.0,168,2,0.0,169,3,0.0,171,1,0,
1957,United States of America,19495,17.28,1,14620,12.1,1,34115,14.6,1,-4875,-3346,45.7
1957,United Kingdom,9811,8.7,2,11589,9.59,2,21400,9.16,2,1778,1591,11.75
1957,Germany,8564,7.59,3,7591,6.28,3,16155,6.92,3,-973,-690,41.01
1957,Canada,5345,4.74,4,6196,5.13,5,11541,4.94,4,851,954,-10.8
1957,France,5223,4.63,5,6294,5.21,4,11517,4.93,5,1071,1014,5.62
1957,Netherlands,3578,3.17,7,4846,4.01,6,8424,3.61,6,1268,1129,12.31
1957,U.S.S.R.,4382,3.89,6,3938,3.26,8,8320,3.56,7,-444,1,-44500.0
1957,Japan,2858,2.53,9,4286,3.55,7,7144,3.06,8,1428,729,95.88
1957,Belgium-Luxembourg,3186,2.82,8,3444,2.85,10,6630,2.84,9,258,116,122.41
1957,Italy,2547,2.26,10,3674,3.04,9,6221,2.66,10,1127,1028,9.63
1957,Sweden,2138,1.9,14,2429,2.01,11,4567,1.96,11,291,264,10.23
1957,"Venezuela, Bolivarian Republic of",2542,2.25,11,1869,1.55,16,4411,1.89,12,-673,-778,-13.5
1957,China,2214,1.96,13,2031,1.68,12,4245,1.82,13,-183,-90,103.33
1957,Australia,2230,1.98,12,1919,1.59,15,4149,1.78,14,-311,28,-1210.71
1957,South Africa,1881,1.67,15,1616,1.34,17,3497,1.5,15,-265,-252,5.16
1957,Switzerland,1535,1.36,17,1932,1.6,14,3467,1.48,16,397,318,24.84
1957,German Democratic Republic,1811,1.61,16,1616,1.34,17,3427,1.47,17,-195,-73,167.12
1957,India,1380,1.22,19,2005,1.66,13,3385,1.45,18,625,404,54.7
1957,Brazil,1392,1.23,18,1489,1.23,19,2881,1.23,19,97,-248,-139.11
1957,Czech and Slovak Federal Republic,1358,1.2,20,1387,1.15,20,2745,1.18,20,29,-201,-114.43
1957,Denmark,1173,1.04,21,1358,1.12,21,2531,1.08,21,185,199,-7.04
1957,Singapore,1136,1.01,22,1336,1.11,22,2472,1.06,22,200,163,22.7
1957,Argentina,975,0.86,24,1310,1.08,23,2285,0.98,23,335,184,82.07
1957,Poland,975,0.86,24,1251,1.04,25,2226,0.95,24,276,37,645.95
1957,Austria,979,0.87,23,1128,0.93,28,2107,0.9,25,149,125,19.2
1957,Norway,821,0.73,31,1274,1.05,24,2095,0.9,26,453,439,3.19
1957,Netherlands Antilles,871,0.77,28,1163,0.96,26,2034,0.87,27,292,221,32.13
1957,Mexico,735,0.65,33,1155,0.96,27,1890,0.81,28,420,238,76.47
1957,Indonesia,955,0.85,26,804,0.67,35,1759,0.75,29,-151,-65,132.31
1957,Finland,837,0.74,30,901,0.75,30,1738,0.74,30,64,111,-42.34
1957,Malaysia,913,0.81,27,782,0.65,36,1695,0.73,31,-131,-176,-25.57
1957,Cuba,845,0.75,29,813,0.67,34,1658,0.71,32,-32,-46,-30.43
1957,New Zealand,773,0.69,32,830,0.69,33,1603,0.69,33,57,-25,-328.0
1957,Algeria,467,0.41,43,1040,0.86,29,1507,0.65,34,573,350,63.71
1957,"Hong Kong, China",528,0.47,37,901,0.75,30,1429,0.61,35,373,237,57.38
1957,Spain,476,0.42,41,862,0.71,32,1338,0.57,36,386,325,18.77
1957,Hungary,488,0.43,40,683,0.57,38,1171,0.5,37,195,-6,-3350.0
1957,Iran,662,0.59,35,468,0.39,46,1130,0.48,38,-194,-677,-71.34
1957,Philippines,432,0.38,45,687,0.57,37,1119,0.48,39,255,116,119.83
1957,"Yugoslavia, Socialist Federal Republic of",395,0.35,47,661,0.55,39,1056,0.45,40,266,151,76.16
1957,Egypt,493,0.44,39,524,0.43,41,1017,0.44,41,31,125,-75.2
1957,Colombia,511,0.45,38,483,0.4,45,994,0.43,42,-28,120,-123.33
1957,Romania,411,0.36,46,531,0.44,40,942,0.4,43,120,-43,-379.07
1957,Democratic Republic of the Congo,473,0.42,42,438,0.36,50,911,0.39,44,-35,-120,-70.83
1957,"Kuwait, the State of",735,0.65,33,168,0.14,76,903,0.39,45,-567,-560,1.25
1957,Chile,455,0.4,44,441,0.37,48,896,0.38,46,-14,-189,-92.59
1957,"Saudi Arabia, Kingdom of",599,0.53,36,290,0.24,62,889,0.38,47,-309,-333,-7.21
1957,Ireland,368,0.33,49,516,0.43,43,884,0.38,48,148,209,-29.19
1957,Portugal,288,0.26,58,502,0.42,44,790,0.34,49,214,143,49.65
1957,Nigeria,357,0.32,52,427,0.35,52,784,0.34,50,70,51,37.25
1957,Pakistan,337,0.3,55,440,0.36,49,777,0.33,51,103,77,33.77
1957,Thailand,363,0.32,50,411,0.34,54,774,0.33,52,48,4,1100.0
1957,Morocco,329,0.29,57,417,0.35,53,746,0.32,53,88,119,-26.05
1957,Greece,220,0.2,63,524,0.43,41,744,0.32,54,304,274,10.95
1957,Türkiye,345,0.31,54,397,0.33,56,742,0.32,55,52,102,-49.02
1957,Sri Lanka,353,0.31,53,379,0.31,57,732,0.31,56,26,-22,-218.18
1957,Peru,330,0.29,56,400,0.33,55,730,0.31,57,70,50,40.0
1957,Bulgaria,370,0.33,48,332,0.27,59,702,0.3,58,-38,-51,-25.49
1957,Iraq,360,0.32,51,341,0.28,58,701,0.3,59,-19,-159,-88.05
1957,Israel,141,0.13,74,436,0.36,51,577,0.25,60,295,271,8.86
1957,Ghana,256,0.23,59,271,0.22,64,527,0.23,61,15,7,114.29
1957,Myanmar,229,0.2,61,297,0.25,61,526,0.23,62,68,-51,-233.33
1957,Senegal,193,0.17,65,303,0.25,60,496,0.21,63,110,88,25.0
1957,"Korea, Republic of",23,0.02,120,442,0.37,47,465,0.2,64,419,361,16.07
1957,Trinidad and Tobago,229,0.2,61,208,0.17,68,437,0.19,65,-21,-16,31.25
1957,Zambia,256,0.23,59,164,0.14,77,420,0.18,66,-92,-193,-52.33
1957,Zimbabwe,162,0.14,67,238,0.2,66,400,0.17,67,76,100,-24.0
1957,Uruguay,136,0.12,77,253,0.21,65,389,0.17,68,117,-7,-1771.43
1957,"Yemen, People's Democratic Republic",183,0.16,66,204,0.17,69,387,0.17,69,21,19,10.53
1957,Viet Nam,81,0.07,88,289,0.24,63,370,0.16,70,208,173,20.23
1957,"Bahrain, Kingdom of",199,0.18,64,162,0.13,78,361,0.15,71,-37,-20,85.0
1957,Chinese Taipei,143,0.13,73,212,0.18,67,355,0.15,72,69,75,-8.0
1957,Sudan,148,0.13,71,182,0.15,73,330,0.14,73,34,-62,-154.84
1957,Jamaica,141,0.13,74,187,0.15,72,328,0.14,74,46,53,-13.21
1957,Tunisia,151,0.13,70,177,0.15,74,328,0.14,74,26,82,-68.29
1957,Syrian Arab Republic,153,0.14,69,172,0.14,75,325,0.14,76,19,39,-51.28
1957,Dominican Republic,161,0.14,68,136,0.11,81,297,0.13,77,-25,4,-725.0
1957,Kenya,87,0.08,86,202,0.17,70,289,0.12,78,115,103,11.65
1957,El Salvador,138,0.12,76,115,0.1,85,253,0.11,79,-23,-8,187.5
1957,Uganda,146,0.13,72,99,0.08,92,245,0.1,80,-47,-37,27.03
1957,Guatemala,109,0.1,83,134,0.11,82,243,0.1,81,25,22,13.64
1957,Côte d'Ivoire,135,0.12,78,108,0.09,88,243,0.1,81,-27,-46,-41.3
1957,Ecuador,133,0.12,79,107,0.09,89,240,0.1,83,-26,-8,225.0
1957,Angola,117,0.1,80,123,0.1,84,240,0.1,83,6,-4,-250.0
1957,Lebanese Republic,42,0.04,104,197,0.16,71,239,0.1,85,155,197,-21.32
1957,Madagascar,90,0.08,85,145,0.12,79,235,0.1,86,55,39,41.03
1957,Tanzania,113,0.1,81,110,0.09,86,223,0.1,87,-3,-26,-88.46
1957,Costa Rica,83,0.07,87,103,0.09,91,186,0.08,88,20,23,-13.04
1957,Cyprus,53,0.05,100,126,0.1,83,179,0.08,89,73,46,58.7
1957,Cameroon,81,0.07,88,98,0.08,93,179,0.08,89,17,20,-15.0
1957,Mozambique,65,0.06,94,104,0.09,90,169,0.07,91,39,40,-2.5
1957,"Bolivia, Plurinational State of",76,0.07,91,90,0.07,95,166,0.07,92,14,4,250.0
1957,Honduras,65,0.06,94,91,0.08,94,156,0.07,93,26,4,550.0
1957,Nicaragua,71,0.06,92,81,0.07,98,152,0.07,94,10,4,150.0
1957,Ethiopia,77,0.07,90,72,0.06,102,149,0.06,95,-5,2,-350.0
1957,Iceland,61,0.05,98,84,0.07,97,145,0.06,96,23,27,-14.81
1957,Brunei Darussalam,111,0.1,82,32,0.03,125,143,0.06,97,-79,-74,6.76
1957,United Arab Emirates,2,0.0,160,141,0.12,80,143,0.06,97,139,128,8.59
1957,Panama,24,0.02,118,109,0.09,87,133,0.06,99,85,72,18.06
1957,Guyana,63,0.06,97,69,0.06,103,132,0.06,100,6,3,100.0
1957,Qatar,107,0.09,84,23,0.02,131,130,0.06,101,-84,-70,20.0
1957,Sierra Leone,51,0.05,102,79,0.07,99,130,0.06,101,28,28,0.0
1957,New Caledonia,64,0.06,96,61,0.05,104,125,0.05,103,-3,1,-400.0
1957,Mauritius,69,0.06,93,55,0.05,108,124,0.05,104,-14,-15,-6.67
1957,Cambodia,52,0.05,101,58,0.05,105,110,0.05,105,6,20,-70.0
1957,Afghanistan,46,0.04,103,57,0.05,106,103,0.04,106,11,-13,-184.62
1957,Jordan,16,0.01,123,85,0.07,96,101,0.04,107,69,64,7.81
1957,Libya,13,0.01,129,79,0.07,99,92,0.04,108,66,35,88.57
1957,Reunion,38,0.03,107,50,0.04,111,88,0.04,109,12,10,20.0
1957,Malta,9,0.01,135,76,0.06,101,85,0.04,110,67,63,6.35
1957,Martinique,36,0.03,108,48,0.04,113,84,0.04,111,12,9,33.33
1957,Albania,29,0.03,114,53,0.04,109,82,0.04,112,24,20,20.0
1957,Guadeloupe,34,0.03,109,47,0.04,114,81,0.03,113,13,7,85.71
1957,Guinea,29,0.03,114,52,0.04,110,81,0.03,113,23,9,155.56
1957,Fiji,40,0.04,105,38,0.03,121,78,0.03,115,-2,13,-115.38
1957,Papua New Guinea,29,0.03,114,49,0.04,112,78,0.03,115,20,19,5.26
1957,Liberia,40,0.04,105,38,0.03,121,78,0.03,115,-2,-18,-88.89
1957,Gabon,34,0.03,109,41,0.03,118,75,0.03,118,7,-3,-333.33
1957,Suriname,34,0.03,109,39,0.03,120,73,0.03,119,5,2,150.0
1957,Equatorial Guinea,57,0.05,99,16,0.01,136,73,0.03,119,-41,-12,241.67
1957,Haiti,34,0.03,109,38,0.03,121,72,0.03,121,4,4,0.0
1957,Congo,13,0.01,129,57,0.05,106,70,0.03,122,44,39,12.82
1957,Barbados,29,0.03,114,40,0.03,119,69,0.03,123,11,15,-26.67
1957,Paraguay,34,0.03,109,33,0.03,124,67,0.03,124,-1,-8,-87.5
1957,Mali,16,0.01,123,42,0.03,116,58,0.02,125,26,24,8.33
1957,Malawi,24,0.02,118,32,0.03,125,56,0.02,126,8,8,0.0
1957,Bahamas,4,0.0,149,43,0.04,115,47,0.02,127,39,33,18.18
1957,Chad,19,0.02,121,28,0.02,128,47,0.02,127,9,6,50.0
1957,Lao People's Democratic Republic,1,0.0,168,42,0.03,116,43,0.02,129,41,34,20.59
1957,Benin,15,0.01,125,24,0.02,130,39,0.02,130,9,7,28.57
1957,Central African Republic,17,0.02,122,19,0.02,132,36,0.02,131,2,0,
1957,Mauritania,2,0.0,160,31,0.03,127,33,0.01,132,29,25,16.0
1957,French Polynesia,15,0.01,125,17,0.01,135,32,0.01,133,2,1,100.0
1957,Togo,12,0.01,131,16,0.01,136,28,0.01,134,4,2,100.0
1957,Djibouti,10,0.01,134,18,0.01,133,28,0.01,134,8,7,14.29
1957,Nepal,1,0.0,168,26,0.02,129,27,0.01,136,25,24,4.17
1957,Eswatini,14,0.01,127,12,0.01,141,26,0.01,137,-2,-2,0.0
1957,Cabo Verde,12,0.01,131,13,0.01,138,25,0.01,138,1,1,0.0
1957,The Gambia,12,0.01,131,13,0.01,138,25,0.01,138,1,3,-66.67
1957,"Macao, China",7,0.01,138,18,0.01,133,25,0.01,138,11,7,57.14
1957,Niger,14,0.01,127,10,0.01,145,24,0.01,141,-4,-11,-63.64
1957,Greenland,9,0.01,135,13,0.01,138,22,0.01,142,4,5,-20.0
1957,Yemen,9,0.01,135,12,0.01,141,21,0.01,143,3,2,50.0
1957,Belize,6,0.01,142,11,0.01,144,17,0.01,144,5,4,25.0
1957,Lesotho,3,0.0,154,12,0.01,141,15,0.01,145,9,8,12.5
1957,Botswana,7,0.01,138,8,0.01,148,15,0.01,145,1,1,0.0
1957,Guinea-Bissau,7,0.01,138,8,0.01,148,15,0.01,145,1,0,
1957,Burkina Faso,5,0.0,144,9,0.01,146,14,0.01,148,4,3,33.33
1957,Burundi,5,0.0,144,8,0.01,148,13,0.01,149,3,3,0.0
1957,Saint Kitts and Nevis,6,0.01,142,6,0.0,153,12,0.01,150,0,0,
1957,Antigua and Barbuda,4,0.0,149,7,0.01,152,11,0.0,151,3,2,50.0
1957,Sao Tomé and Principe,7,0.01,138,4,0.0,158,11,0.0,151,-3,-1,200.0
1957,Oman,2,0.0,160,9,0.01,146,11,0.0,151,7,7,0.0
1957,Samoa,5,0.0,144,5,0.0,155,10,0.0,154,0,0,
1957,Saint Vincent and the Grenadines,4,0.0,149,5,0.0,155,9,0.0,155,1,1,0.0
1957,Vanuatu,5,0.0,144,4,0.0,158,9,0.0,155,-1,-1,0.0
1957,Grenada,3,0.0,154,6,0.0,153,9,0.0,155,3,4,-25.0
1957,French Guiana,1,0.0,168,8,0.01,148,9,0.0,155,7,7,0.0
1957,Solomon Islands,4,0.0,149,4,0.0,158,8,0.0,159,0,-1,-100.0
1957,American Samoa,5,0.0,144,3,0.0,164,8,0.0,159,-2,-1,100.0
1957,Saint Lucia,3,0.0,154,5,0.0,155,8,0.0,159,2,2,0.0
1957,Dominica,3,0.0,154,4,0.0,158,7,0.0,162,1,1,0.0
1957,Comoros,3,0.0,154,3,0.0,164,6,0.0,163,0,1,-100.0
1957,Maldives,2,0.0,160,4,0.0,158,6,0.0,163,2,2,0.0
1957,Rwanda,3,0.0,154,3,0.0,164,6,0.0,163,0,0,
1957,Saint Pierre and Miquelon,2,0.0,160,4,0.0,158,6,0.0,163,2,3,-33.33
1957,Kiribati,2,0.0,160,3,0.0,164,5,0.0,167,1,0,
1957,Guam,4,0.0,149,0,0.0,171,4,0.0,168,-4,-7,-42.86
1957,Seychelles,2,0.0,160,2,0.0,168,4,0.0,168,0,1,-100.0
1957,Tonga,2,0.0,160,2,0.0,168,4,0.0,168,0,0,
1957,Montserrat,1,0.0,168,2,0.0,168,3,0.0,171,1,1,0.0
1956,United States of America,17333,16.73,1,13987,12.82,1,31320,14.72,1,-3346,-1802,85.68
1956,United Kingdom,9290,8.97,2,10881,9.97,2,20171,9.48,2,1591,2408,-33.93
1956,Germany,7348,7.09,3,6658,6.1,3,14006,6.58,3,-690,-298,131.54
1956,Canada,5157,4.98,4,6111,5.6,4,11268,5.3,4,954,422,126.07
1956,France,4641,4.48,5,5655,5.18,5,10296,4.84,5,1014,-176,-676.14
1956,Netherlands,3268,3.15,7,4397,4.03,6,7665,3.6,6,1129,730,54.66
1956,U.S.S.R.,3612,3.49,6,3613,3.31,7,7225,3.4,7,1,-366,-100.27
1956,Belgium-Luxembourg,3172,3.06,8,3288,3.01,8,6460,3.04,8,116,72,61.11
1956,Japan,2501,2.41,9,3230,2.96,9,5731,2.69,9,729,460,58.48
1956,Italy,2146,2.07,10,3174,2.91,10,5320,2.5,10,1028,856,20.09
1956,Sweden,1946,1.88,12,2210,2.03,11,4156,1.95,11,264,271,-2.58
1956,Australia,1905,1.84,13,1933,1.77,12,3838,1.8,12,28,352,-92.05
1956,"Venezuela, Bolivarian Republic of",2099,2.03,11,1321,1.21,18,3420,1.61,13,-778,-721,7.91
1956,China,1650,1.59,15,1560,1.43,15,3210,1.51,14,-90,320,-128.13
1956,South Africa,1707,1.65,14,1455,1.33,16,3162,1.49,15,-252,-124,103.23
1956,Switzerland,1419,1.37,17,1737,1.59,13,3156,1.48,16,318,178,78.65
1956,India,1257,1.21,20,1661,1.52,14,2918,1.37,17,404,93,334.41
1956,German Democratic Republic,1407,1.36,18,1334,1.22,17,2741,1.29,18,-73,-105,-30.48
1956,Brazil,1482,1.43,16,1234,1.13,21,2716,1.28,19,-248,-116,113.79
1956,Czech and Slovak Federal Republic,1387,1.34,19,1186,1.09,23,2573,1.21,20,-201,-123,63.41
1956,Denmark,1112,1.07,22,1311,1.2,19,2423,1.14,21,199,121,64.46
1956,Singapore,1120,1.08,21,1283,1.18,20,2403,1.13,22,163,161,1.24
1956,Argentina,944,0.91,25,1128,1.03,24,2072,0.97,23,184,244,-24.59
1956,Poland,985,0.95,24,1022,0.94,27,2007,0.94,24,37,12,208.33
1956,Norway,772,0.75,33,1211,1.11,22,1983,0.93,25,439,456,-3.73
1956,Mexico,834,0.8,30,1072,0.98,25,1906,0.9,26,238,89,167.42
1956,Netherlands Antilles,841,0.81,29,1062,0.97,26,1903,0.89,27,221,193,14.51
1956,Austria,849,0.82,28,974,0.89,28,1823,0.86,28,125,188,-33.51
1956,Indonesia,925,0.89,27,860,0.79,30,1785,0.84,29,-65,-316,-79.43
1956,Malaysia,936,0.9,26,760,0.7,34,1696,0.8,30,-176,-287,-38.68
1956,Finland,774,0.75,32,885,0.81,29,1659,0.78,31,111,-19,-684.21
1956,New Zealand,777,0.75,31,752,0.69,35,1529,0.72,32,-25,78,-132.05
1956,Iran,1055,1.02,23,378,0.35,51,1433,0.67,33,-677,-203,233.5
1956,"Hong Kong, China",562,0.54,37,799,0.73,31,1361,0.64,34,237,208,13.94
1956,Cuba,695,0.67,34,649,0.59,37,1344,0.63,35,-46,-36,27.78
1956,Spain,442,0.43,44,767,0.7,33,1209,0.57,36,325,171,90.06
1956,Algeria,429,0.41,45,779,0.71,32,1208,0.57,37,350,233,50.21
1956,Colombia,537,0.52,39,657,0.6,36,1194,0.56,38,120,85,41.18
1956,Philippines,453,0.44,43,569,0.52,38,1022,0.48,39,116,206,-43.69
1956,Hungary,487,0.47,41,481,0.44,41,968,0.46,40,-6,-47,-87.23
1956,Democratic Republic of the Congo,536,0.52,40,416,0.38,48,952,0.45,41,-120,-77,55.84
1956,Egypt,409,0.39,46,534,0.49,39,943,0.44,42,125,119,5.04
1956,Chile,542,0.52,38,353,0.32,55,895,0.42,43,-189,-24,687.5
1956,"Saudi Arabia, Kingdom of",613,0.59,36,280,0.26,59,893,0.42,44,-333,-297,12.12
1956,Ireland,303,0.29,57,512,0.47,40,815,0.38,45,209,263,-20.53
1956,Nigeria,377,0.36,48,428,0.39,46,805,0.38,46,51,10,410.0
1956,Morocco,340,0.33,52,459,0.42,44,799,0.38,47,119,169,-29.59
1956,"Yugoslavia, Socialist Federal Republic of",323,0.31,54,474,0.43,42,797,0.37,48,151,184,-17.93
1956,Iraq,477,0.46,42,318,0.29,58,795,0.37,49,-159,-247,-35.63
1956,"Kuwait, the State of",675,0.65,35,115,0.11,82,790,0.37,50,-560,-557,0.54
1956,Pakistan,340,0.33,52,417,0.38,47,757,0.36,51,77,-107,-171.96
1956,Romania,395,0.38,47,352,0.32,56,747,0.35,52,-43,-7,514.29
1956,Portugal,300,0.29,59,443,0.41,45,743,0.35,53,143,114,25.44
1956,Thailand,361,0.35,50,365,0.33,53,726,0.34,54,4,3,33.33
1956,Türkiye,305,0.29,56,407,0.37,49,712,0.33,55,102,185,-44.86
1956,Sri Lanka,364,0.35,49,342,0.31,57,706,0.33,56,-22,-100,-78.0
1956,Peru,311,0.3,55,361,0.33,54,672,0.32,57,50,32,56.25
1956,Greece,190,0.18,65,464,0.43,43,654,0.31,58,274,199,37.69
1956,Bulgaria,302,0.29,58,251,0.23,60,553,0.26,59,-51,13,-492.31
1956,Zambia,344,0.33,51,151,0.14,76,495,0.23,60,-193,-191,1.05
1956,Ghana,242,0.23,61,249,0.23,61,491,0.23,61,7,-22,-131.82
1956,Israel,107,0.1,83,378,0.35,51,485,0.23,62,271,248,9.27
1956,Myanmar,249,0.24,60,198,0.18,68,447,0.21,63,-51,-45,13.33
1956,Uruguay,216,0.21,62,209,0.19,66,425,0.2,64,-7,54,-112.96
1956,"Korea, Republic of",25,0.02,115,386,0.35,50,411,0.19,65,361,323,11.76
1956,Senegal,158,0.15,68,246,0.23,62,404,0.19,66,88,112,-21.43
1956,"Yemen, People's Democratic Republic",180,0.17,67,199,0.18,67,379,0.18,67,19,34,-44.12
1956,Trinidad and Tobago,192,0.19,63,176,0.16,73,368,0.17,68,-16,5,-420.0
1956,Zimbabwe,134,0.13,71,234,0.21,64,368,0.17,68,100,103,-2.91
1956,"Bahrain, Kingdom of",190,0.18,65,170,0.16,74,360,0.17,70,-20,-19,5.26
1956,Syrian Arab Republic,148,0.14,70,187,0.17,72,335,0.16,71,39,35,11.43
1956,Sudan,192,0.19,63,130,0.12,79,322,0.15,72,-62,-5,1140.0
1956,Chinese Taipei,119,0.11,74,194,0.18,70,313,0.15,73,75,78,-3.85
1956,Tunisia,112,0.11,80,194,0.18,70,306,0.14,74,82,74,10.81
1956,Kenya,92,0.09,85,195,0.18,69,287,0.13,75,103,122,-15.57
1956,Lebanese Republic,40,0.04,104,237,0.22,63,277,0.13,76,197,185,6.49
1956,Jamaica,110,0.11,81,163,0.15,75,273,0.13,77,53,35,51.43
1956,Viet Nam,45,0.04,100,218,0.2,65,263,0.12,78,173,194,-10.82
1956,Côte d'Ivoire,151,0.15,69,105,0.1,86,256,0.12,79,-46,-37,24.32
1956,Guatemala,116,0.11,75,138,0.13,77,254,0.12,80,22,5,340.0
1956,Dominican Republic,122,0.12,73,126,0.12,81,248,0.12,81,4,-1,-500.0
1956,Tanzania,127,0.12,72,101,0.09,88,228,0.11,82,-26,20,-230.0
1956,Madagascar,93,0.09,84,132,0.12,78,225,0.11,83,39,40,-2.5
1956,Ecuador,116,0.11,75,108,0.1,85,224,0.11,84,-8,0,
1956,Angola,114,0.11,78,110,0.1,83,224,0.11,84,-4,-5,-20.0
1956,El Salvador,113,0.11,79,105,0.1,86,218,0.1,86,-8,-15,-46.67
1956,Uganda,116,0.11,75,79,0.07,95,195,0.09,87,-37,-23,60.87
1956,Cyprus,63,0.06,92,109,0.1,84,172,0.08,88,46,33,39.39
1956,Cameroon,75,0.07,88,95,0.09,89,170,0.08,89,20,9,122.22
1956,"Bolivia, Plurinational State of",80,0.08,87,84,0.08,94,164,0.08,90,4,-4,-200.0
1956,Costa Rica,68,0.07,90,91,0.08,91,159,0.07,91,23,7,228.57
1956,Iceland,63,0.06,92,90,0.08,93,153,0.07,92,27,26,3.85
1956,Mozambique,55,0.05,98,95,0.09,89,150,0.07,93,40,37,8.11
1956,Honduras,73,0.07,89,77,0.07,97,150,0.07,93,4,25,-84.0
1956,Brunei Darussalam,108,0.1,82,34,0.03,122,142,0.07,95,-74,-69,7.25
1956,Nicaragua,65,0.06,91,69,0.06,99,134,0.06,96,4,-10,-140.0
1956,United Arab Emirates,2,0.0,160,130,0.12,79,132,0.06,97,128,118,8.47
1956,Ethiopia,61,0.06,95,63,0.06,101,124,0.06,98,2,3,-33.33
1956,Guyana,55,0.05,98,58,0.05,102,113,0.05,99,3,2,50.0
1956,Mauritius,63,0.06,92,48,0.04,105,111,0.05,100,-15,0,
1956,Qatar,90,0.09,86,20,0.02,132,110,0.05,101,-70,-66,6.06
1956,Panama,19,0.02,121,91,0.08,91,110,0.05,101,72,60,20.0
1956,Afghanistan,59,0.06,96,46,0.04,107,105,0.05,103,-13,5,-360.0
1956,Equatorial Guinea,57,0.06,97,45,0.04,111,102,0.05,104,-12,-11,9.09
1956,Sierra Leone,37,0.04,105,65,0.06,100,102,0.05,104,28,19,47.37
1956,Cambodia,37,0.04,105,57,0.05,103,94,0.04,106,20,6,233.33
1956,Jordan,14,0.01,125,78,0.07,96,92,0.04,107,64,68,-5.88
1956,Haiti,42,0.04,102,46,0.04,107,88,0.04,108,4,3,33.33
1956,Malta,11,0.01,131,74,0.07,98,85,0.04,109,63,52,21.15
1956,New Caledonia,41,0.04,103,42,0.04,112,83,0.04,110,1,-6,-116.67
1956,Reunion,36,0.03,107,46,0.04,107,82,0.04,111,10,8,25.0
1956,Papua New Guinea,29,0.03,110,48,0.04,105,77,0.04,112,19,16,18.75
1956,Liberia,45,0.04,100,27,0.02,127,72,0.03,113,-18,-17,5.88
1956,Fiji,28,0.03,113,41,0.04,113,69,0.03,114,13,4,225.0
1956,Guinea,29,0.03,110,38,0.03,115,67,0.03,115,9,8,12.5
1956,Guadeloupe,29,0.03,110,36,0.03,118,65,0.03,116,7,3,133.33
1956,Martinique,28,0.03,113,37,0.03,116,65,0.03,116,9,13,-30.77
1956,Suriname,31,0.03,109,33,0.03,123,64,0.03,118,2,0,
1956,Paraguay,36,0.03,107,28,0.03,125,64,0.03,118,-8,9,-188.89
1956,Congo,11,0.01,131,50,0.05,104,61,0.03,120,39,33,18.18
1956,Albania,19,0.02,121,39,0.04,114,58,0.03,121,20,30,-33.33
1956,Libya,11,0.01,131,46,0.04,107,57,0.03,122,35,28,25.0
1956,Barbados,21,0.02,119,36,0.03,118,57,0.03,122,15,9,66.67
1956,Malawi,22,0.02,117,30,0.03,124,52,0.02,124,8,8,0.0
1956,Chad,22,0.02,117,28,0.03,125,50,0.02,125,6,4,50.0
1956,Mali,13,0.01,126,37,0.03,116,50,0.02,125,24,26,-7.69
1956,Gabon,25,0.02,115,22,0.02,130,47,0.02,127,-3,-8,-62.5
1956,Bahamas,3,0.0,152,36,0.03,118,39,0.02,128,33,27,22.22
1956,Benin,15,0.01,124,22,0.02,130,37,0.02,129,7,8,-12.5
1956,Central African Republic,18,0.02,123,18,0.02,134,36,0.02,130,0,2,-100.0
1956,Lao People's Democratic Republic,1,0.0,166,35,0.03,121,36,0.02,130,34,18,88.89
1956,Djibouti,12,0.01,129,19,0.02,133,31,0.01,132,7,9,-22.22
1956,Niger,20,0.02,120,9,0.01,145,29,0.01,133,-11,-4,175.0
1956,Mauritania,2,0.0,160,27,0.02,127,29,0.01,133,25,25,0.0
1956,Togo,13,0.01,126,15,0.01,135,28,0.01,135,2,-4,-150.0
1956,French Polynesia,13,0.01,126,14,0.01,136,27,0.01,136,1,2,-50.0
1956,Nepal,1,0.0,166,25,0.02,129,26,0.01,137,24,23,4.35
1956,Yemen,10,0.01,134,12,0.01,138,22,0.01,138,2,4,-50.0
1956,Eswatini,12,0.01,129,10,0.01,143,22,0.01,138,-2,-2,0.0
1956,Cabo Verde,10,0.01,134,11,0.01,139,21,0.01,140,1,2,-50.0
1956,"Macao, China",6,0.01,141,13,0.01,137,19,0.01,141,7,4,75.0
1956,Belize,7,0.01,137,11,0.01,139,18,0.01,142,4,4,0.0
1956,Botswana,8,0.01,136,9,0.01,145,17,0.01,143,1,-1,-200.0
1956,Greenland,6,0.01,141,11,0.01,139,17,0.01,143,5,6,-16.67
1956,The Gambia,7,0.01,137,10,0.01,143,17,0.01,143,3,3,0.0
1956,Burkina Faso,6,0.01,141,9,0.01,145,15,0.01,146,3,5,-40.0
1956,Lesotho,3,0.0,152,11,0.01,139,14,0.01,147,8,7,14.29
1956,Guinea-Bissau,7,0.01,137,7,0.01,151,14,0.01,147,0,2,-100.0
1956,Burundi,5,0.0,146,8,0.01,149,13,0.01,149,3,3,0.0
1956,Saint Kitts and Nevis,6,0.01,141,6,0.01,153,12,0.01,150,0,0,
1956,Sao Tomé and Principe,6,0.01,141,5,0.0,155,11,0.01,151,-1,-2,-50.0
1956,Oman,2,0.0,160,9,0.01,145,11,0.01,151,7,6,16.67
1956,Antigua and Barbuda,4,0.0,149,6,0.01,153,10,0.0,153,2,3,-33.33
1956,Samoa,5,0.0,146,5,0.0,155,10,0.0,153,0,-2,-100.0
1956,Grenada,3,0.0,152,7,0.01,151,10,0.0,153,4,1,300.0
1956,Solomon Islands,5,0.0,146,4,0.0,158,9,0.0,156,-1,-2,-50.0
1956,French Guiana,1,0.0,166,8,0.01,149,9,0.0,156,7,7,0.0
1956,Saint Lucia,3,0.0,152,5,0.0,155,8,0.0,158,2,2,0.0
1956,Comoros,3,0.0,152,4,0.0,158,7,0.0,159,1,1,0.0
1956,Guam,7,0.01,137,0,0.0,171,7,0.0,159,-7,-5,40.0
1956,Saint Vincent and the Grenadines,3,0.0,152,4,0.0,158,7,0.0,159,1,2,-50.0
1956,American Samoa,4,0.0,149,3,0.0,164,7,0.0,159,-1,-2,-50.0
1956,Vanuatu,4,0.0,149,3,0.0,164,7,0.0,159,-1,0,
1956,Dominica,3,0.0,152,4,0.0,158,7,0.0,159,1,1,0.0
1956,Maldives,2,0.0,160,4,0.0,158,6,0.0,165,2,3,-33.33
1956,Kiribati,3,0.0,152,3,0.0,164,6,0.0,165,0,-2,-100.0
1956,Saint Pierre and Miquelon,1,0.0,166,4,0.0,158,5,0.0,167,3,2,50.0
1956,Tonga,2,0.0,160,2,0.0,167,4,0.0,168,0,-1,-100.0
1956,Rwanda,2,0.0,160,2,0.0,167,4,0.0,168,0,0,
1956,Seychelles,1,0.0,166,2,0.0,167,3,0.0,170,1,1,0.0
1956,Montserrat,1,0.0,166,2,0.0,167,3,0.0,170,1,1,0.0
1955,United States of America,14291,15.3,1,12489,12.61,1,26780,13.92,1,-1802,-1714,5.13
1955,United Kingdom,8467,9.07,2,10875,10.98,2,19342,10.05,2,2408,1674,43.85
1955,Germany,6124,6.56,3,5826,5.88,3,11950,6.21,3,-298,-642,-53.58
1955,France,4960,5.31,4,4784,4.83,5,9744,5.06,4,-176,36,-588.89
1955,Canada,4574,4.9,5,4996,5.04,4,9570,4.97,5,422,239,76.57
1955,Netherlands,3058,3.27,7,3788,3.82,6,6846,3.56,6,730,588,24.15
1955,U.S.S.R.,3427,3.67,6,3061,3.09,7,6488,3.37,7,-366,-41,792.68
1955,Belgium-Luxembourg,2782,2.98,8,2854,2.88,8,5636,2.93,8,72,244,-70.49
1955,Italy,1856,1.99,10,2712,2.74,9,4568,2.37,9,856,800,7.0
1955,Japan,2011,2.15,9,2471,2.49,10,4482,2.33,10,460,770,-40.26
1955,Australia,1787,1.91,12,2139,2.16,11,3926,2.04,11,352,174,102.3
1955,Sweden,1727,1.85,13,1998,2.02,12,3725,1.94,12,271,193,40.41
1955,China,1410,1.51,16,1730,1.75,13,3140,1.63,13,320,140,128.57
1955,South Africa,1545,1.65,14,1421,1.43,15,2966,1.54,14,-124,-57,117.54
1955,"Venezuela, Bolivarian Republic of",1819,1.95,11,1098,1.11,22,2917,1.52,15,-721,-459,57.08
1955,Switzerland,1286,1.38,17,1464,1.48,14,2750,1.43,16,178,73,143.84
1955,Brazil,1423,1.52,15,1307,1.32,17,2730,1.42,17,-116,72,-261.11
1955,India,1263,1.35,19,1356,1.37,16,2619,1.36,18,93,83,12.05
1955,German Democratic Republic,1278,1.37,18,1173,1.18,20,2451,1.27,19,-105,-190,-44.74
1955,Singapore,1101,1.18,21,1262,1.27,18,2363,1.23,20,161,111,45.05
1955,Denmark,1057,1.13,22,1178,1.19,19,2235,1.16,21,121,207,-41.55
1955,Czech and Slovak Federal Republic,1176,1.26,20,1053,1.06,24,2229,1.16,22,-123,-72,70.83
1955,Argentina,929,0.99,25,1173,1.18,20,2102,1.09,23,244,-48,-608.33
1955,Poland,920,0.99,26,932,0.94,26,1852,0.96,24,12,35,-65.71
1955,Netherlands Antilles,803,0.86,27,996,1.01,25,1799,0.93,25,193,192,0.52
1955,Norway,634,0.68,33,1090,1.1,23,1724,0.9,26,456,436,4.59
1955,Mexico,785,0.84,29,874,0.88,28,1659,0.86,27,89,55,61.82
1955,Malaysia,963,1.03,23,676,0.68,32,1639,0.85,28,-287,-111,158.56
1955,Austria,699,0.75,31,887,0.9,27,1586,0.82,29,188,43,337.21
1955,Indonesia,946,1.01,24,630,0.64,35,1576,0.82,30,-316,-238,32.77
1955,Finland,788,0.84,28,769,0.78,30,1557,0.81,31,-19,-20,-5.0
1955,New Zealand,726,0.78,30,804,0.81,29,1530,0.8,32,78,4,1850.0
1955,Colombia,584,0.63,36,669,0.68,33,1253,0.65,33,85,15,466.67
1955,Cuba,611,0.65,34,575,0.58,38,1186,0.62,34,-36,-8,350.0
1955,Algeria,463,0.5,41,696,0.7,31,1159,0.6,35,233,220,5.91
1955,Hungary,601,0.64,35,554,0.56,40,1155,0.6,36,-47,13,-461.54
1955,"Hong Kong, China",443,0.47,44,651,0.66,34,1094,0.57,37,208,178,16.85
1955,Spain,446,0.48,43,617,0.62,36,1063,0.55,38,171,150,14.0
1955,Philippines,401,0.43,47,607,0.61,37,1008,0.52,39,206,137,50.36
1955,Egypt,419,0.45,45,538,0.54,41,957,0.5,40,119,59,101.69
1955,Chile,472,0.51,40,448,0.45,44,920,0.48,41,-24,-53,-54.72
1955,Ireland,309,0.33,55,572,0.58,39,881,0.46,42,263,182,44.51
1955,Iran,540,0.58,38,337,0.34,53,877,0.46,43,-203,-22,822.73
1955,Democratic Republic of the Congo,456,0.49,42,379,0.38,50,835,0.43,44,-77,-26,196.15
1955,Morocco,328,0.35,53,497,0.5,43,825,0.43,45,169,193,-12.44
1955,Türkiye,313,0.34,54,498,0.5,42,811,0.42,46,185,143,29.37
1955,Iraq,519,0.56,39,272,0.27,58,791,0.41,47,-247,-285,-13.33
1955,"Saudi Arabia, Kingdom of",542,0.58,37,245,0.25,62,787,0.41,48,-297,-451,-34.15
1955,Romania,391,0.42,48,384,0.39,47,775,0.4,49,-7,-22,-68.18
1955,Nigeria,371,0.4,50,381,0.38,49,752,0.39,50,10,-100,-110.0
1955,"Kuwait, the State of",651,0.7,32,94,0.09,87,745,0.39,51,-557,-480,16.04
1955,Sri Lanka,407,0.44,46,307,0.31,55,714,0.37,52,-100,-87,14.94
1955,"Yugoslavia, Socialist Federal Republic of",257,0.28,59,441,0.45,45,698,0.36,53,184,99,85.86
1955,Portugal,284,0.3,56,398,0.4,46,682,0.35,54,114,97,17.53
1955,Thailand,335,0.36,51,338,0.34,52,673,0.35,55,3,28,-89.29
1955,Pakistan,385,0.41,49,278,0.28,57,663,0.34,56,-107,-25,328.0
1955,Peru,271,0.29,57,303,0.31,56,574,0.3,57,32,2,1500.0
1955,Greece,183,0.2,64,382,0.39,48,565,0.29,58,199,178,11.8
1955,Ghana,268,0.29,58,246,0.25,61,514,0.27,59,-22,-122,-81.97
1955,Bulgaria,237,0.25,60,250,0.25,60,487,0.25,60,13,-37,-135.14
1955,Zambia,329,0.35,52,138,0.14,76,467,0.24,61,-191,-135,41.48
1955,Israel,89,0.1,84,337,0.34,53,426,0.22,62,248,204,21.57
1955,Uruguay,184,0.2,63,238,0.24,64,422,0.22,63,54,25,116.0
1955,Myanmar,226,0.24,61,181,0.18,70,407,0.21,64,-45,-46,-2.17
1955,"Yemen, People's Democratic Republic",176,0.19,65,210,0.21,67,386,0.2,65,34,61,-44.26
1955,Senegal,131,0.14,70,243,0.25,63,374,0.19,66,112,85,31.76
1955,"Bahrain, Kingdom of",193,0.21,62,174,0.18,73,367,0.19,67,-19,-21,-9.52
1955,"Korea, Republic of",18,0.02,121,341,0.34,51,359,0.19,68,323,219,47.49
1955,Zimbabwe,126,0.13,71,229,0.23,65,355,0.18,69,103,105,-1.9
1955,Trinidad and Tobago,167,0.18,66,172,0.17,74,339,0.18,70,5,-6,-183.33
1955,Viet Nam,69,0.07,91,263,0.27,59,332,0.17,71,194,294,-34.01
1955,Chinese Taipei,123,0.13,72,201,0.2,68,324,0.17,72,78,118,-33.9
1955,Syrian Arab Republic,144,0.15,69,179,0.18,72,323,0.17,73,35,26,34.62
1955,Tunisia,107,0.11,76,181,0.18,70,288,0.15,74,74,43,72.09
1955,Sudan,145,0.16,68,140,0.14,75,285,0.15,75,-5,23,-121.74
1955,Kenya,78,0.08,90,200,0.2,69,278,0.14,76,122,104,17.31
1955,Côte d'Ivoire,146,0.16,67,109,0.11,83,255,0.13,77,-37,-45,-17.78
1955,Lebanese Republic,33,0.04,106,218,0.22,66,251,0.13,78,185,145,27.59
1955,Dominican Republic,115,0.12,74,114,0.12,81,229,0.12,79,-1,-26,-96.15
1955,Ecuador,114,0.12,75,114,0.12,81,228,0.12,80,0,-5,-100.0
1955,Tanzania,102,0.11,78,122,0.12,78,224,0.12,81,20,-13,-253.85
1955,Jamaica,93,0.1,83,128,0.13,77,221,0.11,82,35,19,84.21
1955,Uganda,118,0.13,73,95,0.1,86,213,0.11,83,-23,-44,-47.73
1955,Madagascar,82,0.09,87,122,0.12,78,204,0.11,84,40,45,-11.11
1955,Guatemala,99,0.11,79,104,0.1,84,203,0.11,85,5,-10,-150.0
1955,El Salvador,107,0.11,76,92,0.09,89,199,0.1,86,-15,-18,-16.67
1955,Cameroon,95,0.1,82,104,0.1,84,199,0.1,86,9,6,50.0
1955,Angola,98,0.1,81,93,0.09,88,191,0.1,88,-5,-7,-28.57
1955,Costa Rica,81,0.09,88,88,0.09,91,169,0.09,89,7,-4,-275.0
1955,"Bolivia, Plurinational State of",86,0.09,85,82,0.08,93,168,0.09,90,-4,-15,-73.33
1955,Nicaragua,80,0.09,89,70,0.07,98,150,0.08,91,-10,-5,100.0
1955,Mozambique,53,0.06,95,90,0.09,90,143,0.07,92,37,30,23.33
1955,Cyprus,52,0.06,98,85,0.09,92,137,0.07,93,33,18,83.33
1955,Ethiopia,65,0.07,92,68,0.07,99,133,0.07,94,3,-1,-400.0
1955,Iceland,52,0.06,98,78,0.08,95,130,0.07,95,26,17,52.94
1955,Brunei Darussalam,99,0.11,79,30,0.03,121,129,0.07,96,-69,-56,23.21
1955,Afghanistan,60,0.06,93,65,0.07,100,125,0.06,97,5,17,-70.59
1955,United Arab Emirates,2,0.0,157,120,0.12,80,122,0.06,98,118,98,20.41
1955,Honduras,47,0.05,100,72,0.07,97,119,0.06,99,25,13,92.31
1955,Guyana,53,0.06,95,55,0.06,102,108,0.06,100,2,-3,-166.67
1955,Mauritius,53,0.06,95,53,0.05,103,106,0.06,101,0,-11,-100.0
1955,Panama,22,0.02,117,82,0.08,93,104,0.05,102,60,61,-1.64
1955,Qatar,83,0.09,86,17,0.02,135,100,0.05,103,-66,-52,26.92
1955,Equatorial Guinea,55,0.06,94,44,0.04,107,99,0.05,104,-11,-5,120.0
1955,Cambodia,40,0.04,102,46,0.05,105,86,0.04,105,6,-13,-146.15
1955,Jordan,8,0.01,134,76,0.08,96,84,0.04,106,68,48,41.67
1955,Sierra Leone,29,0.03,110,48,0.05,104,77,0.04,107,19,0,
1955,Haiti,36,0.04,104,39,0.04,112,75,0.04,108,3,-7,-142.86
1955,Papua New Guinea,29,0.03,110,45,0.05,106,74,0.04,109,16,10,60.0
1955,Reunion,33,0.04,106,41,0.04,110,74,0.04,109,8,11,-27.27
1955,New Caledonia,39,0.04,103,33,0.03,119,72,0.04,111,-6,-3,100.0
1955,Guadeloupe,34,0.04,105,37,0.04,115,71,0.04,112,3,3,0.0
1955,Paraguay,30,0.03,109,39,0.04,112,69,0.04,113,9,11,-18.18
1955,Liberia,43,0.05,101,26,0.03,126,69,0.04,113,-17,-3,466.67
1955,Fiji,32,0.03,108,36,0.04,117,68,0.04,115,4,1,300.0
1955,Malta,7,0.01,136,59,0.06,101,66,0.03,116,52,49,6.12
1955,Guinea,29,0.03,110,37,0.04,115,66,0.03,116,8,10,-20.0
1955,Martinique,26,0.03,115,39,0.04,112,65,0.03,118,13,12,8.33
1955,Albania,13,0.01,124,43,0.04,108,56,0.03,119,30,15,100.0
1955,Barbados,23,0.02,116,32,0.03,120,55,0.03,120,9,4,125.0
1955,Suriname,27,0.03,114,27,0.03,124,54,0.03,121,0,-1,-100.0
1955,Congo,10,0.01,130,43,0.04,108,53,0.03,122,33,35,-5.71
1955,Libya,12,0.01,126,40,0.04,111,52,0.03,123,28,21,33.33
1955,Malawi,20,0.02,119,28,0.03,123,48,0.02,124,8,6,33.33
1955,Gabon,28,0.03,113,20,0.02,131,48,0.02,124,-8,-7,14.29
1955,Mali,10,0.01,130,36,0.04,117,46,0.02,126,26,23,13.04
1955,Chad,20,0.02,119,24,0.02,127,44,0.02,127,4,0,
1955,Togo,22,0.02,117,18,0.02,133,40,0.02,128,-4,-8,-50.0
1955,Benin,16,0.02,122,24,0.02,127,40,0.02,128,8,9,-11.11
1955,Djibouti,13,0.01,124,22,0.02,130,35,0.02,130,9,10,-10.0
1955,Central African Republic,16,0.02,122,18,0.02,133,34,0.02,131,2,-4,-150.0
1955,Bahamas,3,0.0,153,30,0.03,121,33,0.02,132,27,22,22.73
1955,Mauritania,2,0.0,157,27,0.03,124,29,0.02,133,25,24,4.17
1955,French Polynesia,12,0.01,126,14,0.01,136,26,0.01,134,2,1,100.0
1955,Nepal,1,0.0,165,24,0.02,127,25,0.01,135,23,22,4.55
1955,Yemen,10,0.01,130,14,0.01,136,24,0.01,136,4,5,-20.0
1955,Cabo Verde,10,0.01,130,12,0.01,138,22,0.01,137,2,0,
1955,Niger,12,0.01,126,8,0.01,146,20,0.01,138,-4,-1,300.0
1955,Eswatini,11,0.01,129,9,0.01,145,20,0.01,138,-2,-1,100.0
1955,Lao People's Democratic Republic,1,0.0,165,19,0.02,132,20,0.01,138,18,15,20.0
1955,"Macao, China",7,0.01,136,11,0.01,139,18,0.01,141,4,37,-89.19
1955,The Gambia,7,0.01,136,10,0.01,141,17,0.01,142,3,-2,-250.0
1955,Belize,6,0.01,140,10,0.01,141,16,0.01,143,4,3,33.33
1955,Greenland,5,0.01,142,11,0.01,139,16,0.01,143,6,4,50.0
1955,Botswana,8,0.01,134,7,0.01,149,15,0.01,145,-1,-1,0.0
1955,Burkina Faso,5,0.01,142,10,0.01,141,15,0.01,145,5,3,66.67
1955,Lesotho,3,0.0,153,10,0.01,141,13,0.01,147,7,7,0.0
1955,Guinea-Bissau,5,0.01,142,7,0.01,149,12,0.01,148,2,-1,-300.0
1955,Samoa,7,0.01,136,5,0.01,154,12,0.01,148,-2,-1,100.0
1955,Burundi,4,0.0,149,7,0.01,149,11,0.01,150,3,2,50.0
1955,Grenada,5,0.01,142,6,0.01,152,11,0.01,150,1,0,
1955,Sao Tomé and Principe,6,0.01,140,4,0.0,156,10,0.01,152,-2,-5,-60.0
1955,Oman,2,0.0,157,8,0.01,146,10,0.01,152,6,6,0.0
1955,Saint Kitts and Nevis,5,0.01,142,5,0.01,154,10,0.01,152,0,1,-100.0
1955,Antigua and Barbuda,3,0.0,153,6,0.01,152,9,0.0,155,3,2,50.0
1955,French Guiana,1,0.0,165,8,0.01,146,9,0.0,155,7,10,-30.0
1955,Solomon Islands,5,0.01,142,3,0.0,162,8,0.0,157,-2,-1,100.0
1955,Vanuatu,4,0.0,149,4,0.0,156,8,0.0,157,0,-2,-100.0
1955,Dominica,3,0.0,153,4,0.0,156,7,0.0,159,1,0,
1955,Saint Vincent and the Grenadines,2,0.0,157,4,0.0,156,6,0.0,160,2,1,100.0
1955,American Samoa,4,0.0,149,2,0.0,165,6,0.0,160,-2,0,
1955,Kiribati,4,0.0,149,2,0.0,165,6,0.0,160,-2,-1,100.0
1955,Saint Lucia,2,0.0,157,4,0.0,156,6,0.0,160,2,1,100.0
1955,Comoros,2,0.0,157,3,0.0,162,5,0.0,164,1,0,
1955,Guam,5,0.01,142,0,0.0,171,5,0.0,164,-5,-5,0.0
1955,Maldives,1,0.0,165,4,0.0,156,5,0.0,164,3,1,200.0
1955,Rwanda,2,0.0,157,2,0.0,165,4,0.0,167,0,0,
1955,Saint Pierre and Miquelon,1,0.0,165,3,0.0,162,4,0.0,167,2,2,0.0
1955,Seychelles,1,0.0,165,2,0.0,165,3,0.0,169,1,0,
1955,Tonga,2,0.0,157,1,0.0,170,3,0.0,169,-1,3,-133.33
1955,Montserrat,1,0.0,165,2,0.0,165,3,0.0,169,1,1,0.0
1954,United States of America,12854,15.19,1,11140,12.55,1,23994,13.84,1,-1714,-416,312.02
1954,United Kingdom,7770,9.18,2,9444,10.64,2,17214,9.93,2,1674,1834,-8.72
1954,Germany,5246,6.2,3,4604,5.19,3,9850,5.68,3,-642,-599,7.18
1954,France,4313,5.1,4,4349,4.9,5,8662,5.0,4,36,147,-75.51
1954,Canada,4197,4.96,5,4436,5.0,4,8633,4.98,5,239,311,-23.15
1954,U.S.S.R.,3223,3.81,6,3182,3.58,7,6405,3.69,6,-41,-179,-77.09
1954,Netherlands,2754,3.26,7,3342,3.76,6,6096,3.52,7,588,299,96.66
1954,Belgium-Luxembourg,2314,2.74,8,2558,2.88,8,4872,2.81,8,244,162,50.62
1954,Italy,1638,1.94,10,2438,2.75,9,4076,2.35,9,800,914,-12.47
1954,Japan,1629,1.93,11,2399,2.7,10,4028,2.32,10,770,1133,-32.04
1954,Australia,1677,1.98,9,1851,2.08,11,3528,2.03,11,174,-570,-130.53
1954,Sweden,1584,1.87,12,1777,2.0,12,3361,1.94,12,193,99,94.95
1954,Brazil,1562,1.85,13,1634,1.84,13,3196,1.84,13,72,-220,-132.73
1954,South Africa,1362,1.61,15,1305,1.47,14,2667,1.54,14,-57,-110,-48.18
1954,Switzerland,1206,1.43,17,1279,1.44,16,2485,1.43,15,73,-21,-447.62
1954,China,1150,1.36,19,1290,1.45,15,2440,1.41,16,140,330,-57.58
1954,India,1169,1.38,18,1252,1.41,17,2421,1.4,17,83,59,40.68
1954,German Democratic Republic,1287,1.52,16,1097,1.24,19,2384,1.38,18,-190,15,-1366.67
1954,"Venezuela, Bolivarian Republic of",1396,1.65,14,937,1.06,24,2333,1.35,19,-459,-502,-8.57
1954,Denmark,963,1.14,22,1170,1.32,18,2133,1.23,20,207,106,95.28
1954,Argentina,1027,1.21,20,979,1.1,22,2006,1.16,21,-48,-330,-85.45
1954,Czech and Slovak Federal Republic,1005,1.19,21,933,1.05,25,1938,1.12,22,-72,-115,-37.39
1954,Singapore,877,1.04,23,988,1.11,21,1865,1.08,23,111,120,-7.5
1954,Poland,869,1.03,24,904,1.02,26,1773,1.02,24,35,-57,-161.4
1954,Netherlands Antilles,773,0.91,26,965,1.09,23,1738,1.0,25,192,153,25.49
1954,Norway,583,0.69,34,1019,1.15,20,1602,0.92,26,436,404,7.92
1954,Indonesia,867,1.02,25,629,0.71,32,1496,0.86,27,-238,-75,217.33
1954,Mexico,659,0.78,30,714,0.8,27,1373,0.79,28,55,217,-74.65
1954,New Zealand,684,0.81,28,688,0.77,28,1372,0.79,29,4,-122,-103.28
1954,Finland,681,0.81,29,661,0.74,30,1342,0.77,30,-20,-42,-52.38
1954,Colombia,657,0.78,31,672,0.76,29,1329,0.77,31,15,-49,-130.61
1954,Malaysia,694,0.82,27,583,0.66,36,1277,0.74,32,-111,-54,105.56
1954,Austria,610,0.72,33,653,0.74,31,1263,0.73,33,43,4,975.0
1954,Cuba,563,0.67,36,555,0.63,37,1118,0.64,34,-8,-128,-93.75
1954,Spain,464,0.55,39,614,0.69,34,1078,0.62,35,150,114,31.58
1954,Hungary,519,0.61,37,532,0.6,39,1051,0.61,36,13,-10,-230.0
1954,"Hong Kong, China",423,0.5,40,601,0.68,35,1024,0.59,37,178,200,-11.0
1954,Algeria,401,0.47,43,621,0.7,33,1022,0.59,38,220,182,20.88
1954,Philippines,401,0.47,43,538,0.61,38,939,0.54,39,137,103,33.01
1954,Egypt,413,0.49,42,472,0.53,43,885,0.51,40,59,108,-45.37
1954,Ireland,322,0.38,51,504,0.57,40,826,0.48,41,182,193,-5.7
1954,Türkiye,335,0.4,50,478,0.54,42,813,0.47,42,143,137,4.38
1954,"Saudi Arabia, Kingdom of",631,0.75,32,180,0.2,68,811,0.47,43,-451,-335,34.63
1954,Democratic Republic of the Congo,397,0.47,46,371,0.42,44,768,0.44,44,-26,-35,-25.71
1954,Morocco,287,0.34,54,480,0.54,41,767,0.44,45,193,220,-12.27
1954,Chile,398,0.47,45,345,0.39,47,743,0.43,46,-53,-73,-27.4
1954,Nigeria,419,0.5,41,319,0.36,52,738,0.43,47,-100,-45,122.22
1954,Romania,360,0.43,48,338,0.38,49,698,0.4,48,-22,44,-150.0
1954,Iraq,489,0.58,38,204,0.23,63,693,0.4,49,-285,-200,42.5
1954,Pakistan,359,0.42,49,334,0.38,50,693,0.4,49,-25,-89,-71.91
1954,Sri Lanka,380,0.45,47,293,0.33,54,673,0.39,51,-87,9,-1066.67
1954,"Kuwait, the State of",564,0.67,35,84,0.09,89,648,0.37,52,-480,-412,16.5
1954,Portugal,254,0.3,57,351,0.4,45,605,0.35,53,97,112,-13.39
1954,Iran,309,0.37,53,287,0.32,56,596,0.34,54,-22,44,-150.0
1954,Thailand,283,0.33,55,311,0.35,53,594,0.34,55,28,7,300.0
1954,"Yugoslavia, Socialist Federal Republic of",240,0.28,61,339,0.38,48,579,0.33,56,99,209,-52.63
1954,Uruguay,249,0.29,59,274,0.31,57,523,0.3,57,25,-63,-139.68
1954,Ghana,321,0.38,52,199,0.22,65,520,0.3,58,-122,-45,171.11
1954,Peru,248,0.29,60,250,0.28,58,498,0.29,59,2,71,-97.18
1954,Greece,152,0.18,65,330,0.37,51,482,0.28,60,178,143,24.48
1954,Myanmar,250,0.3,58,204,0.23,63,454,0.26,61,-46,-59,-22.03
1954,Bulgaria,233,0.28,62,196,0.22,66,429,0.25,62,-37,-6,516.67
1954,Viet Nam,57,0.07,93,351,0.4,45,408,0.24,63,294,343,-14.29
1954,Zambia,262,0.31,56,127,0.14,77,389,0.22,64,-135,-118,14.41
1954,Senegal,152,0.18,65,237,0.27,60,389,0.22,64,85,88,-3.41
1954,"Bahrain, Kingdom of",201,0.24,63,180,0.2,68,381,0.22,66,-21,-37,-43.24
1954,Israel,86,0.1,84,290,0.33,55,376,0.22,67,204,223,-8.52
1954,Zimbabwe,120,0.14,72,225,0.25,61,345,0.2,68,105,85,23.53
1954,Syrian Arab Republic,148,0.17,68,174,0.2,70,322,0.19,69,26,15,73.33
1954,"Yemen, People's Democratic Republic",125,0.15,70,186,0.21,67,311,0.18,70,61,55,10.91
1954,Chinese Taipei,93,0.11,80,211,0.24,62,304,0.18,71,118,64,84.38
1954,Trinidad and Tobago,152,0.18,65,146,0.16,74,298,0.17,72,-6,-12,-50.0
1954,Tunisia,127,0.15,69,170,0.19,72,297,0.17,73,43,60,-28.33
1954,Côte d'Ivoire,156,0.18,64,111,0.13,79,267,0.15,74,-45,-38,18.42
1954,"Korea, Republic of",24,0.03,114,243,0.27,59,267,0.15,74,219,305,-28.2
1954,Sudan,116,0.14,74,139,0.16,75,255,0.15,76,23,18,27.78
1954,Ecuador,125,0.15,70,120,0.14,78,245,0.14,77,-5,-18,-72.22
1954,Kenya,64,0.08,90,168,0.19,73,232,0.13,78,104,81,28.4
1954,Madagascar,92,0.11,81,137,0.15,76,229,0.13,79,45,44,2.27
1954,Dominican Republic,120,0.14,72,94,0.11,83,214,0.12,80,-26,-6,333.33
1954,Lebanese Republic,29,0.03,107,174,0.2,70,203,0.12,81,145,119,21.85
1954,Angola,103,0.12,77,96,0.11,82,199,0.11,82,-7,-38,-81.58
1954,Tanzania,103,0.12,77,90,0.1,85,193,0.11,83,-13,-18,-27.78
1954,El Salvador,105,0.12,76,87,0.1,86,192,0.11,84,-18,-17,5.88
1954,Jamaica,86,0.1,84,105,0.12,80,191,0.11,85,19,28,-32.14
1954,Uganda,115,0.14,75,71,0.08,92,186,0.11,86,-44,-22,100.0
1954,Guatemala,96,0.11,79,86,0.1,87,182,0.1,87,-10,-9,11.11
1954,Cameroon,87,0.1,83,93,0.1,84,180,0.1,88,6,5,20.0
1954,Costa Rica,85,0.1,86,81,0.09,90,166,0.1,89,-4,-6,-33.33
1954,"Bolivia, Plurinational State of",80,0.09,87,65,0.07,96,145,0.08,90,-15,-29,-48.28
1954,Mozambique,55,0.07,95,85,0.1,88,140,0.08,91,30,24,25.0
1954,Ethiopia,65,0.08,89,64,0.07,98,129,0.07,92,-1,-12,-91.67
1954,Honduras,55,0.07,95,68,0.08,94,123,0.07,93,13,3,333.33
1954,Brunei Darussalam,89,0.11,82,33,0.04,116,122,0.07,94,-56,-55,1.82
1954,Iceland,52,0.06,98,69,0.08,93,121,0.07,95,17,24,-29.17
1954,Nicaragua,63,0.07,91,58,0.07,99,121,0.07,95,-5,-11,-54.55
1954,Cyprus,48,0.06,101,66,0.07,95,114,0.07,97,18,16,12.5
1954,Afghanistan,48,0.06,101,65,0.07,96,113,0.07,98,17,18,-5.56
1954,Cambodia,63,0.07,91,50,0.06,102,113,0.07,98,-13,-12,8.33
1954,Haiti,55,0.07,95,48,0.05,103,103,0.06,100,-7,7,-200.0
1954,United Arab Emirates,2,0.0,156,100,0.11,81,102,0.06,101,98,88,11.36
1954,Mauritius,56,0.07,94,45,0.05,105,101,0.06,102,-11,-5,120.0
1954,Panama,19,0.02,121,80,0.09,91,99,0.06,103,61,60,1.67
1954,Guyana,50,0.06,99,47,0.05,104,97,0.06,104,-3,-6,-50.0
1954,Equatorial Guinea,50,0.06,99,45,0.05,105,95,0.05,105,-5,0,
1954,Qatar,68,0.08,88,16,0.02,133,84,0.05,106,-52,-41,26.83
1954,Paraguay,30,0.04,106,41,0.05,108,71,0.04,107,11,8,37.5
1954,Guadeloupe,33,0.04,103,36,0.04,113,69,0.04,108,3,9,-66.67
1954,Papua New Guinea,28,0.03,109,38,0.04,110,66,0.04,109,10,4,150.0
1954,Malta,8,0.01,135,57,0.06,100,65,0.04,110,49,48,2.08
1954,Jordan,8,0.01,135,56,0.06,101,64,0.04,111,48,46,4.35
1954,Guinea,27,0.03,111,37,0.04,111,64,0.04,111,10,13,-23.08
1954,Sierra Leone,32,0.04,104,32,0.04,117,64,0.04,111,0,-2,-100.0
1954,Reunion,26,0.03,112,37,0.04,111,63,0.04,114,11,5,120.0
1954,New Caledonia,32,0.04,104,29,0.03,119,61,0.04,115,-3,1,-400.0
1954,Martinique,24,0.03,114,36,0.04,113,60,0.03,116,12,15,-20.0
1954,Suriname,29,0.03,107,28,0.03,121,57,0.03,117,-1,2,-150.0
1954,Fiji,28,0.03,109,29,0.03,119,57,0.03,117,1,-6,-116.67
1954,Barbados,24,0.03,114,28,0.03,121,52,0.03,119,4,3,33.33
1954,Congo,8,0.01,135,43,0.05,107,51,0.03,120,35,34,2.94
1954,Liberia,26,0.03,112,23,0.03,127,49,0.03,121,-3,-12,-75.0
1954,Mali,13,0.02,125,36,0.04,113,49,0.03,121,23,21,9.52
1954,Malawi,20,0.02,119,26,0.03,123,46,0.03,123,6,1,500.0
1954,"Macao, China",3,0.0,151,40,0.05,109,43,0.02,124,37,37,0.0
1954,Libya,10,0.01,128,31,0.03,118,41,0.02,125,21,22,-4.55
1954,Gabon,24,0.03,114,17,0.02,132,41,0.02,125,-7,-8,-12.5
1954,Togo,24,0.03,114,16,0.02,133,40,0.02,127,-8,-4,100.0
1954,Chad,19,0.02,121,19,0.02,131,38,0.02,128,0,4,-100.0
1954,Benin,14,0.02,124,23,0.03,127,37,0.02,129,9,1,800.0
1954,Central African Republic,20,0.02,119,16,0.02,133,36,0.02,130,-4,-1,300.0
1954,Albania,10,0.01,128,25,0.03,126,35,0.02,131,15,29,-48.28
1954,Djibouti,12,0.01,126,22,0.02,130,34,0.02,132,10,12,-16.67
1954,Cabo Verde,15,0.02,123,15,0.02,137,30,0.02,133,0,-1,-100.0
1954,Bahamas,4,0.0,147,26,0.03,123,30,0.02,133,22,21,4.76
1954,Mauritania,2,0.0,156,26,0.03,123,28,0.02,135,24,22,9.09
1954,Nepal,1,0.0,165,23,0.03,127,24,0.01,136,22,21,4.76
1954,Yemen,9,0.01,131,14,0.02,138,23,0.01,137,5,3,66.67
1954,Niger,11,0.01,127,10,0.01,140,21,0.01,138,-1,-2,-50.0
1954,French Polynesia,10,0.01,128,11,0.01,139,21,0.01,138,1,3,-66.67
1954,Eswatini,9,0.01,131,8,0.01,144,17,0.01,140,-1,-1,0.0
1954,Lao People's Democratic Republic,1,0.0,165,16,0.02,133,17,0.01,140,15,10,50.0
1954,Greenland,6,0.01,140,10,0.01,140,16,0.01,142,4,3,33.33
1954,The Gambia,9,0.01,131,7,0.01,147,16,0.01,142,-2,-2,0.0
1954,Sao Tomé and Principe,9,0.01,131,4,0.0,155,13,0.01,144,-5,-5,0.0
1954,Botswana,7,0.01,138,6,0.01,149,13,0.01,144,-1,1,-200.0
1954,Guinea-Bissau,7,0.01,138,6,0.01,149,13,0.01,144,-1,0,
1954,Belize,5,0.01,142,8,0.01,144,13,0.01,144,3,3,0.0
1954,Lesotho,2,0.0,156,9,0.01,143,11,0.01,148,7,7,0.0
1954,Saint Kitts and Nevis,5,0.01,142,6,0.01,149,11,0.01,148,1,-1,-200.0
1954,Samoa,6,0.01,140,5,0.01,153,11,0.01,148,-1,-1,0.0
1954,Burkina Faso,4,0.0,147,7,0.01,147,11,0.01,148,3,3,0.0
1954,Oman,2,0.0,156,8,0.01,144,10,0.01,152,6,6,0.0
1954,Burundi,4,0.0,147,6,0.01,149,10,0.01,152,2,3,-33.33
1954,Grenada,5,0.01,142,5,0.01,153,10,0.01,152,0,0,
1954,French Guiana,0,0.0,170,10,0.01,140,10,0.01,152,10,7,42.86
1954,Vanuatu,5,0.01,142,3,0.0,158,8,0.0,156,-2,-2,0.0
1954,Solomon Islands,4,0.0,147,3,0.0,158,7,0.0,157,-1,-1,0.0
1954,Maldives,3,0.0,151,4,0.0,155,7,0.0,157,1,1,0.0
1954,Comoros,3,0.0,151,3,0.0,158,6,0.0,159,0,1,-100.0
1954,Antigua and Barbuda,2,0.0,156,4,0.0,155,6,0.0,159,2,1,100.0
1954,Dominica,3,0.0,151,3,0.0,158,6,0.0,159,0,0,
1954,Guam,5,0.01,142,0,0.0,171,5,0.0,162,-5,-4,25.0
1954,Saint Vincent and the Grenadines,2,0.0,156,3,0.0,158,5,0.0,162,1,1,0.0
1954,Kiribati,3,0.0,151,2,0.0,166,5,0.0,162,-1,-1,0.0
1954,Saint Lucia,2,0.0,156,3,0.0,158,5,0.0,162,1,0,
1954,Seychelles,2,0.0,156,2,0.0,166,4,0.0,166,0,0,
1954,Rwanda,2,0.0,156,2,0.0,166,4,0.0,166,0,0,
1954,Saint Pierre and Miquelon,1,0.0,165,3,0.0,158,4,0.0,166,2,2,0.0
1954,Tonga,0,0.0,170,3,0.0,158,3,0.0,169,3,3,0.0
1954,Montserrat,1,0.0,165,2,0.0,166,3,0.0,169,1,1,0.0
1954,American Samoa,1,0.0,165,1,0.0,170,2,0.0,171,0,0,
1953,United States of America,12262,15.26,1,11846,13.9,1,24108,14.56,1,-416,-1496,-72.19
1953,United Kingdom,7526,9.37,2,9360,10.98,2,16886,10.2,2,1834,2151,-14.74
1953,Canada,4385,5.46,4,4696,5.51,3,9081,5.48,3,311,-257,-221.01
1953,Germany,4411,5.49,3,3812,4.47,5,8223,4.97,4,-599,-169,254.44
1953,France,4019,5.0,5,4166,4.89,4,8185,4.94,5,147,503,-70.78
1953,U.S.S.R.,2948,3.67,6,2769,3.25,7,5717,3.45,6,-179,-283,-36.75
1953,Netherlands,2486,3.09,7,2785,3.27,6,5271,3.18,7,299,167,79.04
1953,Belgium-Luxembourg,2268,2.82,8,2430,2.85,8,4698,2.84,8,162,8,1925.0
1953,Italy,1507,1.88,11,2421,2.84,9,3928,2.37,9,914,949,-3.69
1953,Japan,1275,1.59,15,2408,2.83,10,3683,2.22,10,1133,754,50.27
1953,Australia,2017,2.51,9,1447,1.7,12,3464,2.09,11,-570,234,-343.59
1953,Sweden,1481,1.84,12,1580,1.85,11,3061,1.85,12,99,158,-37.34
1953,Brazil,1539,1.92,10,1319,1.55,14,2858,1.73,13,-220,566,-138.87
1953,South Africa,1380,1.72,14,1270,1.49,15,2650,1.6,14,-110,-120,-8.33
1953,"Venezuela, Bolivarian Republic of",1463,1.82,13,961,1.13,21,2424,1.46,15,-502,-488,2.87
1953,China,1020,1.27,19,1350,1.58,13,2370,1.43,16,330,300,10.0
1953,Switzerland,1181,1.47,16,1160,1.36,16,2341,1.41,17,-21,105,-120.0
1953,India,1101,1.37,18,1160,1.36,16,2261,1.37,18,59,384,-84.64
1953,German Democratic Republic,968,1.2,21,983,1.15,20,1951,1.18,19,15,34,-55.88
1953,Argentina,1125,1.4,17,795,0.93,26,1920,1.16,20,-330,491,-167.21
1953,Denmark,894,1.11,22,1000,1.17,18,1894,1.14,21,106,112,-5.36
1953,Czech and Slovak Federal Republic,994,1.24,20,879,1.03,23,1873,1.13,22,-115,2,-5850.0
1953,Singapore,867,1.08,23,987,1.16,19,1854,1.12,23,120,142,-15.49
1953,Indonesia,840,1.05,24,765,0.9,28,1605,0.97,24,-75,14,-635.71
1953,Poland,831,1.03,25,774,0.91,27,1605,0.97,24,-57,87,-165.52
1953,Netherlands Antilles,715,0.89,26,868,1.02,24,1583,0.96,26,153,221,-30.77
1953,Norway,508,0.63,35,912,1.07,22,1420,0.86,27,404,308,31.17
1953,Mexico,591,0.74,31,808,0.95,25,1399,0.84,28,217,142,52.82
1953,Malaysia,679,0.85,27,625,0.73,30,1304,0.79,29,-54,-172,-68.6
1953,Cuba,675,0.84,28,547,0.64,33,1222,0.74,30,-128,-4,3100.0
1953,New Zealand,660,0.82,29,538,0.63,36,1198,0.72,31,-122,99,-223.23
1953,"Hong Kong, China",478,0.59,39,678,0.8,29,1156,0.7,32,200,154,29.87
1953,Colombia,596,0.74,30,547,0.64,33,1143,0.69,33,-49,-58,-15.52
1953,Finland,572,0.71,32,530,0.62,38,1102,0.67,34,-42,75,-156.0
1953,Austria,540,0.67,34,544,0.64,35,1084,0.65,35,4,148,-97.3
1953,Spain,482,0.6,38,596,0.7,31,1078,0.65,36,114,114,0.0
1953,Hungary,498,0.62,37,488,0.57,43,986,0.6,37,-10,18,-155.56
1953,Algeria,397,0.49,45,579,0.68,32,976,0.59,38,182,224,-18.75
1953,Türkiye,396,0.49,46,533,0.63,37,929,0.56,39,137,193,-29.02
1953,Egypt,409,0.51,41,517,0.61,39,926,0.56,40,108,223,-51.57
1953,Philippines,399,0.5,43,502,0.59,41,901,0.54,41,103,122,-15.57
1953,Ireland,319,0.4,52,512,0.6,40,831,0.5,42,193,198,-2.53
1953,Pakistan,439,0.55,40,350,0.41,48,789,0.48,43,-89,97,-191.75
1953,"Saudi Arabia, Kingdom of",555,0.69,33,220,0.26,60,775,0.47,44,-335,-275,21.82
1953,Democratic Republic of the Congo,398,0.5,44,363,0.43,47,761,0.46,45,-35,13,-369.23
1953,Morocco,269,0.33,54,489,0.57,42,758,0.46,46,220,242,-9.09
1953,Chile,408,0.51,42,335,0.39,51,743,0.45,47,-73,-83,-12.05
1953,Romania,341,0.42,49,385,0.45,46,726,0.44,48,44,-64,-168.75
1953,Sri Lanka,329,0.41,50,338,0.4,50,667,0.4,49,9,42,-78.57
1953,Thailand,323,0.4,51,330,0.39,53,653,0.39,50,7,-25,-128.0
1953,Nigeria,348,0.43,48,303,0.36,54,651,0.39,51,-45,-46,-2.17
1953,"Kuwait, the State of",507,0.63,36,95,0.11,80,602,0.36,52,-412,-342,20.47
1953,Iraq,392,0.49,47,192,0.23,65,584,0.35,53,-200,-106,88.68
1953,"Yugoslavia, Socialist Federal Republic of",186,0.23,63,395,0.46,45,581,0.35,54,209,126,65.87
1953,Portugal,219,0.27,60,331,0.39,52,550,0.33,55,112,110,1.82
1953,Iran,237,0.3,57,281,0.33,56,518,0.31,56,44,156,-71.79
1953,Peru,222,0.28,59,293,0.34,55,515,0.31,57,71,49,44.9
1953,Uruguay,270,0.34,53,207,0.24,62,477,0.29,58,-63,52,-221.15
1953,Ghana,252,0.31,56,207,0.24,62,459,0.28,59,-45,-56,-19.64
1953,Viet Nam,53,0.07,96,396,0.46,44,449,0.27,60,343,394,-12.94
1953,Myanmar,237,0.3,57,178,0.21,67,415,0.25,61,-59,-91,-35.16
1953,Zambia,263,0.33,55,145,0.17,72,408,0.25,62,-118,-109,8.26
1953,Bulgaria,206,0.26,61,200,0.23,64,406,0.25,63,-6,158,-103.8
1953,Greece,129,0.16,67,272,0.32,58,401,0.24,64,143,226,-36.73
1953,"Korea, Republic of",40,0.05,102,345,0.4,49,385,0.23,65,305,186,63.98
1953,Senegal,133,0.17,65,221,0.26,59,354,0.21,66,88,141,-37.59
1953,"Bahrain, Kingdom of",193,0.24,62,156,0.18,70,349,0.21,67,-37,-54,-31.48
1953,Zimbabwe,132,0.16,66,217,0.25,61,349,0.21,67,85,122,-30.33
1953,Israel,58,0.07,90,281,0.33,56,339,0.2,69,223,277,-19.49
1953,Chinese Taipei,128,0.16,68,192,0.23,65,320,0.19,70,64,70,-8.57
1953,Trinidad and Tobago,150,0.19,64,138,0.16,75,288,0.17,71,-12,8,-250.0
1953,"Yemen, People's Democratic Republic",116,0.14,71,171,0.2,69,287,0.17,72,55,30,83.33
1953,Tunisia,112,0.14,73,172,0.2,68,284,0.17,73,60,70,-14.29
1953,Sudan,128,0.16,68,146,0.17,71,274,0.17,74,18,54,-66.67
1953,Syrian Arab Republic,116,0.14,71,131,0.15,76,247,0.15,75,15,40,-62.5
1953,Madagascar,85,0.11,83,129,0.15,77,214,0.13,76,44,40,10.0
1953,Kenya,64,0.08,89,145,0.17,72,209,0.13,77,81,83,-2.41
1953,Angola,123,0.15,70,85,0.1,82,208,0.13,78,-38,-5,660.0
1953,Dominican Republic,105,0.13,75,99,0.12,78,204,0.12,79,-6,-5,20.0
1953,Côte d'Ivoire,109,0.14,74,71,0.08,92,180,0.11,80,-38,-19,100.0
1953,Tanzania,98,0.12,76,80,0.09,83,178,0.11,81,-18,-27,-33.33
1953,Jamaica,71,0.09,86,99,0.12,78,170,0.1,82,28,52,-46.15
1953,Lebanese Republic,25,0.03,112,144,0.17,74,169,0.1,83,119,117,1.71
1953,Guatemala,89,0.11,82,80,0.09,83,169,0.1,83,-9,-11,-18.18
1953,Ecuador,93,0.12,79,75,0.09,88,168,0.1,85,-18,-32,-43.75
1953,Uganda,94,0.12,78,72,0.08,91,166,0.1,86,-22,-66,-66.67
1953,"Bolivia, Plurinational State of",97,0.12,77,68,0.08,94,165,0.1,87,-29,-29,0.0
1953,El Salvador,90,0.11,81,73,0.09,90,163,0.1,88,-17,-17,0.0
1953,Cameroon,75,0.09,85,80,0.09,83,155,0.09,89,5,44,-88.64
1953,Costa Rica,80,0.1,84,74,0.09,89,154,0.09,90,-6,-5,20.0
1953,Honduras,68,0.08,87,71,0.08,92,139,0.08,91,3,13,-76.92
1953,Mozambique,56,0.07,92,80,0.09,83,136,0.08,92,24,30,-20.0
1953,Brunei Darussalam,92,0.11,80,37,0.04,110,129,0.08,93,-55,-71,-22.54
1953,Ethiopia,68,0.08,87,56,0.07,98,124,0.07,94,-12,12,-200.0
1953,Iceland,44,0.05,100,68,0.08,94,112,0.07,95,24,17,41.18
1953,Afghanistan,47,0.06,98,65,0.08,96,112,0.07,95,18,15,20.0
1953,Mauritius,58,0.07,90,53,0.06,100,111,0.07,97,-5,-5,0.0
1953,Cyprus,43,0.05,101,59,0.07,97,102,0.06,98,16,6,166.67
1953,Nicaragua,55,0.07,94,44,0.05,104,99,0.06,99,-11,-11,0.0
1953,Cambodia,55,0.07,94,43,0.05,105,98,0.06,100,-12,-40,-70.0
1953,Panama,17,0.02,119,77,0.09,87,94,0.06,101,60,65,-7.69
1953,United Arab Emirates,2,0.0,156,90,0.11,81,92,0.06,102,88,87,1.15
1953,Guyana,48,0.06,97,42,0.05,106,90,0.05,103,-6,0,
1953,Equatorial Guinea,45,0.06,99,45,0.05,102,90,0.05,103,0,10,-100.0
1953,Haiti,38,0.05,103,45,0.05,102,83,0.05,105,7,-1,-800.0
1953,Qatar,56,0.07,92,15,0.02,132,71,0.04,106,-41,-33,24.24
1953,Reunion,32,0.04,106,37,0.04,110,69,0.04,107,5,9,-44.44
1953,Malta,8,0.01,132,56,0.07,98,64,0.04,108,48,48,0.0
1953,Sierra Leone,33,0.04,104,31,0.04,118,64,0.04,108,-2,1,-300.0
1953,Fiji,33,0.04,104,27,0.03,122,60,0.04,110,-6,2,-400.0
1953,Paraguay,26,0.03,111,34,0.04,114,60,0.04,110,8,2,300.0
1953,Guadeloupe,25,0.03,112,34,0.04,114,59,0.04,112,9,8,12.5
1953,Guinea,23,0.03,115,36,0.04,112,59,0.04,112,13,21,-38.1
1953,Papua New Guinea,27,0.03,109,31,0.04,118,58,0.04,114,4,4,0.0
1953,Jordan,6,0.01,136,52,0.06,101,58,0.04,114,46,45,2.22
1953,New Caledonia,28,0.03,108,29,0.03,120,57,0.03,116,1,7,-85.71
1953,Suriname,27,0.03,109,29,0.03,120,56,0.03,117,2,6,-66.67
1953,Martinique,20,0.02,117,35,0.04,113,55,0.03,118,15,18,-16.67
1953,Barbados,24,0.03,114,27,0.03,122,51,0.03,119,3,9,-66.67
1953,Albania,11,0.01,126,40,0.05,107,51,0.03,119,29,19,52.63
1953,Liberia,31,0.04,107,19,0.02,129,50,0.03,121,-12,-19,-36.84
1953,Congo,6,0.01,136,40,0.05,107,46,0.03,122,34,46,-26.09
1953,Mali,12,0.01,125,33,0.04,116,45,0.03,123,21,25,-16.0
1953,"Macao, China",3,0.0,151,40,0.05,107,43,0.03,124,37,37,0.0
1953,Libya,10,0.01,127,32,0.04,117,42,0.03,125,22,19,15.79
1953,Malawi,20,0.02,117,21,0.02,128,41,0.02,126,1,6,-83.33
1953,Djibouti,13,0.02,124,25,0.03,124,38,0.02,127,12,10,20.0
1953,Gabon,22,0.03,116,14,0.02,133,36,0.02,128,-8,4,-300.0
1953,Chad,14,0.02,122,18,0.02,130,32,0.02,129,4,3,33.33
1953,Benin,15,0.02,121,16,0.02,131,31,0.02,130,1,11,-90.91
1953,Bahamas,4,0.0,146,25,0.03,124,29,0.02,131,21,22,-4.55
1953,Togo,16,0.02,120,12,0.01,135,28,0.02,132,-4,1,-500.0
1953,Central African Republic,14,0.02,122,13,0.02,134,27,0.02,133,-1,4,-125.0
1953,Mauritania,2,0.0,156,24,0.03,126,26,0.02,134,22,24,-8.33
1953,Nepal,1,0.0,164,22,0.03,127,23,0.01,135,21,20,5.0
1953,Yemen,9,0.01,130,12,0.01,135,21,0.01,136,3,2,50.0
1953,Cabo Verde,10,0.01,127,9,0.01,139,19,0.01,137,-1,1,-200.0
1953,French Polynesia,8,0.01,132,11,0.01,137,19,0.01,137,3,5,-40.0
1953,Niger,10,0.01,127,8,0.01,142,18,0.01,139,-2,-2,0.0
1953,Greenland,6,0.01,136,9,0.01,139,15,0.01,140,3,-1,-400.0
1953,Eswatini,8,0.01,132,7,0.01,146,15,0.01,140,-1,-1,0.0
1953,The Gambia,8,0.01,132,6,0.01,149,14,0.01,142,-2,-1,100.0
1953,Sao Tomé and Principe,9,0.01,130,4,0.0,154,13,0.01,143,-5,-2,150.0
1953,Botswana,6,0.01,136,7,0.01,146,13,0.01,143,1,-1,-200.0
1953,Burkina Faso,5,0.01,142,8,0.01,142,13,0.01,143,3,5,-40.0
1953,Belize,5,0.01,142,8,0.01,142,13,0.01,143,3,5,-40.0
1953,Guinea-Bissau,6,0.01,136,6,0.01,149,12,0.01,147,0,1,-100.0
1953,Lao People's Democratic Republic,1,0.0,164,11,0.01,137,12,0.01,147,10,1,900.0
1953,Lesotho,2,0.0,156,9,0.01,139,11,0.01,149,7,6,16.67
1953,Saint Kitts and Nevis,6,0.01,136,5,0.01,152,11,0.01,149,-1,-1,0.0
1953,Oman,2,0.0,156,8,0.01,142,10,0.01,151,6,6,0.0
1953,Antigua and Barbuda,4,0.0,146,5,0.01,152,9,0.01,152,1,-1,-200.0
1953,Burundi,3,0.0,151,6,0.01,149,9,0.01,152,3,2,50.0
1953,Samoa,5,0.01,142,4,0.0,154,9,0.01,152,-1,0,
1953,Vanuatu,5,0.01,142,3,0.0,158,8,0.0,155,-2,1,-300.0
1953,Grenada,4,0.0,146,4,0.0,154,8,0.0,155,0,1,-100.0
1953,Solomon Islands,4,0.0,146,3,0.0,158,7,0.0,157,-1,0,
1953,Maldives,3,0.0,151,4,0.0,154,7,0.0,157,1,1,0.0
1953,French Guiana,0,0.0,170,7,0.01,146,7,0.0,157,7,8,-12.5
1953,Dominica,3,0.0,151,3,0.0,158,6,0.0,160,0,0,
1953,Comoros,2,0.0,156,3,0.0,158,5,0.0,161,1,0,
1953,Saint Vincent and the Grenadines,2,0.0,156,3,0.0,158,5,0.0,161,1,1,0.0
1953,Kiribati,3,0.0,151,2,0.0,165,5,0.0,161,-1,0,
1953,Guam,4,0.0,146,0,0.0,171,4,0.0,164,-4,-4,0.0
1953,Seychelles,2,0.0,156,2,0.0,165,4,0.0,164,0,0,
1953,Saint Lucia,2,0.0,156,2,0.0,165,4,0.0,164,0,2,-100.0
1953,Saint Pierre and Miquelon,1,0.0,164,3,0.0,158,4,0.0,164,2,2,0.0
1953,Tonga,0,0.0,170,3,0.0,158,3,0.0,168,3,2,50.0
1953,Montserrat,1,0.0,164,2,0.0,165,3,0.0,168,1,1,0.0
1953,American Samoa,1,0.0,164,1,0.0,169,2,0.0,170,0,0,
1953,Rwanda,1,0.0,164,1,0.0,169,2,0.0,170,0,0,
1952,United States of America,13203,16.64,1,11707,13.33,1,24910,14.9,1,-1496,-2045,-26.85
1952,United Kingdom,7585,9.56,2,9736,11.08,2,17321,10.36,2,2151,3346,-35.71
1952,Canada,4630,5.83,3,4373,4.98,4,9003,5.38,3,-257,194,-232.47
1952,France,4046,5.1,4,4549,5.18,3,8595,5.14,4,503,374,34.49
1952,Germany,4031,5.08,5,3862,4.4,5,7893,4.72,5,-169,35,-582.86
1952,U.S.S.R.,2790,3.52,6,2507,2.85,7,5297,3.17,6,-283,-300,-5.67
1952,Netherlands,2438,3.07,8,2605,2.97,6,5043,3.02,7,167,781,-78.62
1952,Belgium-Luxembourg,2454,3.09,7,2462,2.8,8,4916,2.94,8,8,-104,-107.69
1952,Italy,1387,1.75,12,2336,2.66,9,3723,2.23,9,949,520,82.5
1952,Australia,1729,2.18,9,1963,2.23,12,3692,2.21,10,234,334,-29.94
1952,Brazil,1416,1.78,11,1982,2.26,11,3398,2.03,11,566,216,162.04
1952,Sweden,1572,1.98,10,1730,1.97,13,3302,1.97,12,158,-6,-2733.33
1952,Japan,1269,1.6,15,2023,2.3,10,3292,1.97,13,754,637,18.37
1952,India,1243,1.57,16,1627,1.85,14,2870,1.72,14,384,37,937.84
1952,South Africa,1370,1.73,13,1250,1.42,15,2620,1.57,15,-120,18,-766.67
1952,Singapore,1083,1.36,18,1225,1.39,16,2308,1.38,16,142,66,115.15
1952,Switzerland,1086,1.37,17,1191,1.36,17,2277,1.36,17,105,280,-62.5
1952,"Venezuela, Bolivarian Republic of",1350,1.7,14,862,0.98,26,2212,1.32,18,-488,-422,15.64
1952,China,820,1.03,23,1120,1.27,19,1940,1.16,19,300,440,-31.82
1952,Indonesia,934,1.18,19,948,1.08,22,1882,1.13,20,14,-419,-103.34
1952,Argentina,688,0.87,29,1179,1.34,18,1867,1.12,21,491,311,57.88
1952,Denmark,850,1.07,22,962,1.1,20,1812,1.08,22,112,173,-35.26
1952,Czech and Slovak Federal Republic,874,1.1,20,876,1.0,23,1750,1.05,23,2,52,-96.15
1952,Netherlands Antilles,731,0.92,26,952,1.08,21,1683,1.01,24,221,204,8.33
1952,Poland,776,0.98,24,863,0.98,25,1639,0.98,25,87,163,-46.63
1952,Malaysia,861,1.09,21,689,0.78,32,1550,0.93,26,-172,-551,-68.78
1952,German Democratic Republic,739,0.93,25,773,0.88,29,1512,0.9,27,34,-105,-132.38
1952,Finland,717,0.9,27,792,0.9,28,1509,0.9,28,75,-191,-139.27
1952,Mexico,665,0.84,31,807,0.92,27,1472,0.88,29,142,178,-20.22
1952,New Zealand,674,0.85,30,773,0.88,29,1447,0.87,30,99,-117,-184.62
1952,Norway,565,0.71,32,873,0.99,24,1438,0.86,31,308,257,19.84
1952,Cuba,694,0.87,28,690,0.79,31,1384,0.83,32,-4,-108,-96.3
1952,"Hong Kong, China",507,0.64,35,661,0.75,33,1168,0.7,33,154,76,102.63
1952,Pakistan,533,0.67,34,630,0.72,37,1163,0.7,34,97,-214,-145.33
1952,Austria,506,0.64,36,654,0.74,34,1160,0.69,35,148,206,-28.16
1952,Egypt,431,0.54,42,654,0.74,34,1085,0.65,36,223,113,97.35
1952,Algeria,415,0.52,43,639,0.73,36,1054,0.63,37,224,199,12.56
1952,Spain,458,0.58,38,572,0.65,38,1030,0.62,38,114,-58,-296.55
1952,Türkiye,363,0.46,45,556,0.63,39,919,0.55,39,193,88,119.32
1952,Hungary,438,0.55,40,456,0.52,43,894,0.53,40,18,-5,-460.0
1952,Colombia,473,0.6,37,415,0.47,45,888,0.53,41,-58,-44,31.82
1952,Chile,453,0.57,39,370,0.42,48,823,0.49,42,-83,-41,102.44
1952,Philippines,346,0.44,47,468,0.53,42,814,0.49,43,122,110,10.91
1952,"Saudi Arabia, Kingdom of",540,0.68,33,265,0.3,57,805,0.48,44,-275,-325,-15.38
1952,Democratic Republic of the Congo,391,0.49,44,404,0.46,46,795,0.48,45,13,-78,-116.67
1952,Morocco,274,0.35,52,516,0.59,40,790,0.47,46,242,204,18.63
1952,Ireland,284,0.36,50,482,0.55,41,766,0.46,47,198,345,-42.61
1952,Nigeria,363,0.46,45,317,0.36,54,680,0.41,48,-46,-99,-53.54
1952,Sri Lanka,315,0.4,49,357,0.41,49,672,0.4,49,42,-73,-157.53
1952,Thailand,329,0.41,48,304,0.35,55,633,0.38,50,-25,-98,-74.49
1952,"Yugoslavia, Socialist Federal Republic of",247,0.31,54,373,0.42,47,620,0.37,51,126,206,-38.83
1952,Portugal,237,0.3,57,347,0.4,50,584,0.35,52,110,66,66.67
1952,"Kuwait, the State of",437,0.55,41,95,0.11,81,532,0.32,53,-342,-230,48.7
1952,Peru,239,0.3,56,288,0.33,56,527,0.32,54,49,27,81.48
1952,Viet Nam,56,0.07,86,450,0.51,44,506,0.3,55,394,232,69.83
1952,Iran,165,0.21,61,321,0.37,52,486,0.29,56,156,-281,-155.52
1952,Uruguay,209,0.26,59,261,0.3,58,470,0.28,57,52,138,-62.32
1952,Greece,120,0.15,69,346,0.39,51,466,0.28,58,226,296,-23.65
1952,Iraq,279,0.35,51,173,0.2,66,452,0.27,59,-106,-38,178.95
1952,Myanmar,263,0.33,53,172,0.2,67,435,0.26,60,-91,-55,65.45
1952,Ghana,242,0.3,55,186,0.21,63,428,0.26,61,-56,-79,-29.11
1952,Zimbabwe,124,0.16,66,246,0.28,60,370,0.22,62,122,138,-11.59
1952,Senegal,113,0.14,73,254,0.29,59,367,0.22,63,141,143,-1.4
1952,Israel,44,0.06,98,321,0.37,52,365,0.22,64,277,335,-17.31
1952,Zambia,229,0.29,58,120,0.14,76,349,0.21,65,-109,-87,25.29
1952,"Bahrain, Kingdom of",179,0.23,60,125,0.14,75,304,0.18,66,-54,-45,20.0
1952,Chinese Taipei,117,0.15,70,187,0.21,62,304,0.18,66,70,36,94.44
1952,Sudan,123,0.16,67,177,0.2,65,300,0.18,68,54,-59,-191.53
1952,Tunisia,115,0.14,71,185,0.21,64,300,0.18,68,70,74,-5.41
1952,"Yemen, People's Democratic Republic",128,0.16,65,158,0.18,69,286,0.17,70,30,17,76.47
1952,Trinidad and Tobago,134,0.17,62,142,0.16,71,276,0.17,71,8,3,166.67
1952,Kenya,83,0.1,82,166,0.19,68,249,0.15,72,83,75,10.67
1952,"Korea, Republic of",28,0.04,104,214,0.24,61,242,0.14,73,186,65,186.15
1952,Tanzania,132,0.17,64,105,0.12,79,237,0.14,74,-27,-32,-15.63
1952,Syrian Arab Republic,98,0.12,76,138,0.16,72,236,0.14,75,40,45,-11.11
1952,Madagascar,94,0.12,78,134,0.15,74,228,0.14,76,40,55,-27.27
1952,Dominican Republic,115,0.14,71,110,0.13,77,225,0.13,77,-5,-33,-84.85
1952,"Bolivia, Plurinational State of",122,0.15,68,93,0.11,82,215,0.13,78,-29,-44,-34.09
1952,Uganda,134,0.17,62,68,0.08,92,202,0.12,79,-66,-71,-7.04
1952,Côte d'Ivoire,108,0.14,74,89,0.1,85,197,0.12,80,-19,-12,58.33
1952,Angola,96,0.12,77,91,0.1,83,187,0.11,81,-5,-35,-85.71
1952,Ecuador,102,0.13,75,70,0.08,91,172,0.1,82,-32,-8,300.0
1952,Cameroon,63,0.08,84,107,0.12,78,170,0.1,83,44,29,51.72
1952,Guatemala,87,0.11,81,76,0.09,87,163,0.1,84,-11,5,-320.0
1952,El Salvador,88,0.11,80,71,0.08,90,159,0.1,85,-17,-21,-19.05
1952,Lebanese Republic,21,0.03,112,138,0.16,72,159,0.1,85,117,109,7.34
1952,Bulgaria,0,0.0,168,158,0.18,69,158,0.09,87,158,33,378.79
1952,Jamaica,50,0.06,92,102,0.12,80,152,0.09,88,52,38,36.84
1952,Costa Rica,73,0.09,83,68,0.08,92,141,0.08,89,-5,-7,-28.57
1952,Honduras,63,0.08,84,76,0.09,87,139,0.08,90,13,-4,-425.0
1952,Mozambique,46,0.06,95,76,0.09,87,122,0.07,91,30,27,11.11
1952,Ethiopia,53,0.07,87,65,0.07,94,118,0.07,92,12,-2,-700.0
1952,Brunei Darussalam,94,0.12,78,23,0.03,124,117,0.07,93,-71,-77,-7.79
1952,Cyprus,51,0.06,90,57,0.06,96,108,0.06,94,6,11,-45.45
1952,Afghanistan,45,0.06,96,60,0.07,95,105,0.06,95,15,-5,-400.0
1952,Haiti,52,0.07,89,51,0.06,99,103,0.06,96,-1,-6,-83.33
1952,Mauritius,53,0.07,87,48,0.05,103,101,0.06,97,-5,-7,-28.57
1952,Guyana,48,0.06,94,48,0.05,103,96,0.06,98,0,5,-100.0
1952,Iceland,39,0.05,100,56,0.06,98,95,0.06,99,17,11,54.55
1952,Panama,15,0.02,119,80,0.09,86,95,0.06,99,65,57,14.04
1952,United Arab Emirates,3,0.0,147,90,0.1,84,93,0.06,101,87,86,1.16
1952,Nicaragua,51,0.06,90,40,0.05,105,91,0.05,102,-11,-16,-31.25
1952,Equatorial Guinea,40,0.05,99,50,0.06,101,90,0.05,103,10,20,-50.0
1952,Reunion,30,0.04,103,39,0.04,107,69,0.04,104,9,7,28.57
1952,Malta,9,0.01,126,57,0.06,96,66,0.04,105,48,49,-2.04
1952,Paraguay,32,0.04,102,34,0.04,111,66,0.04,105,2,-3,-166.67
1952,Guadeloupe,28,0.04,104,36,0.04,110,64,0.04,107,8,3,166.67
1952,Cambodia,50,0.06,92,10,0.01,136,60,0.04,108,-40,-41,-2.44
1952,Fiji,28,0.04,104,30,0.03,116,58,0.03,109,2,6,-66.67
1952,Martinique,20,0.03,113,38,0.04,108,58,0.03,109,18,10,80.0
1952,Qatar,45,0.06,96,12,0.01,134,57,0.03,111,-33,-22,50.0
1952,Sierra Leone,28,0.04,104,29,0.03,118,57,0.03,111,1,-5,-120.0
1952,Congo,5,0.01,138,51,0.06,99,56,0.03,113,46,45,2.22
1952,Guinea,17,0.02,116,38,0.04,108,55,0.03,114,21,20,5.0
1952,Barbados,23,0.03,110,32,0.04,113,55,0.03,114,9,9,0.0
1952,Liberia,37,0.05,101,18,0.02,131,55,0.03,114,-19,-35,-45.71
1952,Suriname,24,0.03,109,30,0.03,116,54,0.03,117,6,3,100.0
1952,Papua New Guinea,25,0.03,108,29,0.03,118,54,0.03,117,4,7,-42.86
1952,Jordan,4,0.01,140,49,0.06,102,53,0.03,119,45,40,12.5
1952,New Caledonia,22,0.03,111,29,0.03,118,51,0.03,120,7,8,-12.5
1952,Libya,13,0.02,120,32,0.04,113,45,0.03,121,19,21,-9.52
1952,Albania,13,0.02,120,32,0.04,113,45,0.03,121,19,31,-38.71
1952,Chad,20,0.03,113,23,0.03,124,43,0.03,123,3,-1,-400.0
1952,Mali,9,0.01,126,34,0.04,111,43,0.03,123,25,27,-7.41
1952,"Macao, China",3,0.0,147,40,0.05,105,43,0.03,123,37,37,0.0
1952,Malawi,18,0.02,115,24,0.03,123,42,0.03,126,6,3,100.0
1952,Central African Republic,16,0.02,117,20,0.02,128,36,0.02,127,4,1,300.0
1952,Gabon,16,0.02,117,20,0.02,128,36,0.02,127,4,-3,-233.33
1952,Benin,11,0.01,123,22,0.03,126,33,0.02,129,11,4,175.0
1952,Djibouti,10,0.01,125,20,0.02,128,30,0.02,130,10,3,233.33
1952,Bahamas,3,0.0,147,25,0.03,121,28,0.02,131,22,18,22.22
1952,Mauritania,1,0.0,160,25,0.03,121,26,0.02,132,24,25,-4.0
1952,Togo,12,0.02,122,13,0.01,132,25,0.01,133,1,-2,-150.0
1952,Nepal,1,0.0,160,21,0.02,127,22,0.01,134,20,19,5.26
1952,The Gambia,11,0.01,123,10,0.01,136,21,0.01,135,-1,2,-150.0
1952,French Polynesia,8,0.01,130,13,0.01,132,21,0.01,135,5,1,400.0
1952,Yemen,9,0.01,126,11,0.01,135,20,0.01,137,2,1,100.0
1952,Cabo Verde,8,0.01,130,9,0.01,138,17,0.01,138,1,1,0.0
1952,Niger,9,0.01,126,7,0.01,145,16,0.01,139,-2,-2,0.0
1952,Guinea-Bissau,7,0.01,133,8,0.01,141,15,0.01,140,1,1,0.0
1952,Greenland,8,0.01,130,7,0.01,145,15,0.01,140,-1,-1,0.0
1952,Burkina Faso,4,0.01,140,9,0.01,138,13,0.01,142,5,3,66.67
1952,Belize,4,0.01,140,9,0.01,138,13,0.01,142,5,5,0.0
1952,Eswatini,7,0.01,133,6,0.01,147,13,0.01,142,-1,-1,0.0
1952,Sao Tomé and Principe,7,0.01,133,5,0.01,148,12,0.01,145,-2,-2,0.0
1952,Botswana,6,0.01,136,5,0.01,148,11,0.01,146,-1,-1,0.0
1952,Saint Kitts and Nevis,6,0.01,136,5,0.01,148,11,0.01,146,-1,0,
1952,Lesotho,2,0.0,154,8,0.01,141,10,0.01,148,6,5,20.0
1952,Oman,2,0.0,154,8,0.01,141,10,0.01,148,6,5,20.0
1952,Samoa,5,0.01,138,5,0.01,148,10,0.01,148,0,-2,-100.0
1952,Vanuatu,4,0.01,140,5,0.01,148,9,0.01,151,1,-4,-125.0
1952,Grenada,4,0.01,140,5,0.01,148,9,0.01,151,1,1,0.0
1952,Burundi,3,0.0,147,5,0.01,148,8,0.0,153,2,2,0.0
1952,French Guiana,0,0.0,168,8,0.01,141,8,0.0,153,8,6,33.33
1952,Antigua and Barbuda,4,0.01,140,3,0.0,156,7,0.0,155,-1,1,-200.0
1952,Maldives,3,0.0,147,4,0.0,155,7,0.0,155,1,2,-50.0
1952,Solomon Islands,3,0.0,147,3,0.0,156,6,0.0,157,0,0,
1952,Dominica,3,0.0,147,3,0.0,156,6,0.0,157,0,1,-100.0
1952,Saint Vincent and the Grenadines,2,0.0,154,3,0.0,156,5,0.0,159,1,1,0.0
1952,Comoros,2,0.0,154,2,0.0,162,4,0.0,160,0,0,
1952,Guam,4,0.01,140,0,0.0,170,4,0.0,160,-4,-5,-20.0
1952,Kiribati,2,0.0,154,2,0.0,162,4,0.0,160,0,-1,-100.0
1952,Seychelles,2,0.0,154,2,0.0,162,4,0.0,160,0,0,
1952,Saint Lucia,1,0.0,160,3,0.0,156,4,0.0,160,2,2,0.0
1952,Saint Pierre and Miquelon,1,0.0,160,3,0.0,156,4,0.0,160,2,1,100.0
1952,Montserrat,1,0.0,160,2,0.0,162,3,0.0,166,1,1,0.0
1952,Lao People's Democratic Republic,1,0.0,160,2,0.0,162,3,0.0,166,1,0,
1952,American Samoa,1,0.0,160,1,0.0,168,2,0.0,168,0,0,
1952,Tonga,0,0.0,168,2,0.0,162,2,0.0,168,2,2,0.0
1952,Rwanda,1,0.0,160,1,0.0,168,2,0.0,168,0,0,
1951,United States of America,13967,16.97,1,11922,13.51,1,25889,15.18,1,-2045,-362,464.92
1951,United Kingdom,7585,9.22,2,10931,12.39,2,18516,10.86,2,3346,980,241.43
1951,France,4241,5.15,3,4615,5.23,3,8856,5.19,3,374,-13,-2976.92
1951,Canada,3911,4.75,4,4105,4.65,4,8016,4.7,4,194,88,120.45
1951,Germany,3475,4.22,5,3510,3.98,5,6985,4.1,5,35,717,-95.12
1951,Netherlands,2238,2.72,8,3019,3.42,6,5257,3.08,6,781,830,-5.9
1951,Belgium-Luxembourg,2654,3.23,6,2550,2.89,7,5204,3.05,7,-104,298,-134.9
1951,Australia,2038,2.48,9,2372,2.69,8,4410,2.59,8,334,-96,-447.92
1951,U.S.S.R.,2291,2.78,7,1991,2.26,10,4282,2.51,9,-300,-338,-11.24
1951,Italy,1648,2.0,12,2168,2.46,9,3816,2.24,10,520,277,87.73
1951,Brazil,1771,2.15,11,1987,2.25,12,3758,2.2,11,216,-269,-180.3
1951,Sweden,1783,2.17,10,1777,2.01,13,3560,2.09,12,-6,80,-107.5
1951,Japan,1351,1.64,16,1988,2.25,11,3339,1.96,13,637,139,358.27
1951,India,1602,1.95,13,1639,1.86,15,3241,1.9,14,37,-54,-168.52
1951,Singapore,1576,1.92,14,1642,1.86,14,3218,1.89,15,66,65,1.54
1951,South Africa,1389,1.69,15,1407,1.59,17,2796,1.64,16,18,-230,-107.83
1951,Argentina,1169,1.42,20,1480,1.68,16,2649,1.55,17,311,-214,-245.33
1951,Switzerland,1073,1.3,21,1353,1.53,18,2426,1.42,18,280,143,95.8
1951,Indonesia,1292,1.57,18,873,0.99,25,2165,1.27,19,-419,-360,16.39
1951,Malaysia,1308,1.59,17,757,0.86,29,2065,1.21,20,-551,-466,18.24
1951,China,760,0.92,29,1200,1.36,19,1960,1.15,21,440,30,1366.67
1951,"Venezuela, Bolivarian Republic of",1187,1.44,19,765,0.87,28,1952,1.14,22,-422,-332,27.11
1951,Denmark,839,1.02,24,1012,1.15,20,1851,1.09,23,173,188,-7.98
1951,Czech and Slovak Federal Republic,845,1.03,23,897,1.02,23,1742,1.02,24,52,-140,-137.14
1951,Poland,762,0.93,28,925,1.05,21,1687,0.99,25,163,33,393.94
1951,"Hong Kong, China",776,0.94,26,852,0.97,26,1628,0.95,26,76,13,484.62
1951,Netherlands Antilles,702,0.85,31,906,1.03,22,1608,0.94,27,204,153,33.33
1951,Finland,867,1.05,22,676,0.77,32,1543,0.9,28,-191,-4,4675.0
1951,Cuba,806,0.98,25,698,0.79,30,1504,0.88,29,-108,-104,3.85
1951,Norway,620,0.75,34,877,0.99,24,1497,0.88,30,257,288,-10.76
1951,Mexico,644,0.78,33,822,0.93,27,1466,0.86,31,178,17,947.06
1951,German Democratic Republic,713,0.87,30,608,0.69,34,1321,0.77,32,-105,64,-264.06
1951,Pakistan,763,0.93,27,549,0.62,38,1312,0.77,33,-214,-86,148.84
1951,Egypt,583,0.71,36,696,0.79,31,1279,0.75,34,113,115,-1.74
1951,New Zealand,695,0.84,32,578,0.65,36,1273,0.75,35,-117,-72,62.5
1951,Austria,451,0.55,40,657,0.74,33,1108,0.65,36,206,151,36.42
1951,Philippines,428,0.52,41,538,0.61,39,966,0.57,37,110,45,144.44
1951,Algeria,383,0.47,45,582,0.66,35,965,0.57,38,199,101,97.03
1951,Spain,482,0.59,38,424,0.48,41,906,0.53,39,-58,0,
1951,Iran,589,0.72,35,308,0.35,53,897,0.53,40,-281,-399,-29.57
1951,Colombia,463,0.56,39,419,0.47,42,882,0.52,41,-44,-29,51.72
1951,Ireland,228,0.28,56,573,0.65,37,801,0.47,42,345,243,41.98
1951,Hungary,396,0.48,43,391,0.44,45,787,0.46,43,-5,-16,-68.75
1951,Sri Lanka,400,0.49,42,327,0.37,51,727,0.43,44,-73,-83,-12.05
1951,Türkiye,314,0.38,50,402,0.46,43,716,0.42,45,88,47,87.23
1951,Morocco,252,0.31,54,456,0.52,40,708,0.42,46,204,138,47.83
1951,Chile,370,0.45,46,329,0.37,49,699,0.41,47,-41,13,-415.38
1951,Democratic Republic of the Congo,387,0.47,44,309,0.35,52,696,0.41,48,-78,-73,6.85
1951,"Saudi Arabia, Kingdom of",500,0.61,37,175,0.2,62,675,0.4,49,-325,-225,44.44
1951,Thailand,370,0.45,46,272,0.31,56,642,0.38,50,-98,-95,3.16
1951,Uruguay,236,0.29,55,374,0.42,48,610,0.36,51,138,-42,-428.57
1951,Portugal,263,0.32,51,329,0.37,49,592,0.35,52,66,88,-25.0
1951,Nigeria,336,0.41,48,237,0.27,59,573,0.34,53,-99,-80,23.75
1951,"Yugoslavia, Socialist Federal Republic of",178,0.22,61,384,0.44,46,562,0.33,54,206,76,171.05
1951,Peru,253,0.31,53,280,0.32,55,533,0.31,55,27,-2,-1450.0
1951,Greece,102,0.12,72,398,0.45,44,500,0.29,56,296,338,-12.43
1951,Ghana,258,0.31,52,179,0.2,61,437,0.26,57,-79,-82,-3.66
1951,Israel,45,0.05,95,380,0.43,47,425,0.25,58,335,267,25.47
1951,"Kuwait, the State of",320,0.39,49,90,0.1,76,410,0.24,59,-230,-115,100.0
1951,Viet Nam,72,0.09,82,304,0.34,54,376,0.22,60,232,166,39.76
1951,Senegal,114,0.14,68,257,0.29,57,371,0.22,61,143,63,126.98
1951,Myanmar,198,0.24,57,143,0.16,64,341,0.2,62,-55,-48,14.58
1951,Zimbabwe,101,0.12,73,239,0.27,58,340,0.2,63,138,68,102.94
1951,Iraq,181,0.22,59,143,0.16,64,324,0.19,64,-38,-22,72.73
1951,Sudan,180,0.22,60,121,0.14,72,301,0.18,65,-59,-17,247.06
1951,Tunisia,108,0.13,71,182,0.21,60,290,0.17,66,74,33,124.24
1951,"Bahrain, Kingdom of",166,0.2,62,121,0.14,72,287,0.17,67,-45,-18,150.0
1951,Zambia,186,0.23,58,99,0.11,74,285,0.17,68,-87,-63,38.1
1951,"Yemen, People's Democratic Republic",124,0.15,66,141,0.16,66,265,0.16,69,17,6,183.33
1951,Trinidad and Tobago,125,0.15,65,128,0.15,71,253,0.15,70,3,-5,-160.0
1951,Chinese Taipei,98,0.12,75,134,0.15,67,232,0.14,71,36,37,-2.7
1951,Kenya,76,0.09,79,151,0.17,63,227,0.13,72,75,38,97.37
1951,Syrian Arab Republic,88,0.11,77,133,0.15,68,221,0.13,73,45,129,-65.12
1951,"Bolivia, Plurinational State of",130,0.16,64,86,0.1,79,216,0.13,74,-44,-11,300.0
1951,Madagascar,76,0.09,79,131,0.15,70,207,0.12,75,55,17,223.53
1951,Dominican Republic,119,0.14,67,86,0.1,79,205,0.12,76,-33,-37,-10.81
1951,Uganda,133,0.16,63,62,0.07,90,195,0.11,77,-71,-38,86.84
1951,Tanzania,111,0.13,69,79,0.09,83,190,0.11,78,-32,-1,3100.0
1951,Côte d'Ivoire,100,0.12,74,88,0.1,77,188,0.11,79,-12,-18,-33.33
1951,Angola,111,0.13,69,76,0.09,84,187,0.11,80,-35,-17,105.88
1951,Cameroon,65,0.08,85,94,0.11,75,159,0.09,81,29,13,123.08
1951,Lebanese Republic,24,0.03,105,133,0.15,68,157,0.09,82,109,69,57.97
1951,Guatemala,76,0.09,79,81,0.09,82,157,0.09,82,5,3,66.67
1951,El Salvador,86,0.1,78,65,0.07,88,151,0.09,84,-21,-21,0.0
1951,Ecuador,71,0.09,83,63,0.07,89,134,0.08,85,-8,-27,-70.37
1951,Jamaica,48,0.06,92,86,0.1,79,134,0.08,85,38,20,90.0
1951,Honduras,66,0.08,84,62,0.07,90,128,0.08,87,-4,-21,-80.95
1951,Ethiopia,61,0.07,87,59,0.07,92,120,0.07,88,-2,5,-140.0
1951,Costa Rica,63,0.08,86,56,0.06,93,119,0.07,89,-7,-10,-30.0
1951,Mozambique,44,0.05,97,71,0.08,87,115,0.07,90,27,21,28.57
1951,Afghanistan,60,0.07,88,55,0.06,95,115,0.07,90,-5,7,-171.43
1951,Brunei Darussalam,92,0.11,76,15,0.02,129,107,0.06,92,-77,-51,50.98
1951,Iceland,45,0.05,95,56,0.06,93,101,0.06,93,11,7,57.14
1951,Cyprus,43,0.05,98,54,0.06,97,97,0.06,94,11,7,57.14
1951,Haiti,51,0.06,90,45,0.05,100,96,0.06,95,-6,-3,100.0
1951,Mauritius,50,0.06,91,43,0.05,102,93,0.05,96,-7,5,-240.0
1951,United Arab Emirates,2,0.0,150,88,0.1,77,90,0.05,97,86,69,24.64
1951,"Korea, Republic of",11,0.01,123,76,0.09,84,87,0.05,98,65,31,109.68
1951,Panama,15,0.02,118,72,0.08,86,87,0.05,98,57,54,5.56
1951,Equatorial Guinea,30,0.04,102,50,0.06,99,80,0.05,100,20,17,17.65
1951,Nicaragua,46,0.06,94,30,0.03,112,76,0.04,101,-16,-10,60.0
1951,Guyana,34,0.04,100,39,0.04,105,73,0.04,102,5,3,66.67
1951,Liberia,52,0.06,89,17,0.02,127,69,0.04,103,-35,-17,105.88
1951,Paraguay,35,0.04,99,32,0.04,110,67,0.04,104,-3,-15,-80.0
1951,Malta,6,0.01,133,55,0.06,95,61,0.04,105,49,42,16.67
1951,Reunion,26,0.03,104,33,0.04,109,59,0.03,106,7,7,0.0
1951,Congo,6,0.01,133,51,0.06,98,57,0.03,107,45,44,2.27
1951,Cambodia,48,0.06,92,7,0.01,139,55,0.03,108,-41,-37,10.81
1951,Martinique,21,0.03,107,31,0.04,111,52,0.03,109,10,6,66.67
1951,Guinea,16,0.02,115,36,0.04,106,52,0.03,109,20,13,53.85
1951,Sierra Leone,28,0.03,103,23,0.03,119,51,0.03,111,-5,0,
1951,Barbados,21,0.03,107,30,0.03,112,51,0.03,111,9,7,28.57
1951,Papua New Guinea,21,0.03,107,28,0.03,114,49,0.03,113,7,8,-12.5
1951,Guadeloupe,23,0.03,106,26,0.03,115,49,0.03,113,3,4,-25.0
1951,Albania,9,0.01,125,40,0.05,103,49,0.03,113,31,16,93.75
1951,Jordan,4,0.0,142,44,0.05,101,48,0.03,116,40,26,53.85
1951,Libya,13,0.02,121,34,0.04,108,47,0.03,117,21,9,133.33
1951,Suriname,21,0.03,107,24,0.03,117,45,0.03,118,3,5,-40.0
1951,Mali,9,0.01,125,36,0.04,106,45,0.03,118,27,18,50.0
1951,"Macao, China",3,0.0,146,40,0.05,103,43,0.03,120,37,38,-2.63
1951,Fiji,18,0.02,113,24,0.03,117,42,0.02,121,6,-2,-400.0
1951,Qatar,32,0.04,101,10,0.01,134,42,0.02,121,-22,-15,46.67
1951,Gabon,21,0.03,107,18,0.02,125,39,0.02,123,-3,-4,-25.0
1951,Chad,19,0.02,112,18,0.02,125,37,0.02,124,-1,-7,-85.71
1951,Malawi,17,0.02,114,20,0.02,122,37,0.02,124,3,7,-57.14
1951,New Caledonia,14,0.02,120,22,0.02,120,36,0.02,126,8,4,100.0
1951,Benin,16,0.02,115,20,0.02,122,36,0.02,126,4,-1,-500.0
1951,Central African Republic,16,0.02,115,17,0.02,127,33,0.02,128,1,-1,-200.0
1951,Togo,15,0.02,118,13,0.01,131,28,0.02,129,-2,0,
1951,Mauritania,1,0.0,159,26,0.03,115,27,0.02,130,25,18,38.89
1951,Djibouti,12,0.01,122,15,0.02,129,27,0.02,130,3,7,-57.14
1951,Bahamas,3,0.0,146,21,0.02,121,24,0.01,132,18,14,28.57
1951,Nepal,1,0.0,159,20,0.02,122,21,0.01,133,19,18,5.56
1951,French Polynesia,10,0.01,124,11,0.01,132,21,0.01,133,1,0,
1951,The Gambia,9,0.01,125,11,0.01,132,20,0.01,135,2,2,0.0
1951,Yemen,9,0.01,125,10,0.01,134,19,0.01,136,1,2,-50.0
1951,Cabo Verde,8,0.01,129,9,0.01,136,17,0.01,137,1,1,0.0
1951,Burkina Faso,5,0.01,138,8,0.01,138,13,0.01,138,3,5,-40.0
1951,Belize,4,0.0,142,9,0.01,136,13,0.01,138,5,3,66.67
1951,Greenland,7,0.01,130,6,0.01,142,13,0.01,138,-1,0,
1951,Niger,7,0.01,130,5,0.01,145,12,0.01,141,-2,1,-300.0
1951,Sao Tomé and Principe,7,0.01,130,5,0.01,145,12,0.01,141,-2,-3,-33.33
1951,Botswana,6,0.01,133,5,0.01,145,11,0.01,143,-1,-2,-50.0
1951,Guinea-Bissau,5,0.01,138,6,0.01,142,11,0.01,143,1,0,
1951,Eswatini,6,0.01,133,5,0.01,145,11,0.01,143,-1,0,
1951,Lesotho,2,0.0,150,7,0.01,139,9,0.01,146,5,4,25.0
1951,Oman,2,0.0,150,7,0.01,139,9,0.01,146,5,4,25.0
1951,Grenada,4,0.0,142,5,0.01,145,9,0.01,146,1,0,
1951,Vanuatu,6,0.01,133,2,0.0,159,8,0.0,149,-4,-3,33.33
1951,Burundi,3,0.0,146,5,0.01,145,8,0.0,149,2,2,0.0
1951,Saint Kitts and Nevis,4,0.0,142,4,0.0,151,8,0.0,149,0,1,-100.0
1951,Samoa,5,0.01,138,3,0.0,153,8,0.0,149,-2,-1,100.0
1951,Solomon Islands,3,0.0,146,3,0.0,153,6,0.0,153,0,0,
1951,Maldives,2,0.0,150,4,0.0,151,6,0.0,153,2,2,0.0
1951,French Guiana,0,0.0,168,6,0.01,142,6,0.0,153,6,4,50.0
1951,Antigua and Barbuda,2,0.0,150,3,0.0,153,5,0.0,156,1,1,0.0
1951,Guam,5,0.01,138,0,0.0,169,5,0.0,156,-5,-1,400.0
1951,Saint Vincent and the Grenadines,2,0.0,150,3,0.0,153,5,0.0,156,1,1,0.0
1951,Dominica,2,0.0,150,3,0.0,153,5,0.0,156,1,1,0.0
1951,Seychelles,2,0.0,150,2,0.0,159,4,0.0,160,0,-1,-100.0
1951,Saint Lucia,1,0.0,159,3,0.0,153,4,0.0,160,2,1,100.0
1951,Kiribati,2,0.0,150,1,0.0,164,3,0.0,162,-1,-1,0.0
1951,Montserrat,1,0.0,159,2,0.0,159,3,0.0,162,1,0,
1951,Saint Pierre and Miquelon,1,0.0,159,2,0.0,159,3,0.0,162,1,1,0.0
1951,Comoros,1,0.0,159,1,0.0,164,2,0.0,165,0,-1,-100.0
1951,American Samoa,1,0.0,159,1,0.0,164,2,0.0,165,0,0,
1951,Tonga,0,0.0,168,2,0.0,159,2,0.0,165,2,2,0.0
1951,Rwanda,1,0.0,159,1,0.0,164,2,0.0,165,0,0,
1951,Lao People's Democratic Republic,1,0.0,159,1,0.0,164,2,0.0,165,0,0,
1950,United States of America,9993,16.26,1,9631,15.1,1,19624,15.67,1,-362,-4507,-91.97
1950,United Kingdom,6325,10.29,2,7305,11.45,2,13630,10.88,2,980,1605,-38.94
1950,France,3082,5.01,3,3069,4.81,4,6151,4.91,3,-13,9,-244.44
1950,Canada,3020,4.91,4,3108,4.87,3,6128,4.89,4,88,-171,-151.46
1950,Germany,1993,3.24,5,2710,4.25,5,4703,3.75,5,717,1104,-35.05
1950,Netherlands,1604,2.61,9,2434,3.82,6,4038,3.22,6,830,589,40.92
1950,Belgium-Luxembourg,1652,2.69,8,1950,3.06,7,3602,2.88,7,298,31,861.29
1950,U.S.S.R.,1794,2.92,6,1456,2.28,10,3250,2.59,8,-338,41,-924.39
1950,Australia,1668,2.71,7,1572,2.46,8,3240,2.59,9,-96,-100,-4.0
1950,Italy,1206,1.96,11,1483,2.32,9,2689,2.15,10,277,424,-34.67
1950,Brazil,1359,2.21,10,1090,1.71,13,2449,1.96,11,-269,56,-580.36
1950,Sweden,1103,1.79,15,1183,1.85,11,2286,1.83,12,80,24,233.33
1950,India,1145,1.86,14,1091,1.71,12,2236,1.79,13,-54,643,-108.4
1950,Argentina,1178,1.92,12,964,1.51,16,2142,1.71,14,-214,136,-257.35
1950,Singapore,1005,1.64,16,1070,1.68,14,2075,1.66,15,65,176,-63.07
1950,South Africa,1151,1.87,13,921,1.44,18,2072,1.65,16,-230,112,-305.36
1950,Switzerland,894,1.45,19,1037,1.63,15,1931,1.54,17,143,76,88.16
1950,Japan,825,1.34,20,964,1.51,16,1789,1.43,18,139,395,-64.81
1950,Malaysia,1004,1.63,17,538,0.84,30,1542,1.23,19,-466,-141,230.5
1950,"Venezuela, Bolivarian Republic of",929,1.51,18,597,0.94,26,1526,1.22,20,-332,-62,435.48
1950,Denmark,665,1.08,25,853,1.34,19,1518,1.21,21,188,126,49.21
1950,Czech and Slovak Federal Republic,779,1.27,22,639,1.0,24,1418,1.13,22,-140,-88,59.09
1950,"Hong Kong, China",650,1.06,26,663,1.04,22,1313,1.05,23,13,98,-86.73
1950,Poland,630,1.03,27,663,1.04,22,1293,1.03,24,33,-60,-155.0
1950,Netherlands Antilles,553,0.9,28,706,1.11,20,1259,1.01,25,153,177,-13.56
1950,Indonesia,800,1.3,21,440,0.69,35,1240,0.99,26,-360,52,-792.31
1950,Cuba,667,1.09,24,563,0.88,28,1230,0.98,27,-104,-127,-18.11
1950,China,550,0.89,29,580,0.91,27,1130,0.9,28,30,-133,-122.56
1950,Egypt,504,0.82,32,619,0.97,25,1123,0.9,29,115,153,-24.84
1950,Mexico,532,0.87,30,549,0.86,29,1081,0.86,30,17,12,41.67
1950,Norway,390,0.63,36,678,1.06,21,1068,0.85,31,288,378,-23.81
1950,Iran,701,1.14,23,302,0.47,46,1003,0.8,32,-399,-259,54.05
1950,New Zealand,514,0.84,31,442,0.69,34,956,0.76,33,-72,-99,-27.27
1950,Pakistan,489,0.8,33,403,0.63,38,892,0.71,34,-86,68,-226.47
1950,German Democratic Republic,406,0.66,34,470,0.74,32,876,0.7,35,64,1,6300.0
1950,Austria,326,0.53,44,477,0.75,31,803,0.64,36,151,306,-50.65
1950,Spain,389,0.63,38,389,0.61,39,778,0.62,37,0,63,-100.0
1950,Finland,390,0.63,36,386,0.61,40,776,0.62,38,-4,-69,-94.2
1950,Algeria,333,0.54,40,434,0.68,36,767,0.61,39,101,122,-17.21
1950,Colombia,394,0.64,35,365,0.57,42,759,0.61,40,-29,-70,-58.57
1950,Philippines,331,0.54,41,376,0.59,41,707,0.56,41,45,397,-88.66
1950,Ireland,203,0.33,52,446,0.7,33,649,0.52,42,243,259,-6.18
1950,Hungary,329,0.54,42,313,0.49,44,642,0.51,43,-16,-101,-84.16
1950,Türkiye,264,0.43,47,311,0.49,45,575,0.46,44,47,98,-52.04
1950,Chile,281,0.46,46,294,0.46,48,575,0.46,44,13,11,18.18
1950,Sri Lanka,328,0.53,43,245,0.38,50,573,0.46,46,-83,-10,730.0
1950,Morocco,190,0.31,55,328,0.51,43,518,0.41,47,138,172,-19.77
1950,Greece,90,0.15,68,428,0.67,37,518,0.41,47,338,293,15.36
1950,Thailand,304,0.49,45,209,0.33,56,513,0.41,49,-95,-81,17.28
1950,Uruguay,254,0.41,49,212,0.33,53,466,0.37,50,-42,-11,281.82
1950,Portugal,186,0.3,56,274,0.43,49,460,0.37,51,88,190,-53.68
1950,"Saudi Arabia, Kingdom of",340,0.55,39,115,0.18,65,455,0.36,52,-225,-208,8.17
1950,Democratic Republic of the Congo,261,0.42,48,188,0.29,58,449,0.36,53,-73,-7,942.86
1950,Nigeria,253,0.41,50,173,0.27,59,426,0.34,54,-80,-85,-5.88
1950,Senegal,174,0.28,57,237,0.37,51,411,0.33,55,63,49,28.57
1950,Peru,194,0.32,54,192,0.3,57,386,0.31,56,-2,12,-116.67
1950,"Yugoslavia, Socialist Federal Republic of",154,0.25,58,230,0.36,52,384,0.31,57,76,94,-19.15
1950,Ghana,217,0.35,51,135,0.21,62,352,0.28,58,-82,-17,382.35
1950,Israel,35,0.06,93,302,0.47,46,337,0.27,59,267,300,-11.0
1950,Syrian Arab Republic,82,0.13,70,211,0.33,54,293,0.23,60,129,182,-29.12
1950,"Kuwait, the State of",195,0.32,53,80,0.13,73,275,0.22,61,-115,,
1950,Tunisia,114,0.19,63,147,0.23,61,261,0.21,62,33,42,-21.43
1950,Zimbabwe,96,0.16,66,164,0.26,60,260,0.21,63,68,91,-25.27
1950,"Bahrain, Kingdom of",137,0.22,61,119,0.19,63,256,0.2,64,-18,-15,20.0
1950,Viet Nam,44,0.07,88,210,0.33,55,254,0.2,65,166,163,1.84
1950,Iraq,127,0.21,62,105,0.16,67,232,0.19,66,-22,52,-142.31
1950,Myanmar,139,0.23,59,91,0.14,70,230,0.18,67,-48,-76,-36.84
1950,"Yemen, People's Democratic Republic",111,0.18,64,117,0.18,64,228,0.18,68,6,10,-40.0
1950,Zambia,138,0.22,60,75,0.12,75,213,0.17,69,-63,-48,31.25
1950,Trinidad and Tobago,103,0.17,65,98,0.15,68,201,0.16,70,-5,12,-141.67
1950,Chinese Taipei,73,0.12,76,110,0.17,66,183,0.15,71,37,42,-11.9
1950,Sudan,95,0.15,67,78,0.12,74,173,0.14,72,-17,-14,21.43
1950,Madagascar,69,0.11,78,86,0.13,71,155,0.12,73,17,33,-48.48
1950,Kenya,57,0.09,82,95,0.15,69,152,0.12,74,38,142,-73.24
1950,Côte d'Ivoire,79,0.13,72,61,0.1,82,140,0.11,75,-18,-42,-57.14
1950,"Bolivia, Plurinational State of",75,0.12,74,64,0.1,80,139,0.11,76,-11,-11,0.0
1950,Guatemala,68,0.11,80,71,0.11,77,139,0.11,76,3,16,-81.25
1950,Dominican Republic,87,0.14,69,50,0.08,88,137,0.11,78,-37,-22,68.18
1950,Tanzania,68,0.11,80,67,0.11,78,135,0.11,79,-1,27,-103.7
1950,Angola,75,0.12,74,58,0.09,85,133,0.11,80,-17,-19,-10.53
1950,Ecuador,77,0.13,73,50,0.08,88,127,0.1,81,-27,13,-307.69
1950,Uganda,81,0.13,71,43,0.07,95,124,0.1,82,-38,-42,-9.52
1950,El Salvador,70,0.11,77,49,0.08,92,119,0.1,83,-21,-14,50.0
1950,Afghanistan,53,0.09,85,60,0.09,83,113,0.09,84,7,5,40.0
1950,Cameroon,47,0.08,86,60,0.09,83,107,0.09,85,13,15,-13.33
1950,Jamaica,43,0.07,89,63,0.1,81,106,0.08,86,20,27,-25.93
1950,Costa Rica,56,0.09,83,46,0.07,94,102,0.08,87,-10,-8,25.0
1950,Lebanese Republic,15,0.02,113,84,0.13,72,99,0.08,88,69,,
1950,Mozambique,37,0.06,91,58,0.09,85,95,0.08,89,21,31,-32.26
1950,Honduras,55,0.09,84,34,0.05,101,89,0.07,90,-21,-5,320.0
1950,Brunei Darussalam,69,0.11,78,18,0.03,121,87,0.07,91,-51,-10,410.0
1950,Equatorial Guinea,33,0.05,96,50,0.08,88,83,0.07,92,17,20,-15.0
1950,Panama,13,0.02,117,67,0.11,78,80,0.06,93,54,50,8.0
1950,Ethiopia,37,0.06,91,42,0.07,96,79,0.06,94,5,10,-50.0
1950,"Korea, Republic of",23,0.04,102,54,0.08,87,77,0.06,95,31,125,-75.2
1950,Haiti,39,0.06,90,36,0.06,100,75,0.06,96,-3,-4,-25.0
1950,United Arab Emirates,3,0.0,140,72,0.11,76,75,0.06,96,69,,
1950,Cyprus,31,0.05,98,38,0.06,98,69,0.06,98,7,10,-30.0
1950,Mauritius,32,0.05,97,37,0.06,99,69,0.06,98,5,-4,-225.0
1950,Guyana,30,0.05,99,33,0.05,102,63,0.05,100,3,2,50.0
1950,Nicaragua,35,0.06,93,25,0.04,107,60,0.05,101,-10,-3,233.33
1950,Iceland,26,0.04,101,33,0.05,102,59,0.05,102,7,15,-53.33
1950,Cambodia,47,0.08,86,10,0.02,131,57,0.05,103,-37,,
1950,Congo,6,0.01,128,50,0.08,88,56,0.04,104,44,41,7.32
1950,Paraguay,35,0.06,93,20,0.03,116,55,0.04,105,-15,-1,1400.0
1950,Malta,5,0.01,132,47,0.07,93,52,0.04,106,42,53,-20.75
1950,Reunion,19,0.03,106,26,0.04,105,45,0.04,107,7,-2,-450.0
1950,"Macao, China",3,0.0,140,41,0.06,97,44,0.04,108,38,39,-2.56
1950,Barbados,16,0.03,110,23,0.04,109,39,0.03,109,7,9,-22.22
1950,Liberia,28,0.05,100,11,0.02,130,39,0.03,109,-17,-16,6.25
1950,Fiji,20,0.03,104,18,0.03,121,38,0.03,111,-2,1,-300.0
1950,Papua New Guinea,15,0.02,113,23,0.04,109,38,0.03,111,8,11,-27.27
1950,Guadeloupe,17,0.03,109,21,0.03,112,38,0.03,111,4,0,
1950,Sierra Leone,19,0.03,106,19,0.03,118,38,0.03,111,0,-4,-100.0
1950,Suriname,16,0.03,110,21,0.03,112,37,0.03,115,5,2,150.0
1950,Martinique,15,0.02,113,21,0.03,112,36,0.03,116,6,10,-40.0
1950,Gabon,20,0.03,104,16,0.03,124,36,0.03,116,-4,,
1950,Malawi,14,0.02,116,21,0.03,112,35,0.03,118,7,3,133.33
1950,Guinea,11,0.02,119,24,0.04,108,35,0.03,118,13,-10,-230.0
1950,Jordan,4,0.01,135,30,0.05,104,34,0.03,120,26,34,-23.53
1950,Mali,8,0.01,123,26,0.04,105,34,0.03,120,18,,
1950,Central African Republic,16,0.03,110,15,0.02,125,31,0.02,122,-1,,
1950,Libya,11,0.02,119,20,0.03,116,31,0.02,122,9,15,-40.0
1950,Chad,19,0.03,106,12,0.02,128,31,0.02,122,-7,,
1950,Qatar,22,0.04,103,7,0.01,138,29,0.02,125,-15,-4,275.0
1950,Albania,6,0.01,128,22,0.03,111,28,0.02,126,16,,
1950,New Caledonia,11,0.02,119,15,0.02,125,26,0.02,127,4,6,-33.33
1950,Benin,13,0.02,117,12,0.02,128,25,0.02,128,-1,3,-133.33
1950,Nepal,1,0.0,157,19,0.03,118,20,0.02,129,18,,
1950,Bahamas,3,0.0,140,17,0.03,123,20,0.02,129,14,16,-12.5
1950,Mauritania,1,0.0,157,19,0.03,118,20,0.02,129,18,,
1950,Djibouti,6,0.01,128,13,0.02,127,19,0.02,132,7,2,250.0
1950,Togo,9,0.01,122,9,0.01,133,18,0.01,133,0,5,-100.0
1950,Yemen,8,0.01,123,10,0.02,131,18,0.01,133,2,2,0.0
1950,Cabo Verde,8,0.01,123,9,0.01,133,17,0.01,135,1,3,-66.67
1950,French Polynesia,8,0.01,123,8,0.01,135,16,0.01,136,0,2,-100.0
1950,The Gambia,6,0.01,128,8,0.01,135,14,0.01,137,2,-1,-300.0
1950,Sao Tomé and Principe,7,0.01,127,4,0.01,145,11,0.01,138,-3,0,
1950,Burkina Faso,3,0.0,140,8,0.01,135,11,0.01,138,5,,
1950,Greenland,5,0.01,132,5,0.01,142,10,0.01,140,0,3,-100.0
1950,Eswatini,5,0.01,132,5,0.01,142,10,0.01,140,0,,
1950,Belize,3,0.0,140,6,0.01,139,9,0.01,142,3,3,0.0
1950,Lesotho,2,0.0,150,6,0.01,139,8,0.01,143,4,,
1950,Oman,2,0.0,150,6,0.01,139,8,0.01,143,4,5,-20.0
1950,Burundi,3,0.0,140,5,0.01,142,8,0.01,143,2,,
1950,Guinea-Bissau,4,0.01,135,4,0.01,145,8,0.01,143,0,1,-100.0
1950,Grenada,4,0.01,135,4,0.01,145,8,0.01,143,0,-4,-100.0
1950,Niger,3,0.0,140,4,0.01,145,7,0.01,148,1,0,
1950,Antigua and Barbuda,3,0.0,140,4,0.01,145,7,0.01,148,1,1,0.0
1950,Saint Kitts and Nevis,3,0.0,140,4,0.01,145,7,0.01,148,1,,
1950,Samoa,4,0.01,135,3,0.0,153,7,0.01,148,-1,-2,-50.0
1950,Maldives,2,0.0,150,4,0.01,145,6,0.0,152,2,2,0.0
1950,Vanuatu,4,0.01,135,1,0.0,160,5,0.0,153,-3,-2,50.0
1950,Botswana,3,0.0,140,1,0.0,160,4,0.0,154,-2,,
1950,Solomon Islands,2,0.0,150,2,0.0,154,4,0.0,154,0,-1,-100.0
1950,French Guiana,0,0.0,168,4,0.01,145,4,0.0,154,4,4,0.0
1950,Comoros,2,0.0,150,1,0.0,160,3,0.0,157,-1,,
1950,Saint Vincent and the Grenadines,1,0.0,157,2,0.0,154,3,0.0,157,1,1,0.0
1950,Kiribati,2,0.0,150,1,0.0,160,3,0.0,157,-1,1,-200.0
1950,Seychelles,2,0.0,150,1,0.0,160,3,0.0,157,-1,-1,0.0
1950,Dominica,1,0.0,157,2,0.0,154,3,0.0,157,1,,
1950,Saint Lucia,1,0.0,157,2,0.0,154,3,0.0,157,1,2,-50.0
1950,Saint Pierre and Miquelon,1,0.0,157,2,0.0,154,3,0.0,157,1,0,
1950,American Samoa,1,0.0,157,1,0.0,160,2,0.0,164,0,0,
1950,Tonga,0,0.0,168,2,0.0,154,2,0.0,164,2,2,0.0
1950,Rwanda,1,0.0,157,1,0.0,160,2,0.0,164,0,,
1950,Montserrat,1,0.0,157,1,0.0,160,2,0.0,164,0,,
1950,Lao People's Democratic Republic,1,0.0,157,1,0.0,160,2,0.0,164,0,,
1950,Guam,1,0.0,157,0,0.0,169,1,0.0,169,-1,-2,-50.0
1949,United States of America,12051,20.57,1,7544,12.13,2,19595,16.23,1,-4507,-4572,-1.42
1949,United Kingdom,6875,11.74,2,8480,13.64,1,15355,12.71,2,1605,1765,-9.07
1949,Canada,3050,5.21,3,2879,4.63,3,5929,4.91,3,-171,-462,-62.99
1949,France,2781,4.75,4,2790,4.49,4,5571,4.61,4,9,1431,-99.37
1949,Netherlands,1484,2.53,7,2073,3.33,6,3557,2.95,5,589,963,-38.84
1949,Belgium-Luxembourg,1759,3.0,5,1790,2.88,8,3549,2.94,6,31,295,-89.49
1949,Australia,1592,2.72,6,1492,2.4,10,3084,2.55,7,-100,-308,-67.53
1949,Germany,985,1.68,15,2089,3.36,5,3074,2.55,8,1104,609,81.28
1949,India,1197,2.04,9,1840,2.96,7,3037,2.51,9,643,132,387.12
1949,U.S.S.R.,1433,2.45,8,1474,2.37,11,2907,2.41,10,41,-83,-149.4
1949,Italy,1121,1.91,12,1545,2.48,9,2666,2.21,11,424,462,-8.23
1949,South Africa,1156,1.97,10,1268,2.04,12,2424,2.01,12,112,382,-70.68
1949,Sweden,1151,1.96,11,1175,1.89,14,2326,1.93,13,24,271,-91.14
1949,Brazil,1100,1.88,13,1156,1.86,15,2256,1.87,14,56,-56,-200.0
1949,Argentina,1044,1.78,14,1180,1.9,13,2224,1.84,15,136,-67,-302.99
1949,"Venezuela, Bolivarian Republic of",863,1.47,16,801,1.29,19,1664,1.38,16,-62,-59,5.08
1949,Switzerland,791,1.35,18,867,1.39,17,1658,1.37,17,76,357,-78.71
1949,Czech and Slovak Federal Republic,806,1.38,17,718,1.15,22,1524,1.26,18,-88,-72,22.22
1949,Denmark,685,1.17,20,811,1.3,18,1496,1.24,19,126,144,-12.5
1949,Japan,510,0.87,29,905,1.46,16,1415,1.17,20,395,426,-7.28
1949,Singapore,612,1.04,21,788,1.27,20,1400,1.16,21,176,156,12.82
1949,Poland,692,1.18,19,632,1.02,25,1324,1.1,22,-60,-75,-20.0
1949,Egypt,527,0.9,26,680,1.09,23,1207,1.0,23,153,124,23.39
1949,Norway,388,0.66,35,766,1.23,21,1154,0.96,24,378,335,12.84
1949,"Hong Kong, China",526,0.9,28,624,1.0,26,1150,0.95,25,98,124,-20.97
1949,Indonesia,527,0.9,26,579,0.93,29,1106,0.92,26,52,70,-25.71
1949,Malaysia,594,1.01,22,453,0.73,34,1047,0.87,27,-141,-164,-14.02
1949,Netherlands Antilles,432,0.74,32,609,0.98,27,1041,0.86,28,177,136,30.15
1949,Cuba,578,0.99,24,451,0.73,35,1029,0.85,29,-127,-183,-30.6
1949,New Zealand,535,0.91,25,436,0.7,37,971,0.8,30,-99,-67,47.76
1949,Pakistan,447,0.76,31,515,0.83,30,962,0.8,31,68,-182,-137.36
1949,Iran,588,1.0,23,329,0.53,44,917,0.76,32,-259,-383,-32.38
1949,Philippines,248,0.42,46,645,1.04,24,893,0.74,33,397,334,18.86
1949,Austria,286,0.49,44,592,0.95,28,878,0.73,34,306,292,4.79
1949,Finland,469,0.8,30,400,0.64,39,869,0.72,35,-69,-13,430.77
1949,Spain,403,0.69,34,466,0.75,32,869,0.72,35,63,109,-42.2
1949,Mexico,428,0.73,33,440,0.71,36,868,0.72,37,12,88,-86.36
1949,Algeria,335,0.57,38,457,0.73,33,792,0.66,38,122,64,90.63
1949,Ireland,226,0.39,49,485,0.78,31,711,0.59,39,259,350,-26.0
1949,Hungary,387,0.66,36,286,0.46,49,673,0.56,40,-101,-85,18.82
1949,German Democratic Republic,330,0.56,40,331,0.53,43,661,0.55,41,1,-148,-100.68
1949,Colombia,335,0.57,38,265,0.43,50,600,0.5,42,-70,30,-333.33
1949,Chile,294,0.5,43,305,0.49,46,599,0.5,43,11,-57,-119.3
1949,Türkiye,248,0.42,46,346,0.56,42,594,0.49,44,98,151,-35.1
1949,Sri Lanka,298,0.51,42,288,0.46,48,586,0.49,45,-10,-6,66.67
1949,Morocco,193,0.33,52,365,0.59,40,558,0.46,46,172,137,25.55
1949,Greece,115,0.2,59,408,0.66,38,523,0.43,47,293,269,8.92
1949,Nigeria,302,0.52,41,217,0.35,54,519,0.43,48,-85,-83,2.41
1949,Portugal,157,0.27,55,347,0.56,41,504,0.42,49,190,243,-21.81
1949,"Yugoslavia, Socialist Federal Republic of",204,0.35,50,298,0.48,47,502,0.42,50,94,12,683.33
1949,"Saudi Arabia, Kingdom of",338,0.58,37,130,0.21,64,468,0.39,51,-208,-203,2.46
1949,Thailand,274,0.47,45,193,0.31,58,467,0.39,52,-81,-79,2.53
1949,Democratic Republic of the Congo,235,0.4,48,228,0.37,53,463,0.38,53,-7,-53,-86.79
1949,Senegal,198,0.34,51,247,0.4,51,445,0.37,54,49,22,122.73
1949,Uruguay,192,0.33,53,181,0.29,59,373,0.31,55,-11,22,-150.0
1949,Israel,29,0.05,94,329,0.53,44,358,0.3,56,300,102,194.12
1949,Ghana,186,0.32,54,169,0.27,60,355,0.29,57,-17,-99,-82.83
1949,Peru,155,0.26,56,167,0.27,61,322,0.27,58,12,6,100.0
1949,Zimbabwe,109,0.19,61,200,0.32,56,309,0.26,59,91,72,26.39
1949,Viet Nam,68,0.12,71,231,0.37,52,299,0.25,60,163,96,69.79
1949,"Bahrain, Kingdom of",135,0.23,58,120,0.19,67,255,0.21,61,-15,-13,15.38
1949,Syrian Arab Republic,35,0.06,88,217,0.35,54,252,0.21,62,182,177,2.82
1949,Iraq,99,0.17,64,151,0.24,62,250,0.21,63,52,135,-61.48
1949,Kenya,52,0.09,76,194,0.31,57,246,0.2,64,142,45,215.56
1949,"Yemen, People's Democratic Republic",112,0.19,60,122,0.2,65,234,0.19,65,10,59,-83.05
1949,Myanmar,154,0.26,57,78,0.13,73,232,0.19,66,-76,-52,46.15
1949,Trinidad and Tobago,107,0.18,62,119,0.19,68,226,0.19,67,12,-1,-1300.0
1949,Tunisia,79,0.13,68,121,0.19,66,200,0.17,68,42,131,-67.94
1949,Sudan,105,0.18,63,91,0.15,70,196,0.16,69,-14,-7,100.0
1949,"Bolivia, Plurinational State of",89,0.15,66,78,0.13,73,167,0.14,70,-11,-44,-75.0
1949,Tanzania,66,0.11,72,93,0.15,69,159,0.13,71,27,17,58.82
1949,"Korea, Republic of",14,0.02,109,139,0.22,63,153,0.13,72,125,187,-33.16
1949,Madagascar,54,0.09,75,87,0.14,71,141,0.12,73,33,29,13.79
1949,Zambia,92,0.16,65,44,0.07,92,136,0.11,74,-48,-64,-25.0
1949,Uganda,89,0.15,66,47,0.08,89,136,0.11,74,-42,-66,-36.36
1949,Dominican Republic,74,0.13,69,52,0.08,83,126,0.1,76,-22,-9,144.44
1949,Congo,41,0.07,85,82,0.13,72,123,0.1,77,41,3,1266.67
1949,Angola,70,0.12,70,51,0.08,85,121,0.1,78,-19,-11,72.73
1949,Guatemala,52,0.09,76,68,0.11,76,120,0.1,79,16,18,-11.11
1949,Jamaica,45,0.08,82,72,0.12,75,117,0.1,80,27,33,-18.18
1949,Cameroon,50,0.09,79,65,0.1,78,115,0.1,81,15,6,150.0
1949,Mozambique,37,0.06,87,68,0.11,76,105,0.09,82,31,31,0.0
1949,Honduras,55,0.09,73,50,0.08,86,105,0.09,82,-5,-12,-58.33
1949,Afghanistan,47,0.08,80,52,0.08,83,99,0.08,84,5,9,-44.44
1949,Ecuador,42,0.07,83,55,0.09,82,97,0.08,85,13,14,-7.14
1949,El Salvador,55,0.09,73,41,0.07,95,96,0.08,86,-14,-4,250.0
1949,Costa Rica,51,0.09,78,43,0.07,93,94,0.08,87,-8,-8,0.0
1949,Mauritius,46,0.08,81,42,0.07,94,88,0.07,88,-4,-3,33.33
1949,Ethiopia,38,0.06,86,48,0.08,88,86,0.07,89,10,11,-9.09
1949,Equatorial Guinea,30,0.05,93,50,0.08,86,80,0.07,90,20,32,-37.5
1949,Panama,15,0.03,108,65,0.1,78,80,0.07,90,50,57,-12.28
1949,Iceland,31,0.05,91,46,0.07,91,77,0.06,92,15,9,66.67
1949,Chinese Taipei,17,0.03,104,59,0.09,80,76,0.06,93,42,-12,-450.0
1949,Cyprus,31,0.05,91,41,0.07,95,72,0.06,94,10,40,-75.0
1949,Haiti,35,0.06,88,31,0.05,99,66,0.05,95,-4,2,-300.0
1949,Paraguay,33,0.06,90,32,0.05,98,65,0.05,96,-1,0,
1949,Malta,4,0.01,127,57,0.09,81,61,0.05,97,53,60,-11.67
1949,Guyana,29,0.05,94,31,0.05,99,60,0.05,98,2,9,-77.78
1949,Jordan,13,0.02,111,47,0.08,89,60,0.05,98,34,33,3.03
1949,Sierra Leone,26,0.04,96,22,0.04,106,48,0.04,100,-4,-2,100.0
1949,Fiji,22,0.04,100,23,0.04,104,45,0.04,101,1,-3,-133.33
1949,Nicaragua,24,0.04,98,21,0.03,107,45,0.04,101,-3,5,-160.0
1949,Reunion,23,0.04,99,21,0.03,107,44,0.04,103,-2,0,
1949,Barbados,17,0.03,104,26,0.04,101,43,0.04,104,9,14,-35.71
1949,"Macao, China",2,0.0,133,41,0.07,95,43,0.04,104,39,17,129.41
1949,Brunei Darussalam,26,0.04,96,16,0.03,113,42,0.03,106,-10,-7,42.86
1949,Côte d'Ivoire,42,0.07,83,0,0.0,142,42,0.03,106,-42,-42,0.0
1949,Guadeloupe,21,0.04,101,21,0.03,107,42,0.03,106,0,6,-100.0
1949,Martinique,16,0.03,106,26,0.04,101,42,0.03,106,10,6,66.67
1949,Papua New Guinea,14,0.02,109,25,0.04,103,39,0.03,110,11,10,10.0
1949,Malawi,18,0.03,102,21,0.03,107,39,0.03,110,3,3,0.0
1949,Suriname,18,0.03,102,20,0.03,111,38,0.03,112,2,5,-60.0
1949,Libya,8,0.01,117,23,0.04,104,31,0.03,113,15,13,15.38
1949,Djibouti,12,0.02,112,14,0.02,114,26,0.02,114,2,8,-75.0
1949,Benin,11,0.02,113,14,0.02,114,25,0.02,115,3,-3,-200.0
1949,New Caledonia,8,0.01,117,14,0.02,114,22,0.02,116,6,4,50.0
1949,Bahamas,2,0.0,133,18,0.03,112,20,0.02,117,16,17,-5.88
1949,French Polynesia,9,0.02,116,11,0.02,117,20,0.02,117,2,-1,-300.0
1949,Cabo Verde,7,0.01,119,10,0.02,119,17,0.01,119,3,6,-50.0
1949,Togo,6,0.01,122,11,0.02,117,17,0.01,119,5,-3,-266.67
1949,Yemen,7,0.01,119,9,0.01,120,16,0.01,121,2,2,0.0
1949,Qatar,10,0.02,114,6,0.01,122,16,0.01,121,-4,0,
1949,Liberia,16,0.03,106,0,0.0,142,16,0.01,121,-16,-16,0.0
1949,Belize,5,0.01,123,8,0.01,121,13,0.01,124,3,2,50.0
1949,The Gambia,7,0.01,119,6,0.01,122,13,0.01,124,-1,-1,0.0
1949,Guinea-Bissau,5,0.01,123,6,0.01,122,11,0.01,126,1,2,-50.0
1949,Sao Tomé and Principe,5,0.01,123,5,0.01,126,10,0.01,127,0,-5,-100.0
1949,Guinea,10,0.02,114,0,0.0,142,10,0.01,127,-10,-10,0.0
1949,Greenland,3,0.01,131,6,0.01,122,9,0.01,129,3,0,
1949,Niger,4,0.01,127,4,0.01,128,8,0.01,130,0,-6,-100.0
1949,Samoa,5,0.01,123,3,0.0,131,8,0.01,130,-2,-1,100.0
1949,Vanuatu,4,0.01,127,2,0.0,135,6,0.0,132,-2,-3,-33.33
1949,Maldives,2,0.0,133,4,0.01,128,6,0.0,132,2,2,0.0
1949,Saint Pierre and Miquelon,3,0.01,131,3,0.0,131,6,0.0,132,0,0,
1949,Antigua and Barbuda,2,0.0,133,3,0.0,131,5,0.0,135,1,3,-66.67
1949,Oman,0,0.0,143,5,0.01,126,5,0.0,135,5,5,0.0
1949,Grenada,4,0.01,127,0,0.0,142,4,0.0,137,-4,-4,0.0
1949,French Guiana,0,0.0,143,4,0.01,128,4,0.0,137,4,5,-20.0
1949,Saint Lucia,1,0.0,140,3,0.0,131,4,0.0,137,2,,
1949,Saint Vincent and the Grenadines,1,0.0,140,2,0.0,135,3,0.0,140,1,1,0.0
1949,Solomon Islands,2,0.0,133,1,0.0,138,3,0.0,140,-1,0,
1949,Seychelles,2,0.0,133,1,0.0,138,3,0.0,140,-1,-1,0.0
1949,Guam,2,0.0,133,0,0.0,142,2,0.0,143,-2,-6,-66.67
1949,American Samoa,1,0.0,140,1,0.0,138,2,0.0,143,0,0,
1949,Tonga,0,0.0,143,2,0.0,135,2,0.0,143,2,-1,-300.0
1949,Kiribati,0,0.0,143,1,0.0,138,1,0.0,146,1,1,0.0
1948,United States of America,12653,21.62,1,8081,12.99,2,20734,17.17,1,-4572,,
1948,United Kingdom,6605,11.29,2,8370,13.45,1,14975,12.4,2,1765,,
1948,Canada,3202,5.47,3,2740,4.4,4,5942,4.92,3,-462,,
1948,France,2012,3.44,4,3443,5.53,3,5455,4.52,4,1431,,
1948,Belgium-Luxembourg,1690,2.89,5,1985,3.19,6,3675,3.04,5,295,,
1948,Netherlands,1185,2.03,10,2148,3.45,5,3333,2.76,6,963,,
1948,Argentina,1629,2.78,7,1562,2.51,7,3191,2.64,7,-67,,
1948,Australia,1649,2.82,6,1341,2.15,13,2990,2.48,8,-308,,
1948,India,1295,2.21,8,1427,2.29,10,2722,2.25,9,132,,
1948,South Africa,1170,2.0,12,1552,2.49,8,2722,2.25,9,382,,
1948,Italy,1077,1.84,14,1539,2.47,9,2616,2.17,11,462,,
1948,U.S.S.R.,1295,2.21,8,1212,1.95,14,2507,2.08,12,-83,,
1948,Sweden,1107,1.89,13,1378,2.21,12,2485,2.06,13,271,,
1948,Brazil,1183,2.02,11,1127,1.81,16,2310,1.91,14,-56,,
1948,Germany,791,1.35,16,1400,2.25,11,2191,1.81,15,609,,
1948,Switzerland,786,1.34,17,1143,1.84,15,1929,1.6,16,357,,
1948,"Venezuela, Bolivarian Republic of",898,1.53,15,839,1.35,18,1737,1.44,17,-59,,
1948,Singapore,690,1.18,20,846,1.36,17,1536,1.27,18,156,,
1948,Czech and Slovak Federal Republic,753,1.29,18,681,1.09,23,1434,1.19,19,-72,,
1948,Egypt,591,1.01,23,715,1.15,20,1306,1.08,20,124,,
1948,Denmark,569,0.97,24,713,1.15,21,1282,1.06,21,144,,
1948,Cuba,710,1.21,19,527,0.85,28,1237,1.02,22,-183,,
1948,Mexico,555,0.95,25,643,1.03,25,1198,0.99,23,88,,
1948,Norway,415,0.71,32,750,1.21,19,1165,0.96,24,335,,
1948,Poland,594,1.02,22,519,0.83,30,1113,0.92,25,-75,,
1948,Malaysia,621,1.06,21,457,0.73,36,1078,0.89,26,-164,,
1948,Finland,501,0.86,28,488,0.78,32,989,0.82,27,-13,,
1948,New Zealand,518,0.89,27,451,0.72,37,969,0.8,28,-67,,
1948,Philippines,310,0.53,40,644,1.03,24,954,0.79,29,334,,
1948,Netherlands Antilles,407,0.7,33,543,0.87,27,950,0.79,30,136,,
1948,Japan,258,0.44,44,684,1.1,22,942,0.78,31,426,,
1948,"Hong Kong, China",399,0.68,34,523,0.84,29,922,0.76,32,124,,
1948,China,520,0.89,26,387,0.62,39,907,0.75,33,-133,,
1948,Algeria,418,0.71,31,482,0.77,33,900,0.75,34,64,,
1948,Indonesia,394,0.67,35,464,0.75,35,858,0.71,35,70,,
1948,Spain,373,0.64,36,482,0.77,33,855,0.71,36,109,,
1948,Pakistan,494,0.84,29,312,0.5,44,806,0.67,37,-182,,
1948,Ireland,199,0.34,51,549,0.88,26,748,0.62,38,350,,
1948,Austria,198,0.34,52,490,0.79,31,688,0.57,39,292,,
1948,Colombia,307,0.52,41,337,0.54,42,644,0.53,40,30,,
1948,"Yugoslavia, Socialist Federal Republic of",304,0.52,43,316,0.51,43,620,0.51,41,12,,
1948,Sri Lanka,306,0.52,42,300,0.48,45,606,0.5,42,-6,,
1948,Iran,491,0.84,30,108,0.17,70,599,0.5,43,-383,,
1948,Chile,327,0.56,38,270,0.43,47,597,0.49,44,-57,,
1948,Portugal,172,0.29,55,415,0.67,38,587,0.49,45,243,,
1948,Türkiye,197,0.34,53,348,0.56,41,545,0.45,46,151,,
1948,German Democratic Republic,320,0.55,39,172,0.28,58,492,0.41,47,-148,,
1948,Greece,94,0.16,67,363,0.58,40,457,0.38,48,269,,
1948,"Saudi Arabia, Kingdom of",330,0.56,37,127,0.2,64,457,0.38,48,-203,,
1948,Democratic Republic of the Congo,245,0.42,47,192,0.31,51,437,0.36,50,-53,,
1948,Morocco,144,0.25,59,281,0.45,46,425,0.35,51,137,,
1948,Nigeria,252,0.43,46,169,0.27,60,421,0.35,52,-83,,
1948,Hungary,253,0.43,45,168,0.27,61,421,0.35,52,-85,,
1948,Myanmar,228,0.39,48,176,0.28,57,404,0.33,54,-52,,
1948,Uruguay,178,0.3,54,200,0.32,50,378,0.31,55,22,,
1948,Thailand,223,0.38,50,144,0.23,63,367,0.3,56,-79,,
1948,Ghana,226,0.39,49,127,0.2,64,353,0.29,57,-99,,
1948,Senegal,155,0.26,58,177,0.28,56,332,0.27,58,22,,
1948,Peru,162,0.28,56,168,0.27,61,330,0.27,59,6,,
1948,Kenya,137,0.23,60,182,0.29,54,319,0.26,60,45,,
1948,Viet Nam,92,0.16,68,188,0.3,52,280,0.23,61,96,,
1948,Zimbabwe,99,0.17,65,171,0.27,59,270,0.22,62,72,,
1948,Romania,160,0.27,57,96,0.15,72,256,0.21,63,-64,,
1948,"Bahrain, Kingdom of",133,0.23,61,120,0.19,67,253,0.21,64,-13,,
1948,Syrian Arab Republic,36,0.06,91,213,0.34,48,249,0.21,65,177,,
1948,Iraq,50,0.09,77,185,0.3,53,235,0.19,66,135,,
1948,Tunisia,48,0.08,83,179,0.29,55,227,0.19,67,131,,
1948,"Korea, Republic of",19,0.03,100,206,0.33,49,225,0.19,68,187,,
1948,Trinidad and Tobago,111,0.19,64,110,0.18,69,221,0.18,69,-1,,
1948,Bulgaria,91,0.16,69,124,0.2,66,215,0.18,70,33,,
1948,Sudan,99,0.17,65,92,0.15,73,191,0.16,71,-7,,
1948,"Bolivia, Plurinational State of",113,0.19,63,69,0.11,81,182,0.15,72,-44,,
1948,Zambia,115,0.2,62,51,0.08,88,166,0.14,73,-64,,
1948,"Yemen, People's Democratic Republic",52,0.09,76,111,0.18,68,163,0.13,74,59,,
1948,Dominican Republic,83,0.14,70,74,0.12,77,157,0.13,75,-9,,
1948,Tanzania,64,0.11,72,81,0.13,74,145,0.12,76,17,,
1948,Iceland,62,0.11,73,71,0.11,78,133,0.11,77,9,,
1948,Madagascar,49,0.08,81,78,0.13,76,127,0.11,78,29,,
1948,Jamaica,46,0.08,84,79,0.13,75,125,0.1,79,33,,
1948,Guatemala,50,0.09,77,68,0.11,82,118,0.1,80,18,,
1948,Israel,6,0.01,124,108,0.17,70,114,0.09,81,102,,
1948,Mozambique,40,0.07,89,71,0.11,78,111,0.09,82,31,,
1948,Angola,60,0.1,74,49,0.08,91,109,0.09,83,-11,,
1948,Afghanistan,49,0.08,81,58,0.09,86,107,0.09,84,9,,
1948,Ecuador,46,0.08,84,60,0.1,85,106,0.09,85,14,,
1948,Congo,50,0.09,77,53,0.09,87,103,0.09,86,3,,
1948,Honduras,55,0.09,75,43,0.07,92,98,0.08,87,-12,,
1948,Costa Rica,50,0.09,77,42,0.07,94,92,0.08,88,-8,,
1948,Ethiopia,39,0.07,90,50,0.08,90,89,0.07,89,11,,
1948,El Salvador,46,0.08,84,42,0.07,94,88,0.07,90,-4,,
1948,Cyprus,23,0.04,98,63,0.1,84,86,0.07,91,40,,
1948,Panama,14,0.02,108,71,0.11,78,85,0.07,92,57,,
1948,Mauritius,44,0.08,87,41,0.07,97,85,0.07,92,-3,,
1948,Cameroon,36,0.06,91,42,0.07,94,78,0.06,94,6,,
1948,Guyana,31,0.05,93,40,0.06,98,71,0.06,95,9,,
1948,Equatorial Guinea,19,0.03,100,51,0.08,88,70,0.06,96,32,,
1948,Malta,5,0.01,129,65,0.1,83,70,0.06,96,60,,
1948,Uganda,66,0.11,71,0,0.0,142,66,0.05,98,-66,,
1948,Haiti,30,0.05,94,32,0.05,99,62,0.05,99,2,,
1948,Paraguay,28,0.05,95,28,0.04,100,56,0.05,100,0,,
1948,Jordan,10,0.02,113,43,0.07,92,53,0.04,101,33,,
1948,Fiji,25,0.04,96,22,0.04,103,47,0.04,102,-3,,
1948,Nicaragua,19,0.03,100,24,0.04,102,43,0.04,103,5,,
1948,Côte d'Ivoire,42,0.07,88,0,0.0,142,42,0.03,104,-42,,
1948,Sierra Leone,22,0.04,99,20,0.03,108,42,0.03,104,-2,,
1948,Brunei Darussalam,24,0.04,97,17,0.03,114,41,0.03,106,-7,,
1948,Barbados,12,0.02,110,26,0.04,101,38,0.03,107,14,,
1948,Reunion,19,0.03,100,19,0.03,110,38,0.03,107,0,,
1948,Malawi,17,0.03,104,20,0.03,108,37,0.03,109,3,,
1948,Martinique,15,0.03,107,21,0.03,105,36,0.03,110,6,,
1948,Suriname,14,0.02,108,19,0.03,110,33,0.03,111,5,,
1948,Papua New Guinea,11,0.02,112,21,0.03,105,32,0.03,112,10,,
1948,Libya,9,0.02,118,22,0.04,103,31,0.03,113,13,,
1948,Guadeloupe,12,0.02,110,18,0.03,113,30,0.02,114,6,,
1948,Cabo Verde,10,0.02,113,16,0.03,116,26,0.02,115,6,,
1948,Djibouti,9,0.02,118,17,0.03,114,26,0.02,115,8,,
1948,"Macao, China",4,0.01,133,21,0.03,105,25,0.02,117,17,,
1948,Chinese Taipei,17,0.03,104,5,0.01,125,22,0.02,118,-12,,
1948,Bahamas,2,0.0,138,19,0.03,110,21,0.02,119,17,,
1948,New Caledonia,7,0.01,123,11,0.02,117,18,0.01,120,4,,
1948,Togo,10,0.02,113,7,0.01,122,17,0.01,121,-3,,
1948,Benin,10,0.02,113,7,0.01,122,17,0.01,121,-3,,
1948,The Gambia,9,0.02,118,8,0.01,118,17,0.01,121,-1,,
1948,French Polynesia,9,0.02,118,8,0.01,118,17,0.01,121,-1,,
1948,Liberia,16,0.03,106,0,0.0,142,16,0.01,125,-16,,
1948,Yemen,6,0.01,124,8,0.01,118,14,0.01,126,2,,
1948,Belize,6,0.01,124,8,0.01,118,14,0.01,126,2,,
1948,Sao Tomé and Principe,9,0.02,118,4,0.01,129,13,0.01,128,-5,,
1948,Guinea-Bissau,5,0.01,129,7,0.01,122,12,0.01,129,2,,
1948,Qatar,5,0.01,129,5,0.01,125,10,0.01,130,0,,
1948,Guinea,10,0.02,113,0,0.0,142,10,0.01,130,-10,,
1948,Greenland,4,0.01,133,4,0.01,129,8,0.01,132,0,,
1948,Vanuatu,5,0.01,129,2,0.0,135,7,0.01,133,-3,,
1948,Samoa,4,0.01,133,3,0.0,133,7,0.01,133,-1,,
1948,Niger,6,0.01,124,0,0.0,142,6,0.0,135,-6,,
1948,Guam,6,0.01,124,0,0.0,142,6,0.0,135,-6,,
1948,Maldives,2,0.0,138,4,0.01,129,6,0.0,135,2,,
1948,Antigua and Barbuda,1,0.0,143,4,0.01,129,5,0.0,138,3,,
1948,Saint Vincent and the Grenadines,2,0.0,138,3,0.0,133,5,0.0,138,1,,
1948,Oman,0,0.0,146,5,0.01,125,5,0.0,138,5,,
1948,Tonga,3,0.01,137,2,0.0,135,5,0.0,138,-1,,
1948,French Guiana,0,0.0,146,5,0.01,125,5,0.0,138,5,,
1948,Grenada,4,0.01,133,0,0.0,142,4,0.0,143,-4,,
1948,Saint Pierre and Miquelon,2,0.0,138,2,0.0,135,4,0.0,143,0,,
1948,Seychelles,2,0.0,138,1,0.0,138,3,0.0,145,-1,,
1948,Solomon Islands,1,0.0,143,1,0.0,138,2,0.0,146,0,,
1948,American Samoa,1,0.0,143,1,0.0,138,2,0.0,146,0,,
1948,Kiribati,0,0.0,146,1,0.0,138,1,0.0,148,1,,